,نماد,نام,تعداد,حجم,ارزش,دیروز,اولین,آخرین معامله - مقدار,آخرین معامله - تغییر,آخرین معامله - درصد,قیمت پایانی - مقدار,قیمت پایانی - تغییر,قیمت پایانی - درصد,کمترین,بیشترین,تاریخ
0,آريا,پليمر آريا ساسول,122109,21903672,3684743543928,162050,157000,170152,8102,5.0,168225,6175,3.81,156000,170152,1399-6-5
1,وپويا,سرمايه گذاري پويا,68183,78479699,1219437223616,15015,15600,15704,689,4.59,15538,523,3.48,14770,15765,1399-6-5
2,شصدفح,ح . صنعتي دوده فام,66815,16692940,431441719183,25000,25297,26250,1250,5.0,25846,846,3.38,24000,26250,1399-6-5
3,شستا,سرمايه گذاري تامين اجتماعي,59388,134915099,6084624142860,42960,45100,45000,2040,4.75,45100,2140,4.98,45000,45100,1399-6-5
4,آبادا,توليد نيروي برق آبادان,55818,20468456,671294476510,31670,31800,33250,1580,4.99,32800,1130,3.57,31670,33250,1399-6-5
5,سيتا,سرمايه گذاري سيمان تامين,41852,26824329,781124460480,27740,29120,29120,1380,4.97,29120,1380,4.97,29120,29120,1399-6-5
6,پيزد,مجتمع صنايع لاستيك يزد,41813,4481745,590787782912,127910,132000,131650,3740,2.92,131821,3911,3.06,124150,133800,1399-6-5
7,ثشاهد,سرمايه‌ گذاري‌ شاهد,25241,44417364,2866397870740,62790,65000,65920,3130,4.98,64530,1740,2.77,59710,65920,1399-6-5
8,خودرو,ايران‌ خودرو,23912,393783085,1676842944850,4060,4260,4260,200,4.93,4260,200,4.93,4220,4260,1399-6-5
9,خگستر,گسترش‌سرمايه‌گذاري‌ايران‌خودرو,21223,147869741,1166948190860,7570,7890,7940,370,4.89,7890,320,4.23,7570,7940,1399-6-5
10,خبهمن,گروه‌بهمن‌,19501,73624172,2948159315170,38420,39990,40340,1920,5.0,40040,1620,4.22,38020,40340,1399-6-5
11,ثنوسا,نوسازي‌وساختمان‌تهران‌,16743,143732904,2252208391150,15520,15550,16290,770,4.96,15670,150,0.97,14750,16290,1399-6-5
12,غگل,گلوكوزان‌,16717,78773578,748321559950,9180,9510,9630,450,4.9,9500,320,3.49,9200,9630,1399-6-5
13,خزاميا,زامياد,15588,56083258,1237200667060,21300,21600,22360,1060,4.98,22060,760,3.57,21030,22360,1399-6-5
14,ثعمرا,عمران و توسعه شاهد,14331,55714454,1722338964328,30004,30200,31504,1500,5.0,30914,910,3.03,29000,31504,1399-6-5
15,شپلي,پلي اكريل ايران,14131,174648565,1891705835436,10767,10229,11305,538,5.0,10831,64,0.59,10229,11305,1399-6-5
16,سمايه,بانك سرمايه,13583,182390802,2143021541383,12276,11663,11663,-613,-4.99,11750,-526,-4.28,11663,12190,1399-6-5
17,گدنا,تهيه توزيع غذاي دنا آفرين فدك,13494,157817,1005136473,6066,6369,6369,303,5.0,6072,6,0.1,6369,6369,1399-6-5
18,حفاري,حفاري شمال,12517,51304777,960511213630,17890,18670,18780,890,4.97,18720,830,4.64,17890,18780,1399-6-5
19,زملارد,كشاورزي و دامپروري ملارد شير,12426,90337,2261767469,23845,25037,25037,1192,5.0,23891,46,0.19,25037,25037,1399-6-5
20,ولپارس,ليزينگ پارسيان,12202,1024468,3851999680,3590,3760,3760,170,4.74,3600,10,0.28,3760,3760,1399-6-5
21,فنوال,نورد آلومينيوم‌,11546,47244228,1954734788250,43130,40980,41300,-1830,-4.24,41380,-1750,-4.06,40980,43600,1399-6-5
22,امين,تامين سرمايه امين,11076,1570071,22593321690,13710,14390,14390,680,4.96,13960,250,1.82,14390,14390,1399-6-5
23,خمحركه,نيرو محركه‌,11043,35724459,462696705780,12460,12780,13080,620,4.98,12950,490,3.93,12100,13080,1399-6-5
24,بركت,گروه دارويي بركت,10734,31151505,841656234840,25880,26800,27170,1290,4.98,27020,1140,4.4,26010,27170,1399-6-5
25,ساوه,سيمان ساوه,10520,2471146,216319279091,84551,83550,88778,4227,5.0,87538,2987,3.53,83550,88778,1399-6-5
26,فولاي,صنايع فولاد آلياژي يزد,10470,17387633,1033121783874,57528,59500,58900,1372,2.38,59417,1889,3.28,55005,60404,1399-6-5
27,فاسمين,كالسيمين‌,9644,13949862,1049219568210,74370,73420,75150,780,1.05,75210,840,1.13,72500,77900,1399-6-5
28,خصدرا,صنعتي‌ دريايي‌ ايران‌,9628,72729459,559357791764,7397,7550,7766,369,4.99,7691,294,3.97,7399,7766,1399-6-5
29,شپترو,پتروشيمي آبادان,9239,61438403,559661700480,9333,9062,9199,-134,-1.44,9109,-224,-2.4,9054,9470,1399-6-5
30,ثبهساز,بهساز كاشانه تهران,9015,27310617,88486399080,3090,3240,3240,150,4.85,3240,150,4.85,3240,3240,1399-6-5
31,حكشتي,كشتيراني جمهوري اسلامي ايران,8938,11088495,719420275700,62000,64440,65100,3100,5.0,64880,2880,4.65,63110,65100,1399-6-5
32,وساپا,سرمايه‌گذاري‌ سايپا,8831,36072184,584467069110,15560,15980,16330,770,4.95,16200,640,4.11,15700,16330,1399-6-5
33,رافزا,رايان هم افزا,8823,51759,1453030407,26737,28073,28073,1336,5.0,26774,37,0.14,28073,28073,1399-6-5
34,دارا يكم,صندوق واسطه گري مالي يكم-سهام,8751,1088428,226697783840,189350,208280,208280,18930,10.0,208280,18930,10.0,208280,208280,1399-6-5
35,هاي وب,داده گسترعصرنوين-هاي وب,8745,30168968,1154645494930,36460,38280,38280,1820,4.99,38270,1810,4.96,37500,38280,1399-6-5
36,خاور,ايران خودرو ديزل,8670,61419285,531226994916,8536,8470,8540,4,0.05,8649,113,1.32,8470,8724,1399-6-5
37,وليز,ليزينگ‌ايران‌,8644,33553691,408964326070,12290,11680,12400,110,0.9,12190,-100,-0.81,11680,12790,1399-6-5
38,خاذين,سايپاآذين‌,8436,45678690,444109321040,9620,9600,9600,-20,-0.21,9720,100,1.04,9210,9990,1399-6-5
39,ثفارس,عمران‌وتوسعه‌فارس‌,8235,30403130,430724219740,13860,14010,14240,380,2.74,14170,310,2.24,13750,14390,1399-6-5
40,كسعدي,كاشي‌ سعدي‌,7884,30683895,2227762092000,75900,72110,72110,-3790,-4.99,72600,-3300,-4.35,72110,75880,1399-6-5
41,حسير,ريل سير كوثر,7821,22680890,675339316366,28993,29220,28900,-93,-0.32,29776,783,2.7,28210,30442,1399-6-5
42,وتوصا,گروه س توسعه صنعتي ايران,7564,27571594,483469213820,17350,17210,17550,200,1.15,17540,190,1.1,16550,18200,1399-6-5
43,زبينا,كشاورزي و دامپروري بينالود,7563,10153173,650795930173,65754,65755,64200,-1554,-2.36,64098,-1656,-2.52,62467,68020,1399-6-5
44,سمگا,گروه سرمايه گذاري ميراث فرهنگي,7443,32134485,577097294918,17294,17750,18158,864,5.0,17959,665,3.85,17410,18158,1399-6-5
45,بگيلان,توسعه مسير برق گيلان,7172,388591,11751769022,28802,30242,30242,1440,5.0,29109,307,1.07,30242,30242,1399-6-5
46,دي,بانك دي,7099,11732167,671936400591,54546,57273,57273,2727,5.0,57273,2727,5.0,57273,57273,1399-6-5
47,آگاس,صندوق س.هستي بخش آگاه-س,6790,3958366,1264002384081,295148,316000,326000,30852,10.45,319324,24176,8.19,310002,329000,1399-6-5
48,فسپا,گروه‌صنعتي‌سپاهان‌,6677,9214982,584437824340,61340,61700,64200,2860,4.66,63420,2080,3.39,61350,64400,1399-6-5
49,وخارزم,سرمايه گذاري خوارزمي,6605,34234139,555265977850,15510,16160,16280,770,4.96,16220,710,4.58,15620,16280,1399-6-5
50,اخابر,مخابرات ايران,6282,38407090,983481567390,24440,25400,25660,1220,4.99,25610,1170,4.79,24900,25660,1399-6-5
51,فاهواز,نورد و لوله اهواز,6164,44999101,1077262896797,24252,23767,24347,95,0.39,23940,-312,-1.29,23767,24640,1399-6-5
52,ياقوت,صندوق س ياقوت آگاه-ثابت,5962,288403025,3143590341120,10880,10920,10900,20,0.18,10900,20,0.18,10850,10990,1399-6-5
53,كيسون,شركت كيسون,5844,37531157,933565765987,26123,24817,24817,-1306,-5.0,24874,-1249,-4.78,24817,25627,1399-6-5
54,ختور,رادياتور ايران‌,5771,8112985,343909483290,43050,40900,42400,-650,-1.51,42390,-660,-1.53,40900,44500,1399-6-5
55,زدشت,كشت و صنعت دشت خرم دره,5660,13627992,865311126802,65966,62668,62668,-3298,-5.0,63495,-2471,-3.75,62668,67000,1399-6-5
56,وسينا,بانك سينا,5535,65540066,1147497367700,16810,17640,17650,840,5.0,17510,700,4.16,16870,17650,1399-6-5
57,بجهرم,توسعه مولد نيروگاهي جهرم,5510,39527893,233809346207,5636,5917,5917,281,4.99,5915,279,4.95,5800,5917,1399-6-5
58,ولشرق,ليزينگ ايران و شرق,5499,79515946,933688949126,11830,11239,12421,591,5.0,11742,-88,-0.74,11239,12421,1399-6-5
59,شصدف,صنعتي دوده فام,5381,202395,3781143390,17793,18682,18682,889,5.0,17857,64,0.36,18682,18682,1399-6-5
60,غگيلا,شيرپاستوريزه پگاه گيلان,5314,75952,1191459024,14940,15687,15687,747,5.0,14957,17,0.11,15687,15687,1399-6-5
61,كمند,صندوق س. با درآمد ثابت كمند,5270,235758544,2401805546930,10180,10200,10220,40,0.39,10190,10,0.1,10170,10220,1399-6-5
62,خچرخش,چرخشگر,5247,32663393,786305408470,25240,23980,23980,-1260,-4.99,24070,-1170,-4.64,23980,24730,1399-6-5
63,فاراك,ماشين‌ سازي‌ اراك‌,5211,31662861,468841337350,14220,14360,14930,710,4.99,14810,590,4.15,14350,14930,1399-6-5
64,دسبحان,سبحان دارو,5192,7247653,203394666220,28660,27230,28240,-420,-1.47,28060,-600,-2.09,27230,28660,1399-6-5
65,بزاگرس,نيروگاه زاگرس كوثر,4986,19069788,357509018422,18794,19260,19200,406,2.16,18747,-47,-0.25,18053,19280,1399-6-5
66,دتوليد,داروسازي توليد دارو,4973,6953939,369522297280,51093,51120,53647,2554,5.0,53139,2046,4.0,51120,53647,1399-6-5
67,غصينو,صنعتي مينو,4933,17971960,671861623455,38210,37064,37064,-1146,-3.0,37384,-826,-2.16,37064,39356,1399-6-5
68,تسه9905,امتياز تسهيلات مسكن مرداد99,4820,94563,71473056892,766626,747155,757999,-8627,-1.13,755825,-10801,-1.41,745000,762000,1399-6-5
69,ثپرديس,سرمايه گذاري مسكن پرديس,4711,20435172,308029590493,15328,14562,15000,-328,-2.14,15074,-254,-1.66,14562,15788,1399-6-5
70,غنوش,نوش‌ مازندران‌,4698,5061585,594043683230,112390,114000,118000,5610,4.99,117360,4970,4.42,113000,118000,1399-6-5
71,كنور,توسعه معدني و صنعتي صبانور,4631,7328653,391773469450,51700,51900,54280,2580,4.99,53460,1760,3.4,51900,54280,1399-6-5
72,ثتران,سرمايه گذاري مسكن تهران,4588,28021969,305180336997,10860,10500,11081,221,2.03,10891,31,0.29,10337,11279,1399-6-5
73,وگردش,بانك گردشگري,4536,37926954,788343087557,20188,20793,20793,605,3.0,20786,598,2.96,20400,20793,1399-6-5
74,تبرك,گروه كارخانجات صنعتي تبرك,4528,9302305,333917811167,34363,36000,36081,1718,5.0,35896,1533,4.46,34800,36081,1399-6-5
75,سرو,صندوق س سروسودمند مدبران-سهام,4451,5614205,398696325070,66690,70500,72870,6180,9.27,71020,4330,6.49,68000,73000,1399-6-5
76,بزاگرسح,ح . نيروگاه زاگرس كوثر,4443,47275073,589167821440,12915,13000,12750,-165,-1.28,12463,-452,-3.5,12270,13350,1399-6-5
77,ديران,ايران‌دارو,4339,8579261,247070138510,28760,27330,29160,400,1.39,28800,40,0.14,27330,29990,1399-6-5
78,حتايد,تايدواترخاورميانه,4274,14765652,392505411350,25740,26300,27020,1280,4.97,26580,840,3.26,25220,27020,1399-6-5
79,خكمك,كمك‌فنرايندامين‌,4252,8278234,517239585000,64240,65000,61030,-3210,-5.0,62480,-1760,-2.74,61030,66000,1399-6-5
80,خساپا,سايپا,4212,112143555,411566846850,3500,3670,3670,170,4.86,3670,170,4.86,3670,3670,1399-6-5
81,خريخت,صنايع‌ريخته‌گري‌ايران‌,4198,29860731,201732762360,6510,6530,6830,320,4.92,6760,250,3.84,6520,6830,1399-6-5
82,صبا,سرمايه گذاري صبا تامين,4150,9406510,306059615870,30988,32537,32537,1549,5.0,32537,1549,5.0,32537,32537,1399-6-5
83,ونفت,سرمايه‌گذاري‌ صنعت‌ نفت‌,4111,14430153,278719626700,18470,19150,19390,920,4.98,19320,850,4.6,18650,19390,1399-6-5
84,زقيام,كشت و دام قيام اصفهان,4081,6963671,278463670590,41682,40000,39760,-1922,-4.61,39988,-1694,-4.06,39598,42700,1399-6-5
85,سخزر,سيمان‌ خزر,4074,8414380,319592976260,39810,37820,37850,-1960,-4.92,37980,-1830,-4.6,37820,38950,1399-6-5
86,شگويا,پتروشيمي تندگويان,4048,11178054,217625533326,18542,19469,19469,927,5.0,19469,927,5.0,19469,19469,1399-6-5
87,نطرين,عطرين نخ قم,3897,9694793,213273347782,21771,21351,22859,1088,5.0,21999,228,1.05,20683,22859,1399-6-5
88,ثمسكن,سرمايه‌گذاري‌ مسكن‌,3896,27290574,269774593900,9540,9590,10010,470,4.93,9890,350,3.67,9300,10010,1399-6-5
89,قرن,پديده شيمي قرن,3772,4599292,273203288800,57220,59670,60080,2860,5.0,59400,2180,3.81,57940,60080,1399-6-5
90,وسبحان,سرمايه گذاري سبحان,3743,45182817,553258876200,11671,12254,12254,583,5.0,12245,574,4.92,11674,12254,1399-6-5
91,شسپا,نفت سپاهان,3738,12711036,361187389920,27110,28460,28460,1350,4.98,28420,1310,4.83,27800,28460,1399-6-5
92,اطلس,صندوق س.توسعه اندوخته آينده-س,3697,1361544,293016519740,200556,211000,215300,14744,7.35,215209,14653,7.31,210005,219000,1399-6-5
93,ارزش,صندوق س ارزش آفرين بيدار-سهام,3596,17019343,204787480040,11100,11590,12210,1110,10.0,12030,930,8.38,11590,12210,1399-6-5
94,ثباغ,شهر سازي و خانه سازي باغميشه,3596,21953681,460430066339,21971,20873,20873,-1098,-5.0,20973,-998,-4.54,20873,21550,1399-6-5
95,فلوله,لوله‌وماشين‌سازي‌ايران‌,3578,7777923,255844238190,32470,32990,32770,300,0.92,32890,420,1.29,32400,33950,1399-6-5
96,همراه,شركت ارتباطات سيار ايران,3558,11915135,691292924160,55260,58020,58020,2760,4.99,58020,2760,4.99,57000,58020,1399-6-5
97,غپاك,لبنيات‌ پاك‌,3537,17770899,339977739340,19910,19650,18920,-990,-4.97,19130,-780,-3.92,18920,19910,1399-6-5
98,اميد,تامين سرمايه اميد,3534,25289525,634437482810,23910,25100,25100,1190,4.98,25090,1180,4.94,24630,25100,1399-6-5
99,شتران,پالايش نفت تهران,3512,31184214,1137600126720,34750,36480,36480,1730,4.98,36480,1730,4.98,36480,36480,1399-6-5
100,امين يكم,صندوق درآمد ثابت امين يكم فردا,3484,125933828,1318582994150,10420,10460,10510,90,0.86,10470,50,0.48,10420,10550,1399-6-5
101,فيروزه,صندوق شاخص30 شركت فيروزه- سهام,3482,3624762,755732634430,193650,210300,207990,14340,7.41,208490,14840,7.66,206120,211500,1399-6-5
102,خموتور,موتورسازان‌تراكتورسازي‌ايران‌,3449,17028247,245326498590,15070,14320,14360,-710,-4.71,14410,-660,-4.38,14320,14700,1399-6-5
103,كترام,توليدي‌ كاشي‌ تكسرام‌,3435,7090661,170283559100,23620,24000,24800,1180,5.0,24020,400,1.69,22900,24800,1399-6-5
104,كماسه,تامين‌ ماسه‌ ريخته‌گري‌,3372,2840435,236272153990,80010,81890,84010,4000,5.0,83180,3170,3.96,78000,84010,1399-6-5
105,شجم,صنايع پتروشيمي تخت جمشيد,3244,16112085,179200385531,11332,10993,11160,-172,-1.52,11122,-210,-1.85,10993,11540,1399-6-5
106,ستران,سيمان‌ تهران‌,3233,4075410,224073168070,52430,54840,55050,2620,5.0,54980,2550,4.86,53400,55050,1399-6-5
107,آوا,صندوق س.سهام آواي معيار-س,3208,26909289,277581153780,9422,10100,10349,927,9.84,10315,893,9.48,10100,10599,1399-6-5
108,خفنر,فنرسازي‌خاور,3173,7510364,163063198870,22680,21550,21670,-1010,-4.45,21710,-970,-4.28,21550,22330,1399-6-5
109,ثاخت,بين‌المللي‌توسعه‌ساختمان,3144,20231852,133440001250,6310,6550,6620,310,4.91,6600,290,4.6,6500,6620,1399-6-5
110,فبيرا,بسته‌ بندي‌ ايران‌,3111,29104919,169327291783,5938,5760,5772,-166,-2.8,5818,-120,-2.02,5760,6039,1399-6-5
111,فولاد,فولاد مباركه اصفهان,3110,30151735,540017573850,17060,17910,17910,850,4.98,17910,850,4.98,17910,17910,1399-6-5
112,رنيك,جنرال مكانيك,3103,6638917,228234989721,33354,33000,35020,1666,4.99,34378,1024,3.07,33000,35021,1399-6-5
113,ولساپا,ليزينگ رايان‌ سايپا,3102,37784891,233510626380,5890,6180,6180,290,4.92,6180,290,4.92,6180,6180,1399-6-5
114,خوساز,محورسازان‌ايران‌خودرو,3096,12749900,143838512600,10920,10650,11460,540,4.95,11280,360,3.3,10650,11460,1399-6-5
115,وايران,ليزينگ ايرانيان,3038,13775370,203955023180,14160,14860,14860,700,4.94,14810,650,4.59,14460,14860,1399-6-5
116,تملت,تامين سرمايه بانك ملت,3038,11002321,196578690320,17020,17870,17870,850,4.99,17870,850,4.99,17400,17870,1399-6-5
117,وغدير,سرمايه‌گذاري‌غدير(هلدينگ‌,3028,33658553,594073460450,16810,17650,17650,840,5.0,17650,840,5.0,17650,17650,1399-6-5
118,غگرجي,بيسكويت‌  گرجي‌,3015,2495070,121124415050,40870,49000,48960,8090,19.79,48550,7680,18.79,46550,50000,1399-6-5
119,ثغرب,شركت سرمايه گذاري مسكن شمالغرب,2999,16649501,245412949921,15058,14306,14700,-358,-2.38,14740,-318,-2.11,14306,15700,1399-6-5
120,كگاز,شيشه‌ و گاز,2964,4670585,127207186050,28460,27040,27040,-1420,-4.99,27240,-1220,-4.29,27040,28900,1399-6-5
121,كالا,بورس كالاي ايران,2922,4055740,208953015460,49230,50200,51690,2460,5.0,51520,2290,4.65,50200,51690,1399-6-5
122,ثشرق,سرمايه گذاري مسكن شمال شرق,2903,20646479,163540618060,8010,7700,8060,50,0.62,7920,-90,-1.12,7610,8280,1399-6-5
123,واعتبار,سرمايه گذاري اعتبار ايران,2851,14333131,125782785300,8730,8850,8600,-130,-1.49,8780,50,0.57,8600,8990,1399-6-5
124,ورنا,سرمايه‌گذاري‌ رنا(هلدينگ‌,2834,14157299,209842270150,14170,14780,14870,700,4.94,14820,650,4.59,14520,14870,1399-6-5
125,دكوثر,داروسازي‌ كوثر,2804,4870011,152553293880,31550,29980,31710,160,0.51,31330,-220,-0.7,29980,32650,1399-6-5
126,كچاد,معدني‌وصنعتي‌چادرملو,2770,24423009,433508409750,16910,17750,17750,840,4.97,17750,840,4.97,17750,17750,1399-6-5
127,خشرق,الكتريك‌ خودرو شرق‌,2760,6519654,153151055920,22730,22960,23860,1130,4.97,23490,760,3.34,21600,23860,1399-6-5
128,كوير,توليدي فولاد سپيد فراب كوير,2755,9485933,181742722740,18290,18750,19200,910,4.98,19160,870,4.76,18750,19200,1399-6-5
129,شپنا,پالايش نفت اصفهان,2730,25570337,940732698230,35040,36790,36790,1750,4.99,36790,1750,4.99,36790,36790,1399-6-5
130,ذوب,سهامي ذوب آهن  اصفهان,2720,22784669,172069820288,7193,7552,7552,359,4.99,7552,359,4.99,7552,7552,1399-6-5
131,خكرمان,گروه اقتصادي كرمان خودرو,2708,31909812,318918068685,9715,9900,10006,291,3.0,9994,279,2.87,9720,10006,1399-6-5
132,كاما,باما,2698,1770147,399611041910,215780,226000,226560,10780,5.0,225750,9970,4.62,220000,226560,1399-6-5
133,غفارس,شير پاستوريزه پگاه فارس,2613,6785130,77945943159,11817,11227,11620,-197,-1.67,11488,-329,-2.78,11227,12000,1399-6-5
134,وحكمت,بيمه حكمت صبا,2600,16318230,101391989227,6080,6000,6261,181,2.98,6213,133,2.19,6000,6262,1399-6-5
135,آبين,كشت و صنعت آبشيرين,2592,14042159,75552780501,5365,5310,5427,62,1.16,5380,15,0.28,5230,5525,1399-6-5
136,ثاختح,ح . بين‌المللي‌توسعه‌ساختمان,2560,28115562,143818385880,4720,4930,5190,470,9.96,5120,400,8.47,4930,5190,1399-6-5
137,كاريس,صندوق س.سپهر كاريزما-س,2544,2707375,644570722075,222547,239000,241980,19433,8.73,238080,15533,6.98,234500,241980,1399-6-5
138,وتجارت,بانك تجارت,2533,85266683,266884717790,2990,3130,3130,140,4.68,3130,140,4.68,3130,3130,1399-6-5
139,وبصادر,بانك صادرات ايران,2482,150066881,532737427550,3390,3550,3550,160,4.72,3550,160,4.72,3550,3550,1399-6-5
140,غشهد,شهد ايران ‌,2429,8540133,82234277630,9380,9690,9840,460,4.9,9630,250,2.67,9180,9840,1399-6-5
141,خمهر,مهركام‌پارس‌,2426,14667107,151469385450,9970,10060,10460,490,4.91,10330,360,3.61,9620,10460,1399-6-5
142,شكربن,كربن‌ ايران‌,2421,2538863,202441062320,80980,84900,79200,-1780,-2.2,79740,-1240,-1.53,76940,85020,1399-6-5
143,زكوثر,سرمايه گذاري كشاورزي كوثر,2406,4164590,123353715300,28210,29620,29620,1410,5.0,29620,1410,5.0,29350,29620,1399-6-5
144,قشكر,شكرشاهرود,2385,4684271,290661269110,60250,60400,63260,3010,5.0,62050,1800,2.99,58040,63260,1399-6-5
145,فملي,ملي‌ صنايع‌ مس‌ ايران‌,2378,16684497,510045073290,29120,30570,30570,1450,4.98,30570,1450,4.98,30570,30570,1399-6-5
146,افقح,ح .فروشگاه زنجيره اي افق كوروش,2372,4773849,304716745990,58797,61900,64680,5883,10.01,63830,5033,8.56,60000,64680,1399-6-5
147,كشرق,صنعتي و معدني شمال شرق شاهرود,2352,1620690,150869009313,94299,90090,94100,-199,-0.21,93089,-1210,-1.28,90090,97000,1399-6-5
148,قشرين,قند شيرين خراسان,2342,10624074,255294577324,23374,24064,24075,701,3.0,24030,656,2.81,23374,24075,1399-6-5
149,فخاس,فولاد خراسان,2334,5933455,264049367210,42500,43900,44620,2120,4.99,44500,2000,4.71,43500,44620,1399-6-5
150,ثامان,سامان‌ گستراصفهان‌,2296,6176102,147480286040,24750,24940,23600,-1150,-4.65,23880,-870,-3.52,23520,25570,1399-6-5
151,غمينو,شركت صنايع غذايي مينو شرق,2281,4111476,75902218930,18142,18100,18670,528,2.91,18461,319,1.76,17950,18990,1399-6-5
152,فجام,جام‌دارو,2270,1685364,111140183300,64760,67400,67890,3130,4.83,65940,1180,1.82,62820,67990,1399-6-5
153,وپاسار,بانك  پاسارگاد,2264,33997649,381793598270,10700,11230,11230,530,4.95,11230,530,4.95,11230,11230,1399-6-5
154,بساما,بيمه سامان,2256,6112292,197401242689,32312,32500,33260,948,2.93,32296,-16,-0.05,31000,33290,1399-6-5
155,غسالم,سالمين‌,2251,9548302,72091454810,7200,7550,7560,360,5.0,7550,350,4.86,7500,7560,1399-6-5
156,وبهمن,سرمايه‌گذاري‌بهمن‌,2246,6779073,155702348000,22090,22500,23190,1100,4.98,22970,880,3.98,22000,23190,1399-6-5
157,وشمال,س. چشم انداز توسعه شمال,2227,2062457,205233625629,101517,100050,102000,483,0.48,99509,-2008,-1.98,98472,102000,1399-6-5
158,حخزر,كشتيراني درياي خزر,2226,6398887,234015223117,37021,35170,38300,1279,3.45,36571,-450,-1.22,35170,38872,1399-6-5
159,غشان,شيرپاستوريزه‌پگاه‌خراسان‌,2218,1201233,86070680610,72850,72550,71300,-1550,-2.13,71650,-1200,-1.65,70080,74400,1399-6-5
160,آتيمس,صندوق س.آرمان آتيه درخشان مس-س,2200,1000803,266684194592,251199,265100,274510,23311,9.28,266470,15271,6.08,260000,276000,1399-6-5
161,چدن,توليدي چدن سازان,2189,6257297,237780138730,36540,38290,38360,1820,4.98,38000,1460,4.0,37570,38360,1399-6-5
162,ثالوند,سرمايه گذاري مسكن الوند,2188,9440223,159376030743,17514,16639,16850,-664,-3.79,16883,-631,-3.6,16639,17500,1399-6-5
163,دزهراوي,داروسازي‌زهراوي‌,2184,8356176,139413523820,15970,16000,16760,790,4.95,16680,710,4.45,15990,16760,1399-6-5
164,كوثر,بيمه كوثر,2184,6571494,115367247350,17600,17800,17200,-400,-2.27,17556,-44,-0.25,16740,18280,1399-6-5
165,غپينو,پارس‌ مينو,2166,10262509,86149339400,8000,8400,8400,400,5.0,8390,390,4.88,8270,8400,1399-6-5
166,سفارس,سيمان فارس و خوزستان,2150,10011663,229057252120,21830,22760,22920,1090,4.99,22880,1050,4.81,22100,22920,1399-6-5
167,افق ملت,صندوق س در سهام افق ملت,2145,1375387,236825712350,161190,169200,177300,16110,9.99,172190,11000,6.82,168000,177300,1399-6-5
168,وبوعلي,سرمايه‌گذاري‌بوعلي‌,2142,12040496,139238215570,11140,11000,11690,550,4.94,11560,420,3.77,10880,11690,1399-6-5
169,قشير,قند شيروان قوچان و بجنورد,2122,3802352,125662229113,32793,34000,32800,7,0.02,33049,256,0.78,31154,34000,1399-6-5
170,وزمين,بانك ايران زمين,2101,27572800,551196031299,19629,19990,20021,392,2.0,19991,362,1.84,19630,20021,1399-6-5
171,غشاذر,پگاه‌آذربايجان‌غربي‌,2094,3314028,79881593920,24500,23650,23910,-590,-2.41,24100,-400,-1.63,23650,25190,1399-6-5
172,دعبيدح,ح . داروسازي‌ دكترعبيدي‌,2092,1643104,52272062430,28950,31560,31850,2900,10.02,31810,2860,9.88,30000,31850,1399-6-5
173,وكادو,تكادو,2060,4945269,124039831907,24906,24159,25010,104,0.42,25083,177,0.71,24159,25566,1399-6-5
174,وگستر,گسترش سرمايه گذاري ايرانيان,2047,8852092,265244592987,28612,29480,30042,1430,5.0,29964,1352,4.73,28664,30042,1399-6-5
175,وپست,پست بانك ايران,2041,6377795,105355746740,15930,16190,16720,790,4.96,16520,590,3.7,16100,16720,1399-6-5
176,تمحركه,ماشين‌سازي‌نيرومحركه‌,2023,5188170,122101212520,24350,23140,23670,-680,-2.79,23530,-820,-3.37,23140,24620,1399-6-5
177,رمپنا,گروه مپنا (سهامي عام),2022,12539035,519317806170,39460,41390,41430,1970,4.99,41420,1960,4.97,40310,41430,1399-6-5
178,زاگرس,پتروشيمي زاگرس,1992,3153812,478817947690,144785,149900,152024,7239,5.0,151822,7037,4.86,146000,152024,1399-6-5
179,ختراك,ريخته‌گري‌ تراكتورسازي‌ ايران‌,1990,7184925,170511882980,23610,23060,24240,630,2.67,23730,120,0.51,23060,24570,1399-6-5
180,مداران,داده‌پردازي‌ايران‌,1936,6516038,248493555310,40000,38000,38000,-2000,-5.0,38140,-1860,-4.65,38000,39000,1399-6-5
181,سمازن,سيمان‌مازندران‌,1934,7277943,88237070050,11680,11700,12260,580,4.97,12120,440,3.77,11700,12260,1399-6-5
182,شغدير,پتروشيمي غدير,1923,3578666,165699044601,44099,46303,46303,2204,5.0,46302,2203,5.0,46000,46303,1399-6-5
183,سپ,پرداخت الكترونيك سامان كيش,1921,3355580,99893556710,28650,29150,30080,1430,4.99,29770,1120,3.91,28800,30080,1399-6-5
184,وآذر,سرمايه‌گذاري‌توسعه‌آذربايجان‌,1900,1496045,232038924120,148070,155420,155470,7400,5.0,155100,7030,4.75,150500,155470,1399-6-5
185,وايرا,سرمايه گذاري صنايع ايران,1896,10845314,102981040386,9542,9500,9700,158,1.66,9495,-47,-0.49,9067,9980,1399-6-5
186,وسرمد,بيمه  سرمد,1872,8839857,83891761130,9669,9450,9600,-69,-0.71,9490,-179,-1.85,9379,9926,1399-6-5
187,ثتوسا,س.توسعه و عمران استان اردبيل,1852,1656012,132880594223,81766,79314,79314,-2452,-3.0,80241,-1525,-1.87,79314,84000,1399-6-5
188,ختورح,ح . رادياتور ايران‌,1849,6331026,198263867210,28640,30300,31500,2860,9.99,31320,2680,9.36,29110,31500,1399-6-5
189,كلوند,كاشي‌ الوند,1833,3610369,102335074260,28840,27400,28010,-830,-2.88,28340,-500,-1.73,27400,29500,1399-6-5
190,خفناور,مهندسي صنعتي روان فن آور,1831,4935683,127725416067,27051,25699,25800,-1251,-4.62,25878,-1173,-4.34,25699,27000,1399-6-5
191,وآرين,شركت توسعه اقتصادي آرين,1826,13350859,87458474287,6478,6300,6670,192,2.96,6551,73,1.13,6300,6672,1399-6-5
192,ونوين,بانك‌اقتصادنوين‌,1821,25279572,137015280240,5170,5420,5420,250,4.84,5420,250,4.84,5420,5420,1399-6-5
193,خودكفا,اقتصادي و خودكفايي آزادگان,1819,1286069,195922316543,147905,152342,152342,4437,3.0,152342,4437,3.0,152340,152342,1399-6-5
194,سشرق,سيمان‌ شرق‌,1814,6814849,68468541600,9640,9950,10120,480,4.98,10050,410,4.25,9670,10120,1399-6-5
195,خكاوه,سايپا ديزل,1813,14845877,113818763793,7460,7600,7683,223,2.99,7667,207,2.77,7590,7683,1399-6-5
196,شساخت,مهندسي و ساختمان صنايع نفت,1805,3741915,190412359511,50909,49401,52436,1527,3.0,50886,-23,-0.05,49382,52436,1399-6-5
197,كاسپين,داروسازي كاسپين تامين,1770,3034076,93274101098,32090,30486,30570,-1520,-4.74,30742,-1348,-4.2,30486,31880,1399-6-5
198,دبالك,مواد اوليه دارويي البرز بالك,1762,3903282,89168269390,22290,22200,22800,510,2.29,22844,554,2.49,21179,23404,1399-6-5
199,كاردان,صندوق س تجارت شاخصي كاردان,1755,658671,144665463510,202500,215200,222750,20250,10.0,219630,17130,8.46,215200,222750,1399-6-5
200,چافست,افست‌,1753,4605414,133069909490,29170,27720,29780,610,2.09,28890,-280,-0.96,27720,30250,1399-6-5
201,اعتماد,صندوق س.اعتماد آفرين پارسيان-د,1749,67217680,2157073602600,32042,32047,32105,63,0.2,32091,49,0.15,32047,32110,1399-6-5
202,ثنظام,س. ساختماني نظام مهندسي ايران,1726,2602654,117720228545,46035,45800,45460,-575,-1.25,45231,-804,-1.75,44654,47000,1399-6-5
203,فرابورس,فرابورس ايران,1714,1877010,105843852621,53839,56000,56530,2691,5.0,56390,2551,4.74,55000,56530,1399-6-5
204,خرينگ,رينگ‌سازي‌مشهد,1707,2908885,100176715170,33410,31770,35080,1670,5.0,34440,1030,3.08,31770,35080,1399-6-5
205,شگل,گلتاش‌,1693,4443994,143345166760,31270,32000,32830,1560,4.99,32260,990,3.17,31310,32830,1399-6-5
206,خپارس,پارس‌ خودرو,1680,7792397,103405108190,12640,13270,13270,630,4.98,13210,570,4.51,13270,13270,1399-6-5
207,وثوق,سرمايه گذاري وثوق امين,1675,3406199,57158756414,17037,16526,16690,-347,-2.04,16781,-256,-1.5,16526,17470,1399-6-5
208,غبشهر,صنعتي‌ بهشهر,1671,7366784,220832555450,28590,30010,30010,1420,4.97,29980,1390,4.86,28600,30010,1399-6-5
209,بالاس,مهندسي ساختمان تاسيسات راه آهن,1652,1147203,63493079708,54513,54550,56381,1868,3.43,55346,833,1.53,52000,56890,1399-6-5
210,وهنر,گروه توسعه هنر ايران,1631,18714032,120685247431,6536,6340,6600,64,0.98,6449,-87,-1.33,6340,6729,1399-6-5
211,تاصيكو,سرمايه گذاري صدرتامين,1629,18615340,271965784770,13920,14610,14610,690,4.96,14610,690,4.96,14530,14610,1399-6-5
212,شبندر,پالايش نفت بندرعباس,1617,12558770,531110383300,40280,42290,42290,2010,4.99,42290,2010,4.99,42290,42290,1399-6-5
213,تكنو,تكنوتار,1582,6424382,100182075160,16370,15560,15560,-810,-4.95,15590,-780,-4.76,15560,16290,1399-6-5
214,وثنو,سرمايه گذاري ساختماني نوين,1582,3930640,77826913070,20153,19580,19549,-604,-3.0,19800,-353,-1.75,19549,20690,1399-6-5
215,حكشتيح,ح . كشتيراني ج. ا. ا,1562,3725054,187278340710,46140,48850,50750,4610,9.99,50280,4140,8.97,48510,50750,1399-6-5
216,وساخت,سرمايه‌ گذاري‌ ساختمان‌ايران‌,1552,3353574,191219692270,54310,57020,57020,2710,4.99,57020,2710,4.99,56990,57020,1399-6-5
217,ومعادن,توسعه‌معادن‌وفلزات‌,1552,32003109,534451920300,15910,16700,16700,790,4.97,16700,790,4.97,16700,16700,1399-6-5
218,فلامي,لاميران‌,1545,823805,111839928810,140680,133650,133650,-7030,-5.0,135760,-4920,-3.5,133650,144990,1399-6-5
219,سپاها,سيمان‌سپاهان‌,1538,5264310,63581512260,11630,12100,12210,580,4.99,12080,450,3.87,11500,12210,1399-6-5
220,كتوكا,توليدي و خدمات صنايع نسوز توكا,1532,631105,105768360475,164606,169990,170150,5544,3.37,167592,2986,1.81,162030,171900,1399-6-5
221,دماوند,توليد نيروي برق دماوند,1531,1664880,96912664800,55439,58210,58210,2771,5.0,58210,2771,5.0,58210,58210,1399-6-5
222,قزوين,كارخانجات‌ قند قزوين‌,1522,3892367,207069432510,55450,52680,53000,-2450,-4.42,53200,-2250,-4.06,52680,55320,1399-6-5
223,ولبهمن,شركت بهمن ليزينگ,1494,7276296,89697637701,11958,11361,12550,592,4.95,12327,369,3.09,11361,12555,1399-6-5
224,غويتا,ويتانا,1490,5019465,318009741548,60394,63212,63413,3019,5.0,63355,2961,4.9,62900,63413,1399-6-5
225,آپ,آسان پرداخت پرشين,1483,3647442,103437981470,27080,28430,28430,1350,4.99,28360,1280,4.73,27100,28430,1399-6-5
226,سصفها,سيمان‌اصفهان‌,1482,663905,92219377700,143660,150780,136480,-7180,-5.0,138900,-4760,-3.31,136480,150780,1399-6-5
227,وخاور,بانك خاورميانه,1480,15023335,166657500470,10580,11080,11100,520,4.91,11090,510,4.82,11000,11100,1399-6-5
228,كروي,توسعه‌ معادن‌ روي‌ ايران‌,1470,2697962,130874714950,46250,48500,48560,2310,4.99,48510,2260,4.89,46480,48560,1399-6-5
229,دانا,بيمه دانا,1462,6157806,61064561610,9500,9850,9970,470,4.95,9920,420,4.42,9660,9970,1399-6-5
230,لابسا,آبسال‌,1460,2934905,123000583800,41670,40100,43000,1330,3.19,41910,240,0.58,39970,43600,1399-6-5
231,سكرد,سيمان كردستان,1435,4768227,59044324320,11910,12270,12500,590,4.95,12380,470,3.95,11710,12500,1399-6-5
232,تايرا,تراكتورسازي‌ايران‌,1424,2855606,91503763290,30840,32250,32380,1540,4.99,32040,1200,3.89,30510,32380,1399-6-5
233,چفيبر,فيبر ايران‌,1407,9765661,118884266620,11660,12240,12120,460,3.95,12170,510,4.37,11850,12240,1399-6-5
234,دسبحاح,ح .گروه دارويي سبحان,1402,948493,17579515110,2670,17020,18720,16050,601.12,18530,15860,594.01,17020,18720,1399-6-5
235,كطبس,ذغال‌سنگ‌ نگين‌ ط‌بس‌,1393,1728825,102901417040,62000,60000,58900,-3100,-5.0,59520,-2480,-4.0,58900,63500,1399-6-5
236,خنصير,مهندسي‌نصيرماشين‌,1390,2604738,144410522170,57050,57050,54200,-2850,-5.0,55440,-1610,-2.82,54200,59890,1399-6-5
237,ومهان,گروه توسعه مالي مهر آيندگان,1385,7564878,151108438050,19024,19975,19975,951,5.0,19975,951,5.0,19975,19975,1399-6-5
238,ارفع,شركت آهن و فولاد ارفع,1368,5830755,115104934455,18801,19741,19741,940,5.0,19741,940,5.0,19741,19741,1399-6-5
239,كپشير,پشم‌شيشه‌ايران‌,1367,1469210,84343573080,60300,57290,57290,-3010,-4.99,57410,-2890,-4.79,57290,58820,1399-6-5
240,آسيا,بيمه آسيا,1360,2888478,107466422440,35530,37190,37300,1770,4.98,37210,1680,4.73,36900,37300,1399-6-5
241,كرمان,س. توسعه و عمران استان كرمان,1352,2234929,282376574363,120331,126347,126347,6016,5.0,126347,6016,5.0,126347,126347,1399-6-5
242,خزر,فنرسازي‌زر,1352,4788039,49902244360,10120,10300,10620,500,4.94,10420,300,2.96,9930,10620,1399-6-5
243,حريل,ريل پردازسير,1348,8603978,50333190110,5572,5850,5850,278,4.99,5850,278,4.99,5840,5850,1399-6-5
244,وگردشح,ح . بانك گردشگري,1338,29978492,557480037232,19171,18596,18596,-575,-3.0,18596,-575,-3.0,18596,18596,1399-6-5
245,شاملا,معدني‌ املاح‌  ايران‌,1337,728790,114113996850,153880,156810,157980,4100,2.66,156580,2700,1.75,153000,161570,1399-6-5
246,داوه,داروسازي آوه سينا,1328,1829828,42859494794,22596,22970,23725,1129,5.0,23341,745,3.3,22490,23725,1399-6-5
247,حفارس,حمل و نقل بين المللي خليج فارس,1327,13254303,90180500680,6530,6660,6850,320,4.9,6800,270,4.13,6660,6850,1399-6-5
248,سنوين,سرمايه گذاري اقتصاد نوين,1326,11970453,146235232293,12170,12413,12409,239,1.96,12216,46,0.38,11927,12413,1399-6-5
249,ملت,بيمه ملت,1322,4748283,82203279640,16550,17370,17370,820,4.95,17310,760,4.59,15730,17370,1399-6-5
250,وسپه,سرمايه‌گذاري‌ سپه‌,1302,8131577,133195231260,15600,16380,16380,780,5.0,16380,780,5.0,16380,16380,1399-6-5
251,شيران,س. صنايع‌شيميايي‌ايران,1302,3731145,154058977050,39330,41290,41290,1960,4.98,41290,1960,4.98,41290,41290,1399-6-5
252,فروس,فروسيليس‌ ايران‌,1296,2300509,69996362620,29210,30670,30670,1460,5.0,30430,1220,4.18,29500,30670,1399-6-5
253,پاكشو,گروه صنعتي پاكشو,1290,1802729,110281039390,58780,61000,61710,2930,4.98,61170,2390,4.07,58900,61710,1399-6-5
254,كيميا,معدني كيمياي زنجان گستران,1289,1506595,60017933510,38194,39880,40103,1909,5.0,39837,1643,4.3,39190,40103,1399-6-5
255,دسانكو,داروسازي سبحان انكولوژي,1280,2619175,65323434610,24051,25000,25253,1202,5.0,24940,889,3.7,24067,25253,1399-6-5
256,پلاسك,پلاسكوكار,1276,7533817,77245183840,9880,9770,10370,490,4.96,10250,370,3.74,9650,10370,1399-6-5
257,سشمال,سيمان‌ شمال‌,1267,3783835,52503276580,13880,13210,13880,0,0.0,13880,0,0.0,13210,14470,1399-6-5
258,كبافق,معادن‌ بافق‌,1266,1240074,51901716460,39960,41900,41950,1990,4.98,41850,1890,4.73,40300,41950,1399-6-5
259,ساراب,سيمان‌ داراب‌,1247,2418070,33990312190,13590,13300,14250,660,4.86,13910,320,2.35,13300,14250,1399-6-5
260,دارا,صندوق س. دارا الگوريتم-د,1244,29183263,293849140384,10051,10070,10070,19,0.19,10069,18,0.18,10061,10100,1399-6-5
261,زگلدشت,كشت و دام گلدشت نمونه اصفهان,1243,1148882,53878882927,46464,44142,48000,1536,3.31,46897,433,0.93,44142,48587,1399-6-5
262,وبيمه,سرمايه‌ گذاري‌ صنعت‌ بيمه‌,1239,8220476,63025761790,7310,7670,7670,360,4.92,7670,360,4.92,7420,7670,1399-6-5
263,دجابر,داروسازي‌ جابرابن‌حيان‌,1233,1559080,82208849980,51110,49050,53660,2550,4.99,52730,1620,3.17,49050,53660,1399-6-5
264,كمينا,شيشه سازي مينا,1225,2242243,100935885693,45944,44605,44700,-1244,-2.71,45016,-928,-2.02,44566,47322,1399-6-5
265,پارند,صندوق س. پارند پايدار سپهر,1224,44720143,523587750010,11700,11670,11750,50,0.43,11710,10,0.09,11670,11770,1399-6-5
266,شپارسح,ح . بين‌ المللي‌محصولات پارس‌,1224,2279373,34746877374,650,14000,15400,14750,2269.23,15244,14594,2245.23,14000,15400,1399-6-5
267,وملي,گروه‌ صنعتي‌ ملي‌ (هلدينگ‌,1223,92550,61590174000,700500,665480,665480,-35020,-5.0,667740,-32760,-4.68,665480,665480,1399-6-5
268,سهگمت,سيمان‌هگمتان‌,1223,1978680,48012020200,24110,22910,24500,390,1.62,24260,150,0.62,22910,25000,1399-6-5
269,زشريف,كشت وصنعت شريف آباد,1222,1434503,45185290452,31202,32200,31379,177,0.57,31486,284,0.91,30700,32200,1399-6-5
270,وسديد,گروه ‌صنعتي‌سديد,1214,4552934,130866467654,28039,27954,28880,841,3.0,28743,704,2.51,27954,28880,1399-6-5
271,سيلام,سيمان‌ ايلام‌,1207,4672365,54469152010,11420,11030,11600,180,1.58,11660,240,2.1,10900,11990,1399-6-5
272,پاسا,ايران‌ياساتايرورابر,1205,1952201,52425940340,25820,26800,27110,1290,5.0,26850,1030,3.99,26000,27110,1399-6-5
273,زماهان,مجتمع توليد گوشت مرغ ماهان,1204,1557511,46265213476,29383,28300,29500,117,0.4,29705,322,1.1,28300,30389,1399-6-5
274,درهآور,دارويي ره آورد تامين,1198,1155370,46261298233,39374,41300,40990,1616,4.1,39995,621,1.58,37406,41300,1399-6-5
275,ولملت,واسپاري ملت,1190,3464274,51432710480,14180,14860,14880,700,4.94,14770,590,4.16,14300,14880,1399-6-5
276,وپسا,س. پتروشيمي ساختمان  خليج فارس,1186,12027038,68997556578,6008,5708,5708,-300,-4.99,5737,-271,-4.51,5708,5910,1399-6-5
277,سغرب,سيمان‌غرب‌,1186,1698232,41425305630,24710,23500,24220,-490,-1.98,24430,-280,-1.13,23500,25120,1399-6-5
278,وملل,اعتباري ملل,1181,17952577,346161589714,18364,19282,19282,918,5.0,19282,918,5.0,19282,19282,1399-6-5
279,حآسا,آسيا سير ارس,1173,2438478,37116958031,14954,14420,15180,226,1.51,15163,209,1.4,14420,15699,1399-6-5
280,آساس,صندوق س.آسمان آرماني سهام-س,1164,759162,134991204959,165357,178060,180400,15043,9.1,177816,12459,7.53,175200,180760,1399-6-5
281,ولغدر,ليزينگ‌خودروغدير,1164,9241255,188995941190,19510,20480,20480,970,4.97,20450,940,4.82,20010,20480,1399-6-5
282,خاهن,آهنگري‌ تراكتورسازي‌ ايران‌,1164,3078812,103024004800,31950,33480,33540,1590,4.98,33460,1510,4.73,32010,33540,1399-6-5
283,فلات,گروه صنايع معادن فلات ايرانيان,1162,4660135,79631853443,17528,17003,17030,-498,-2.84,17088,-440,-2.51,17003,17600,1399-6-5
284,داسوه,داروسازي‌ اسوه‌,1156,1682261,69555501200,41180,40000,41900,720,1.75,41350,170,0.41,39570,42870,1399-6-5
285,وسنا,سرمايه گذاري نيروگاهي ايران,1155,6003751,182849806647,30206,29300,31111,905,3.0,30456,250,0.83,29300,31112,1399-6-5
286,تاصيكوح,ح . سرمايه گذاري صدرتامين,1151,6603577,83477468990,11500,12540,12650,1150,10.0,12640,1140,9.91,12540,12650,1399-6-5
287,آينده,بازرگاني آينده سازان بهشت پارس,1151,3691144,90470425034,25760,24472,24472,-1288,-5.0,24510,-1250,-4.85,24472,25241,1399-6-5
288,غديس,پاكديس,1145,1352526,62625471480,44503,44510,46728,2225,5.0,46303,1800,4.04,44505,46728,1399-6-5
289,بهپاك,صنعتي بهپاك,1143,1644869,81410162334,47467,47090,49840,2373,5.0,49493,2026,4.27,47090,49840,1399-6-5
290,فروي,ذوب روي اصفهان,1141,530529,38805543705,69662,73145,73145,3483,5.0,72555,2893,4.15,73145,73145,1399-6-5
291,ولتجار,واسپاري تجارت وسرمايه ايرانيان,1132,5312145,44792353068,8524,8400,8402,-122,-1.43,8432,-92,-1.08,8170,8730,1399-6-5
292,تسه9904,امتياز تسهيلات مسكن تير99,1132,20903,15970340021,803858,765000,763666,-40192,-5.0,764021,-39837,-4.96,763666,765000,1399-6-5
293,حتوكا,حمل‌ونقل‌توكا,1122,11455270,246632228590,20720,21720,21750,1030,4.97,21530,810,3.91,20900,21750,1399-6-5
294,رتاپ,تجارت الكترونيك  پارسيان,1104,3272931,49715821890,14470,15190,15190,720,4.98,15190,720,4.98,15190,15190,1399-6-5
295,قجام,فرآوردههاي غذايي وقندتربت‌جام‌,1099,6589830,157167465655,23171,23865,23866,695,3.0,23850,679,2.93,23200,23866,1399-6-5
296,ددام,داروسازي زاگرس فارمد پارس,1093,2875335,47266829800,15800,16340,16590,790,5.0,16420,620,3.92,15680,16590,1399-6-5
297,لپارس,پارس‌ الكتريك‌,1088,124355,55784409450,472190,448590,448590,-23600,-5.0,448590,-23600,-5.0,448590,448590,1399-6-5
298,خفولا,خدمات فني فولاد يزد,1084,2053697,60124002012,29961,29063,29063,-898,-3.0,29276,-685,-2.29,29063,30800,1399-6-5
299,كرازي,كارخانجات‌توليدي‌شيشه‌رازي‌,1081,2781244,51050121190,17590,18400,18460,870,4.95,18360,770,4.38,18010,18460,1399-6-5
300,سدور,سيمان‌ دورود,1071,3639466,36950963070,9730,10150,10210,480,4.93,10050,320,3.29,9760,10210,1399-6-5
301,قشهد,شهد,1071,2583018,97795321440,39130,37180,37180,-1950,-4.98,37860,-1270,-3.25,37180,40800,1399-6-5
302,دسينا,داروسازي‌ سينا,1068,1160743,41780253430,35820,34820,36450,630,1.76,35970,150,0.42,34820,37270,1399-6-5
303,شنفت,نفت‌ پارس‌,1064,1300698,103620182090,76340,79460,80150,3810,4.99,79670,3330,4.36,77360,80150,1399-6-5
304,دعبيد,لابراتوارداروسازي‌  دكترعبيدي‌,1051,1418945,52412946520,35190,36940,36940,1750,4.97,36570,1380,3.92,36740,36940,1399-6-5
305,سجام,مجتمع سيمان غرب آسيا,1049,7445690,106986280388,14560,14560,14124,-436,-2.99,14369,-191,-1.31,14124,14560,1399-6-5
306,تليسه,دامداري تليسه نمونه,1042,674456,53172966379,75168,78925,78926,3758,5.0,78838,3670,4.88,76950,78926,1399-6-5
307,كگل,معدني و صنعتي گل گهر,1039,18243328,346075932160,18070,18970,18970,900,4.98,18970,900,4.98,18970,18970,1399-6-5
308,پارسان,گسترش نفت و گاز پارسيان,1038,8218784,237605045440,27540,28910,28910,1370,4.97,28910,1370,4.97,28910,28910,1399-6-5
309,ساروم,سيمان‌اروميه‌,1035,1869708,56833258280,29390,29380,30850,1460,4.97,30400,1010,3.44,29200,30850,1399-6-5
310,پتاير,ايران‌ تاير,1034,1648762,178537697180,105170,103200,110420,5250,4.99,108290,3120,2.97,103200,110420,1399-6-5
311,لبوتان,گروه‌صنعتي‌بوتان‌,1033,777074,69288360130,88450,84030,92870,4420,5.0,89170,720,0.81,84030,92870,1399-6-5
312,كگهر,سنگ آهن گهرزمين,1031,10824289,506674143801,44580,46809,46809,2229,5.0,46809,2229,5.0,46809,46809,1399-6-5
313,بورس,بورس اوراق بهادار تهران,1026,1228731,128398695830,99530,104500,104500,4970,4.99,104500,4970,4.99,104000,104500,1399-6-5
314,بالبر,كابل‌ البرز,1016,1284584,35414947540,28200,27680,27620,-580,-2.06,27730,-470,-1.67,27000,28860,1399-6-5
315,اتكام,شركت بيمه اتكايي امين,1008,6362634,55154712036,8296,8400,8710,414,4.99,8669,373,4.5,8360,8710,1399-6-5
316,افق,فروشگاههاي زنجيره اي افق كوروش,1000,2977606,218741381820,69980,73440,73470,3490,4.99,73460,3480,4.97,72300,73470,1399-6-5
317,ختوقا,قطعات‌ اتومبيل‌ ايران‌,999,6076148,35606227280,5590,5860,5860,270,4.83,5790,200,3.58,5860,5860,1399-6-5
318,فباهنر,مس‌ شهيدباهنر,995,1617222,101545238260,59800,62790,62790,2990,5.0,62790,2990,5.0,62100,62790,1399-6-5
319,بپاس,بيمه پاسارگاد,989,1807304,165633989688,87283,91647,91647,4364,5.0,91647,4364,5.0,91647,91647,1399-6-5
320,والبر,سرمايه‌ گذاري‌ البرز(هلدينگ‌,980,2810217,63370364490,21480,22550,22550,1070,4.98,22550,1070,4.98,22500,22550,1399-6-5
321,اوان,مبين وان كيش,976,828668,51846373904,63013,59870,63000,-13,-0.02,62566,-447,-0.71,59870,65000,1399-6-5
322,سفار,سيمان‌فارس‌,975,278330,31379587680,117220,116300,112890,-4330,-3.69,114220,-3000,-2.56,111360,116350,1399-6-5
323,بسويچ,پارس‌سويچ‌,971,592681,31111877640,52720,50200,51970,-750,-1.42,52570,-150,-0.28,50200,54810,1399-6-5
324,شسينا,صنايع‌شيميايي‌سينا,970,101397,47174732920,456840,444500,463000,6160,1.35,465160,8320,1.82,444000,478910,1399-6-5
325,زكشت,كشاورزي مكانيزه اصفهان كشت,968,1040390,41280741208,38997,39160,39840,843,2.16,39585,588,1.51,39000,40700,1399-6-5
326,شلرد,كود شيميايي اوره لردگان,968,5789484,83206464048,13954,14372,14372,418,3.0,14372,418,3.0,14372,14372,1399-6-5
327,كهمدا,شيشه‌ همدان‌,966,1742341,50264128330,27490,28860,28860,1370,4.98,28850,1360,4.95,27900,28860,1399-6-5
328,پرديس,سرمايه گذاري پرديس,940,4720201,53053810080,10710,11240,11240,530,4.95,11240,530,4.95,11100,11240,1399-6-5
329,شدوص,دوده‌ صنعتي‌ پارس‌,937,1658321,39417265480,23480,22950,23880,400,1.7,23720,240,1.02,22950,24480,1399-6-5
330,شپارس,بين‌ المللي‌ محصولات‌  پارس‌,931,2082534,39822434130,18290,18990,19200,910,4.98,18940,650,3.55,18840,19200,1399-6-5
331,بكهنوج,توليد برق ماهتاب كهنوج,929,927005,61485510840,63322,66000,66488,3166,5.0,66327,3005,4.75,64550,66488,1399-6-5
332,خمحور,توليدمحورخودرو,923,1167205,83302884890,68340,71720,71750,3410,4.99,71370,3030,4.43,68500,71750,1399-6-5
333,دپارس,پارس‌ دارو,920,520897,53739373260,100410,103800,105430,5020,5.0,103170,2760,2.75,96510,105430,1399-6-5
334,غمارگ,مارگارين‌,919,1433106,53878121510,35930,37000,37720,1790,4.98,37600,1670,4.65,36660,37720,1399-6-5
335,سكرما,سيمان‌ كرمان‌,915,1928986,37222343710,19490,18600,19600,110,0.56,19340,-150,-0.77,18600,20000,1399-6-5
336,بمپنا,توليد برق عسلويه  مپنا,915,312274,38457954514,121012,125000,124000,2988,2.47,122732,1720,1.42,114962,127059,1399-6-5
337,قلرست,قند لرستان‌,914,2027792,62814005010,30980,29700,30720,-260,-0.84,30980,0,0.0,29700,32520,1399-6-5
338,غالبر,لبنيات‌ كالبر,912,2577307,38982392150,14650,15190,15380,730,4.98,15020,370,2.53,14720,15380,1399-6-5
339,داناح,ح . بيمه دانا,909,10200000,78770398860,7030,7730,7730,700,9.96,7720,690,9.82,7400,7730,1399-6-5
340,فايرا,آلومينيوم‌ايران‌,908,2383151,57360659800,22960,23990,24100,1140,4.97,24070,1110,4.83,23030,24100,1399-6-5
341,خديزل,بهمن  ديزل,907,1285441,64624063172,48439,50850,50390,1951,4.03,50274,1835,3.79,48900,50860,1399-6-5
342,عيار,صندوق س. پشتوانه طلاي مفيد,906,1362685,43010377887,31125,32000,31900,775,2.49,31563,438,1.41,31202,32136,1399-6-5
343,چكارن,كارتن‌ ايران‌,905,5039099,32703752510,6190,6490,6490,300,4.85,6400,210,3.39,6490,6490,1399-6-5
344,شبصير,توليدات پتروشيمي قائد بصير,903,814502,124430758139,145507,152782,152782,7275,5.0,152769,7262,4.99,149361,152782,1399-6-5
345,دتوزيع,توزيع دارو پخش,900,648771,41081987112,60480,63350,63504,3024,5.0,62770,2290,3.79,62200,63504,1399-6-5
346,كمنگنز,معادن‌منگنزايران‌,898,972228,108934299500,107310,112670,112670,5360,4.99,112050,4740,4.42,110000,112670,1399-6-5
347,هجرت,پخش هجرت,896,707374,52150390175,70753,73150,74290,3537,5.0,73724,2971,4.2,71150,74290,1399-6-5
348,فارس,صنايع پتروشيمي خليج فارس,890,7842328,216683522640,26320,27630,27630,1310,4.98,27630,1310,4.98,27630,27630,1399-6-5
349,غبهنوش,بهنوش‌ ايران‌,884,434385,36810794530,83960,88120,85490,1530,1.82,84550,590,0.7,83000,88120,1399-6-5
350,آ س پ,آ.س.پ,883,2642795,42601867403,15617,16100,16397,780,4.99,16056,439,2.81,15630,16397,1399-6-5
351,وتوشه,سرمايه‌ گذاري‌ پارس‌ توشه‌,881,3733104,104766460280,27120,26000,28470,1350,4.98,28060,940,3.47,26000,28470,1399-6-5
352,رتكو,كنترل‌خوردگي‌تكين‌كو,874,1746958,39073431770,21980,22000,22400,420,1.91,22300,320,1.46,21980,23000,1399-6-5
353,ميدكو,هلدينگ صنايع  معدني خاورميانه,862,7697884,171860943155,21277,22140,22340,1063,5.0,22326,1049,4.93,21310,22340,1399-6-5
354,سيدكو,سرمايه گذاري توسعه صنايع سيمان,856,5047953,50105688340,9460,9930,9930,470,4.97,9930,470,4.97,9630,9930,1399-6-5
355,پارس,پتروشيمي پارس,854,953858,137498630700,137290,144150,144150,6860,5.0,144150,6860,5.0,144150,144150,1399-6-5
356,شفارا,پتروشيمي فارابي,853,5149374,30478642007,5771,5610,5944,173,3.0,5919,148,2.56,5610,5944,1399-6-5
357,افرا,افرانت,849,1209883,93874194644,74639,78370,78140,3501,4.69,77589,2950,3.95,73510,78370,1399-6-5
358,شرانل,نفت ايرانول,841,1120135,35441705114,30159,31500,31666,1507,5.0,31281,1122,3.72,30950,31666,1399-6-5
359,ساربيل,سيمان آرتا اردبيل,834,314359,39906109080,127000,120650,125800,-1200,-0.94,126950,-50,-0.04,120650,129850,1399-6-5
360,طلا,صندوق س.پشتوانه طلاي لوتوس,831,339918,31637050421,91001,93100,93550,2549,2.8,93073,2072,2.28,92600,93550,1399-6-5
361,وتوكا,سرمايه‌گذاري‌توكافولاد(هلدينگ,831,4358037,59737240100,13060,13710,13710,650,4.98,13710,650,4.98,13560,13710,1399-6-5
362,كگهرح,ح . سنگ آهن گهرزمين,822,9660410,400931977701,39527,41503,41503,1976,5.0,41503,1976,5.0,41000,41503,1399-6-5
363,جم,پتروشيمي جم,822,2816504,115814001250,39170,41120,41120,1950,4.98,41120,1950,4.98,41000,41120,1399-6-5
364,خكار,ايركا پارت صنعت,817,1389537,63381410230,43780,45800,45960,2180,4.98,45610,1830,4.18,43810,45960,1399-6-5
365,پخش,پخش البرز,815,1133433,49323851907,42146,40040,44253,2107,5.0,43517,1371,3.25,40040,44253,1399-6-5
366,لخزر,پارس‌ خزر,811,609032,148330004790,235880,238980,240000,4120,1.75,243550,7670,3.25,230000,247670,1399-6-5
367,زمگسا,كشاورزي‌ ودامپروي‌ مگسال‌,808,1348865,49191624070,36160,35500,36470,310,0.86,36470,310,0.86,34550,37870,1399-6-5
368,پارتا,مجتمع‌صنعتي‌آرتاويل‌تاير,807,1444738,99757033565,70989,72995,70000,-989,-1.39,69049,-1940,-2.73,68860,72995,1399-6-5
369,سخاش,سيمان‌خاش‌,798,347054,30362596610,86530,89500,87000,470,0.54,87120,590,0.68,86530,89500,1399-6-5
370,كلر,كلر پارس,797,314997,27433088730,82943,87090,87090,4147,5.0,85348,2405,2.9,87090,87090,1399-6-5
371,سباقر,سيمان باقران,797,2627490,41517512833,15445,15100,15908,463,3.0,15801,356,2.3,15100,15908,1399-6-5
372,شپاكسا,پاكسان‌,796,1379963,45562482070,31500,32880,33070,1570,4.98,32940,1440,4.57,32450,33070,1399-6-5
373,واحصا,احياء صنايع خراسان,794,1177837,21070753130,17805,17530,17652,-153,-0.86,17889,84,0.47,17530,18339,1399-6-5
374,اپرداز,آتيه داده پرداز,793,2175744,74383360589,32609,34200,34239,1630,5.0,34188,1579,4.84,33400,34239,1399-6-5
375,ركيش,كارت اعتباري ايران كيش,790,3226437,73339907280,21860,22880,22950,1090,4.99,22730,870,3.98,22000,22950,1399-6-5
376,مفاخر,توسعه فناوري اطلاعات خوارزمي,787,2807967,127179078305,43651,43700,45833,2182,5.0,45292,1641,3.76,41500,45833,1399-6-5
377,سيمرغ,سيمرغ,786,1867935,44884977000,22920,23890,24060,1140,4.97,23980,1060,4.62,23700,24060,1399-6-5
378,فخوز,فولاد  خوزستان,782,8927364,388786702200,41480,43550,43550,2070,4.99,43550,2070,4.99,43550,43550,1399-6-5
379,سرود,سيمان‌شاهرود,769,2435783,46471862510,18210,18900,19120,910,5.0,18990,780,4.28,18440,19120,1399-6-5
380,كويرح,ح. توليدي فولاد سپيد فراب كوير,768,3791077,51103717960,12250,13480,13480,1230,10.04,13480,1230,10.04,13480,13480,1399-6-5
381,شبريز,پالايش نفت تبريز,760,3069256,139067989360,43160,45310,45310,2150,4.98,45310,2150,4.98,45310,45310,1399-6-5
382,تكشاح,ح . صنايع‌وخدمات‌كشاورزي‌,755,2102523,112547060380,49160,52050,54080,4920,10.01,53530,4370,8.89,50050,54080,1399-6-5
383,اعتلا,شركت سرمايه گذاري اعتلاء البرز,755,2757814,40131709328,15317,14552,14552,-765,-4.99,14650,-667,-4.35,14552,14552,1399-6-5
384,ثشرقح,ح. سرمايه گذاري مسكن شمال شرق,754,1690435,9686422830,5270,5640,5800,530,10.06,5730,460,8.73,5340,5800,1399-6-5
385,شبهرن,نفت‌ بهران‌,746,2604662,212618559060,77750,81630,81630,3880,4.99,81630,3880,4.99,81630,81630,1399-6-5
386,دشيمي,شيمي‌ داروئي‌ داروپخش‌,743,908684,56385979400,60130,63000,63130,3000,4.99,62050,1920,3.19,60500,63130,1399-6-5
387,لازما,كارخانه هاي صنعتي آزمايش,743,1177017,40225307533,34426,35113,33738,-688,-2.0,34176,-250,-0.73,33738,35113,1399-6-5
388,شتوكا,توكا رنگ فولاد سپاهان,737,751294,30334746235,39607,40500,40590,983,2.48,40083,476,1.2,39700,41500,1399-6-5
389,بذر,صندوق س بذر اميد آفرين-سهام,730,530596,72407526260,127290,132000,136700,9410,7.39,136460,9170,7.2,131100,140010,1399-6-5
390,دكيمي,كيميدارو,728,1651350,53832662130,31940,31100,33200,1260,3.94,32600,660,2.07,30350,33330,1399-6-5
391,ثاباد,توريستي ورفاهي آبادگران ايران,721,1751114,61904410570,35890,34710,34100,-1790,-4.99,35350,-540,-1.5,34100,36980,1399-6-5
392,زپارس,ملي كشت و صنعت و دامپروري پارس,718,459433,46353489650,97780,101000,102660,4880,4.99,100890,3110,3.18,93000,102660,1399-6-5
393,خلنت,لنت‌ ترمزايران‌,711,265083,27525544720,102860,97720,105630,2770,2.69,103410,550,0.53,97720,106600,1399-6-5
394,وبانك,سرمايه گذاري گروه توسعه ملي,709,4443366,99175929120,21260,22320,22320,1060,4.99,22320,1060,4.99,22320,22320,1399-6-5
395,بنيرو,نيروترانس‌,705,548853,44303377720,76940,80780,80780,3840,4.99,80330,3390,4.41,77070,80780,1399-6-5
396,دالبر,البرزدارو,702,1331815,32134337880,23050,24200,24200,1150,4.99,23740,690,2.99,23610,24200,1399-6-5
397,لوتوس,تامين سرمايه لوتوس پارسيان,702,3102602,55102211520,16920,17760,17760,840,4.96,17640,720,4.26,17760,17760,1399-6-5
398,غدام,خوراك‌  دام‌ پارس‌,699,738718,91153114590,117530,123400,123400,5870,4.99,123390,5860,4.99,121050,123400,1399-6-5
399,وكار,بانك‌ كارآفرين‌,694,3598741,56162449170,14890,15620,15630,740,4.97,15610,720,4.84,15300,15630,1399-6-5
400,ومعلم,بيمه معلم,693,2810919,51702479480,17604,18390,18484,880,5.0,18378,774,4.4,17850,18484,1399-6-5
401,كپرور,فرآوري زغال سنگ پروده طبس,689,842889,41746806130,49591,47550,48500,-1091,-2.2,49535,-56,-0.11,47550,52000,1399-6-5
402,شفن,پتروشيمي فناوران,689,307266,88400488420,274820,288500,288560,13740,5.0,286640,11820,4.3,280000,288560,1399-6-5
403,ثپرديسح,ح.سرمايه گذاري مسكن پرديس,684,1293085,12994621602,9625,10100,10106,481,5.0,10049,424,4.41,9700,10106,1399-6-5
404,قهكمت,قندهكمتان‌,677,654960,36954219370,56080,54180,55000,-1080,-1.93,56350,270,0.48,54180,58670,1399-6-5
405,زفكا,كشت و دامداري فكا,673,848138,40518735939,45878,45890,48171,2293,5.0,47468,1590,3.47,45890,48171,1399-6-5
406,توريل,توکاريل,670,2109790,45305687525,20472,21495,21495,1023,5.0,21444,972,4.75,20760,21495,1399-6-5
407,هرمز,فولاد هرمزگان جنوب,670,4458825,57264689475,12232,12843,12843,611,5.0,12525,293,2.4,12843,12843,1399-6-5
408,كخاك,صنايع‌خاك‌چيني‌ايران‌,669,420104,69395783030,157630,165510,165510,7880,5.0,165190,7560,4.8,160180,165510,1399-6-5
409,قصفها,قنداصفهان‌,658,232872,54239530970,221830,232920,232920,11090,5.0,232920,11090,5.0,230750,232920,1399-6-5
410,تسه9902,امتياز تسهيلات مسكن ارديبهشت99,655,7956,6008963346,793660,753977,754000,-39660,-5.0,755274,-38386,-4.84,753977,760764,1399-6-5
411,دفارا,داروسازي‌ فارابي‌,652,1133138,82979695740,69750,73230,73230,3480,4.99,73230,3480,4.99,73230,73230,1399-6-5
412,سبهان,سيمان‌ بهبهان‌,647,439825,29189977290,63690,65800,66870,3180,4.99,65250,1560,2.45,64210,66870,1399-6-5
413,سكارون,سيمان كارون,641,1009665,134959914057,129832,133700,133726,3894,3.0,133668,3836,2.95,130000,133726,1399-6-5
414,ريشمك,توليد و صادرات ريشمك,641,1293469,51098255608,37779,39650,39667,1888,5.0,39505,1726,4.57,38000,39667,1399-6-5
415,سهرمز,سيمان‌هرمزگان‌,640,1420698,26732629010,18040,18500,18940,900,4.99,18450,410,2.27,18050,18940,1399-6-5
416,شجمح,ح. صنايع پتروشيمي تخت جمشيد,636,7250982,58322037363,7824,8058,8058,234,2.99,8043,219,2.8,7850,8058,1399-6-5
417,ولانا,شركت ليزينگ آريا دانا,636,1626831,43696217322,26107,26880,26890,783,3.0,26860,753,2.88,26294,26890,1399-6-5
418,گوهران,سرمايه گذاري توسعه گوهران اميد,629,2768385,29731834320,10229,10740,10740,511,5.0,10532,303,2.96,10540,10740,1399-6-5
419,فاما,صنعتي‌ آما,629,1508036,34347862470,21700,22780,22780,1080,4.98,22480,780,3.59,22610,22780,1399-6-5
420,حپترو,حمل و نقل پتروشيمي( سهامي عام,624,469448,15601761470,32930,31290,33800,870,2.64,33020,90,0.27,31290,34500,1399-6-5
421,وتوس,توسعه‌شهري‌توس‌گستر,624,1511067,64326122190,40550,42570,42570,2020,4.98,42570,2020,4.98,42570,42570,1399-6-5
422,غگلپا,شير پاستوريزه پگاه گلپايگان,618,320670,24979243522,81251,78266,77189,-4062,-5.0,79473,-1778,-2.19,77189,81190,1399-6-5
423,مبين,مبين انرژي خليج فارس,616,5816224,146219871360,23950,25140,25140,1190,4.97,25140,1190,4.97,25140,25140,1399-6-5
424,آسام,صندوق س.آرمان سپهر آشنا-م,612,480170,60879817220,124041,125030,126870,2829,2.28,126788,2747,2.21,125030,128470,1399-6-5
425,كيان,صندوق س. با درآمد ثابت كيان,608,18185980,455362149150,24940,25140,25170,230,0.92,25040,100,0.4,24910,25200,1399-6-5
426,تسه9903,امتياز تسهيلات مسكن خرداد99,607,5691,4306454152,794204,755888,755000,-39204,-4.94,756713,-37491,-4.72,754494,766500,1399-6-5
427,تسه9810,امتياز تسهيلات مسكن دي98,601,14005,10800831319,785904,771001,763000,-22904,-2.91,771212,-14692,-1.87,746609,825000,1399-6-5
428,امين يكم2,صندوق درآمد ثابت امين يكم فردا,600,60000000,60000000,10420,1,1,-10419,-99.99,1,-10419,-99.99,1,1,1399-6-5
429,دارو,كارخانجات‌داروپخش‌,597,472456,28063506260,56760,59580,59590,2830,4.99,58230,1470,2.59,57500,59590,1399-6-5
430,بكاب,صنايع‌جوشكاب‌يزد,593,175389,24227716220,132340,138600,138950,6610,4.99,134890,2550,1.93,132340,138950,1399-6-5
431,نوين,بيمه نوين,587,4230283,28837854961,6502,6824,6827,325,5.0,6694,192,2.95,6628,6827,1399-6-5
432,فزرين,زرين معدن آسيا,585,1651776,40807438914,23559,24670,24736,1177,5.0,24510,951,4.04,24070,24736,1399-6-5
433,شزنگ,تجهيزنيروي‌زنگان‌,582,355226,31323207341,90105,86501,91500,1395,1.55,88178,-1927,-2.14,86501,93500,1399-6-5
434,ثرود,سرمايه‌گذاري مسكن زاينده رود,581,2844935,38578242924,13419,13242,13650,231,1.72,13532,113,0.84,12800,14000,1399-6-5
435,رانفور,خدمات‌انفورماتيك‌,581,2169346,77185330680,33890,35580,35580,1690,4.99,35260,1370,4.04,35580,35580,1399-6-5
436,فسا,پتروشيمي فسا,577,4610820,14782288920,3305,3206,3206,-99,-3.0,3229,-76,-2.3,3206,3206,1399-6-5
437,دروز,داروسازي‌ روزدارو,575,3381229,72014900150,20730,19810,21760,1030,4.97,21300,570,2.75,19810,21760,1399-6-5
438,دسبحا,گروه دارويي سبحان,570,1759175,36685519570,20190,19480,21190,1000,4.95,20710,520,2.58,19450,21190,1399-6-5
439,بترانس,ايران‌ ترانسفو,570,726018,38457173460,50450,52970,52970,2520,5.0,51670,1220,2.42,52970,52970,1399-6-5
440,دفرا,فرآورده‌هاي‌ تزريقي‌ ايران‌,569,596696,18072550450,30670,30010,29990,-680,-2.22,30530,-140,-0.46,29550,31000,1399-6-5
441,وصنا,گروه‌صنايع‌بهشهرايران‌,568,1678717,22591388470,12830,13470,13470,640,4.99,13120,290,2.26,13030,13470,1399-6-5
442,وآوا,سرمايه گذاري آوا نوين,563,3457557,56740423511,15674,16299,16457,783,5.0,16411,737,4.7,16110,16457,1399-6-5
443,چكاوه,صنايع‌كاغذسازي‌كاوه‌,561,569921,22511879500,41570,39500,39500,-2070,-4.98,40570,-1000,-2.41,39500,39500,1399-6-5
444,شپاس,نفت پاسارگاد,560,1406428,42003682463,28535,29961,29961,1426,5.0,29659,1124,3.94,29248,29961,1399-6-5
445,دكپسول,توليد ژلاتين كپسول ايران,558,705870,31574920687,42953,45100,45000,2047,4.77,44072,1119,2.61,43300,45100,1399-6-5
446,شفارس,صنايع‌ شيميايي‌ فارس‌,555,1095565,49797147070,43300,45390,45460,2160,4.99,45450,2150,4.97,45390,45460,1399-6-5
447,وصنعت,سرمايه گذاري توسعه صنعت وتجارت,555,2776521,32818478220,11260,11820,11820,560,4.97,11640,380,3.37,11820,11820,1399-6-5
448,سقاين,سيمان‌ قائن‌,548,491358,23658478190,49550,48020,47800,-1750,-3.53,48850,-700,-1.41,47080,51000,1399-6-5
449,گكيشح,ح.توريستي ورفاهي آبادگران كيش,544,1194797,60141381970,50197,48692,51702,1505,3.0,50336,139,0.28,48692,51702,1399-6-5
450,وصندوق,سرمايه‌گذاري‌صندوق‌بازنشستگي‌,534,5871903,116322398430,18870,19810,19810,940,4.98,19810,940,4.98,19810,19810,1399-6-5
451,كساوه,صنايع‌ كاشي‌ و سراميك‌ سينا,525,1291904,58453245460,43380,44950,45540,2160,4.98,45250,1870,4.31,43510,45540,1399-6-5
452,درازك,دارويي‌ رازك‌,521,494315,25343338900,49370,49000,51700,2330,4.72,50360,990,2.01,49000,51830,1399-6-5
453,شوينده,مديريت صنعت شوينده ت.ص.بهشهر,517,897209,39076772650,41510,43470,43580,2070,4.99,43140,1630,3.93,43020,43580,1399-6-5
454,ثجوان,تامين مسكن جوانان,515,2626681,29988747815,10929,11469,11475,546,5.0,11417,488,4.47,11150,11475,1399-6-5
455,غپآذر,شير پگاه آذربايجان شرقي,512,284313,17161187692,60008,62000,60000,-8,-0.01,60130,122,0.2,58600,62000,1399-6-5
456,نوري,پتروشيمي نوري,510,1076680,163483091200,144610,151840,151840,7230,5.0,151840,7230,5.0,151840,151840,1399-6-5
457,پارسيان,بيمه پارسيان,508,4349410,74224538710,16290,17100,17100,810,4.97,17070,780,4.79,16500,17100,1399-6-5
458,تنوين,تامين سرمايه نوين,496,3958001,50424932740,12140,12740,12740,600,4.94,12740,600,4.94,12740,12740,1399-6-5
459,ميدكوح,ح.هلدينگ صنايع معدن خاورميانه,495,1128580,21598749347,18236,19001,19147,911,5.0,19138,902,4.95,18600,19147,1399-6-5
460,شاراك,پتروشيمي شازند,494,3214251,74538480690,22090,23190,23190,1100,4.98,23190,1100,4.98,23190,23190,1399-6-5
461,فنفت,صنايع تجهيزات نفت,493,978460,19379283649,19428,20000,20010,582,3.0,19790,362,1.86,18847,20010,1399-6-5
462,حپارسا,توسعه حمل و نقل ريلي پارسيان,491,1185550,51438827188,41484,43250,43558,2074,5.0,43388,1904,4.59,41610,43558,1399-6-5
463,شپديس,پتروشيمي پرديس,487,5902432,579028579200,93430,98100,98100,4670,5.0,98100,4670,5.0,98100,98100,1399-6-5
464,خراسان,پتروشيمي خراسان,481,818722,67466852280,78560,81990,82480,3920,4.99,82410,3850,4.9,79040,82480,1399-6-5
465,غشوكوح,ح . شوكو پارس,472,1037454,26362542055,24793,25536,25536,743,3.0,25411,618,2.49,24100,25536,1399-6-5
466,ميهن,بيمه ميهن,471,7347382,56220134927,7302,7650,7667,365,5.0,7652,350,4.79,7320,7667,1399-6-5
467,داراب,پتروشيمي داراب,470,5407338,17573848500,3421,3250,3250,-171,-5.0,3261,-160,-4.68,3250,3250,1399-6-5
468,جهرم,پتروشيمي جهرم,461,3227021,10968644379,3577,3399,3399,-178,-4.98,3473,-104,-2.91,3399,3399,1399-6-5
469,دتماد,توليدمواداوليه‌داروپخش‌,445,624532,27821354130,42570,43000,44690,2120,4.98,44130,1560,3.66,43000,44690,1399-6-5
470,سفانو,سيمان فارس نو,442,1006437,33974585840,32380,32200,33990,1610,4.97,33300,920,2.84,32200,33990,1399-6-5
471,دالبرح,ح . البرزدارو,438,7778200,159511594000,19850,21840,20500,650,3.27,20510,660,3.32,19550,21840,1399-6-5
472,فسازان,غلتك سازان سپاهان,438,770064,32003859840,39590,41560,41560,1970,4.98,40800,1210,3.06,41560,41560,1399-6-5
473,وآيند,بانك  آينده,436,6436056,192283609056,29291,29876,29876,585,2.0,29876,585,2.0,29876,29876,1399-6-5
474,دمعيار,صندوق س. توازن معيار-د,421,18324780,183857033681,10017,10025,10050,33,0.33,10033,16,0.16,10020,10050,1399-6-5
475,ضصاد8024,اختيارخ وبصادر-5500-1399/08/11,421,20824,10784550000,323,400,550,227,70.28,518,195,60.37,400,565,1399-6-5
476,كحافظ,كاشي‌ وسراميك‌ حافظ‌,420,1580178,24413750100,14720,15450,15450,730,4.96,15050,330,2.24,15450,15450,1399-6-5
477,حسينا,توسعه خدمات دريايي وبندري سينا,418,1563293,92442204969,56318,59133,59133,2815,5.0,59133,2815,5.0,59133,59133,1399-6-5
478,وثخوز,سرمايه گذاري و توسعه خوزستان,412,554134,22312713352,40851,38809,38840,-2011,-4.92,40266,-585,-1.43,38809,42800,1399-6-5
479,وتوسم,سرمايه‌گذاري‌توسعه‌ملي‌,409,2818450,42304934500,14300,15010,15010,710,4.97,14910,610,4.27,15010,15010,1399-6-5
480,وبشهر,توسعه‌ صنايع‌ بهشهر(هلدينگ,400,2880366,63125266960,20880,21920,21920,1040,4.98,21780,900,4.31,21270,21920,1399-6-5
481,كفرا,فراورده‌ هاي‌ نسوزايران‌,398,518484,24965867450,45900,48180,48190,2290,4.99,47000,1100,2.4,47110,48190,1399-6-5
482,كفرآور,فرآورده هاي سيمان شرق,398,3697019,64248243150,16948,17440,17456,508,3.0,17378,430,2.54,16901,17456,1399-6-5
483,فسرب,ملي‌ سرب‌وروي‌ ايران‌,398,352099,51807846860,140140,147140,147140,7000,5.0,147140,7000,5.0,147140,147140,1399-6-5
484,سبجنو,سيمان‌ بجنورد,396,402159,14599904290,35760,34010,36380,620,1.73,35930,170,0.48,34010,37190,1399-6-5
485,وپخش,داروپخش‌ (هلدينگ‌,394,108493,14352343670,126380,132350,132690,6310,4.99,128050,1670,1.32,129000,132690,1399-6-5
486,زشگزا,شير و گوشت زاگرس شهركرد,391,433853,50147332858,110082,115586,115586,5504,5.0,115586,5504,5.0,115586,115586,1399-6-5
487,بشهاب,لامپ‌  پارس‌ شهاب‌,389,147345,11804297230,78830,78880,80010,1180,1.5,79130,300,0.38,78880,82600,1399-6-5
488,سيستم,همكاران سيستم,388,976010,29147094750,28740,30000,30170,1430,4.98,29380,640,2.23,28740,30170,1399-6-5
489,كقزوي,شيشه‌ قزوين‌,387,1483075,17006421025,11821,11467,11467,-354,-2.99,11501,-320,-2.71,11467,11467,1399-6-5
490,ماديرا,صنايع ماشين هاي اداري ايران,385,1622556,83770943724,49171,51629,51629,2458,5.0,51629,2458,5.0,51629,51629,1399-6-5
491,آريان,سرمايه گذاري پارس آريان,384,4766060,94949447320,20538,19922,19922,-616,-3.0,19922,-616,-3.0,19922,19922,1399-6-5
492,پسهند,صنايع‌ لاستيكي‌  سهند,381,843954,53201199290,60050,63050,63050,3000,5.0,63040,2990,4.98,62100,63050,1399-6-5
493,غشصفا,شيرپاستوريزه‌پگاه‌اصفهان‌,372,1627914,52658632170,30810,32250,32350,1540,5.0,32350,1540,5.0,31890,32350,1399-6-5
494,شفا,سرمايه گذاري شفادارو,370,1800977,119368603550,63130,66280,66280,3150,4.99,66280,3150,4.99,66150,66280,1399-6-5
495,سمتاز,سيمان ممتازان كرمان,367,1238612,29104285375,24105,23798,23810,-295,-1.22,23497,-608,-2.52,23382,24489,1399-6-5
496,شكبير,پتروشيمي اميركبير,364,645266,41824675256,66583,64586,65700,-883,-1.33,65792,-791,-1.19,64586,68500,1399-6-5
497,شكلر,نيروكلر,363,1013613,49879895730,46870,49210,49210,2340,4.99,49200,2330,4.97,49210,49210,1399-6-5
498,حبندر,دريايي و کشتيراني خط دريابندر,362,326562,8567354070,27046,26235,26235,-811,-3.0,26677,-369,-1.36,26235,26235,1399-6-5
499,فرآور,فرآوري‌موادمعدني‌ايران‌,360,1274006,32417797700,24260,25400,25470,1210,4.99,25000,740,3.05,25010,25470,1399-6-5
500,واتي,سرمايه‌ گذاري‌ آتيه‌ دماوند,358,3256260,53658896090,15700,16470,16480,780,4.97,16480,780,4.97,16450,16480,1399-6-5
501,بفجر,فجر انرژي خليج فارس,348,5195628,143659114200,26340,27650,27650,1310,4.97,27650,1310,4.97,27650,27650,1399-6-5
502,قثابت,قند ثابت‌ خراسان‌,346,412755,44177167650,101940,107030,107030,5090,4.99,106640,4700,4.61,107030,107030,1399-6-5
503,فوكا,فولاد كاويان,344,2830600,65420827200,22659,23112,23112,453,2.0,23112,453,2.0,23112,23112,1399-6-5
504,پرداخت,به پرداخت ملت,343,1069561,50060498320,44600,46830,46830,2230,5.0,46800,2200,4.93,45000,46830,1399-6-5
505,كپارس,كاشي‌ پارس‌,340,416832,37799097460,86910,87420,91250,4340,4.99,89930,3020,3.47,87420,91250,1399-6-5
506,وسكاب,س.ص.بازنشستگي كاركنان بانكها,338,2602674,19051573680,6980,7320,7320,340,4.87,7110,130,1.86,7320,7320,1399-6-5
507,واحيا,م .صنايع و معادن احياء سپاهان,337,2201251,452649846883,199644,205633,205633,5989,3.0,205633,5989,3.0,205633,205633,1399-6-5
508,زر,صندوق س.پشتوانه سكه طلاي زر,335,164681,9053203505,54311,55049,55100,789,1.45,54974,663,1.22,54500,55100,1399-6-5
509,دابور,داروسازي‌ ابوريحان‌,335,613297,26376965740,40980,43020,43020,2040,4.98,42050,1070,2.61,42000,43020,1399-6-5
510,شخارك,پتروشيمي‌ خارك‌,334,1456024,61633495920,40320,42330,42330,2010,4.99,41580,1260,3.13,42330,42330,1399-6-5
511,كاوه,فولاد كاوه جنوب كيش,332,6029060,106895233800,16890,17730,17730,840,4.97,17730,840,4.97,17730,17730,1399-6-5
512,وهور,مديريت انرژي اميد  تابان هور,328,6261401,271506870162,41298,43362,43362,2064,5.0,43362,2064,5.0,43362,43362,1399-6-5
513,البرز,بيمه البرز,325,2721041,47536586270,16640,17470,17470,830,4.99,17470,830,4.99,17470,17470,1399-6-5
514,صنوين,صندوق سرمايه‌گذاري صنوين-مختلط,322,205446,25034401970,118000,119000,122020,4020,3.41,121850,3850,3.26,119000,124000,1399-6-5
515,تسه9707,امتياز تسهيلات مسكن مهر97,322,5178,3880325273,778194,751010,750010,-28184,-3.62,749387,-28807,-3.7,739285,799980,1399-6-5
516,ثاژن,سخت آژند,317,3102939,35832739572,11783,11548,11548,-235,-1.99,11548,-235,-1.99,11548,11548,1399-6-5
517,تسه9901,امتياز تسهيلات مسكن فروردين99,310,2402,1827479460,800804,760777,761000,-39804,-4.97,760816,-39988,-4.99,760764,762000,1399-6-5
518,ونيكي,سرمايه‌گذاري‌ ملي‌ايران‌,308,2696469,124684726560,44040,46240,46240,2200,5.0,46240,2200,5.0,46240,46240,1399-6-5
519,تسه9812,امتياز تسهيلات مسكن اسفند98,304,3058,2356976999,800029,840000,760028,-40001,-5.0,770758,-29271,-3.66,760028,840000,1399-6-5
520,سصوفي,سيمان‌ صوفيان‌,297,752598,18619274520,23570,24740,24740,1170,4.96,24000,430,1.82,24740,24740,1399-6-5
521,وتعاون,بيمه  تعاون,293,1729409,11234296287,6312,6501,6501,189,2.99,6418,106,1.68,6320,6501,1399-6-5
522,سلار,شركت سيمان لارستان,292,412383,11520093751,27747,28579,27830,83,0.3,27848,101,0.36,26915,28579,1399-6-5
523,كمرجان,بازرگاني و توليدي مرجان كار,289,361827,16697240109,44201,46000,46411,2210,5.0,44854,653,1.48,42000,46411,1399-6-5
524,آكورد,صندوق س. آرمان آتي كوثر-د,287,5866791,167078284373,28494,28540,28489,-5,-0.02,28479,-15,-0.05,28352,28540,1399-6-5
525,تپولا,مهندسي مرآت پولاد,285,1444336,22060039809,14848,15293,15293,445,3.0,15268,420,2.83,14600,15293,1399-6-5
526,ولصنم,ليزينگ‌صنعت‌ومعدن‌,285,896060,12159534200,12930,13570,13570,640,4.95,13090,160,1.24,13570,13570,1399-6-5
527,وآتوس,س.آرين توسكا قيمت اسمي 350ريال,284,668090,15634704061,22815,23499,23499,684,3.0,23249,434,1.9,23000,23499,1399-6-5
528,فجر,فولاد اميركبيركاشان,283,769684,41778447520,51700,54280,54280,2580,4.99,53910,2210,4.27,54280,54280,1399-6-5
529,زنجان,صنايع كشاورزي وكود زنجان,282,2049628,16931976908,8021,8261,8261,240,2.99,8237,216,2.69,8261,8261,1399-6-5
530,سرچشمه,سرمايه گذاري مس سرچشمه,281,2453621,27286719141,10592,11121,11121,529,4.99,10873,281,2.65,11121,11121,1399-6-5
531,تپمپي,پمپ‌ سازي‌ ايران‌,279,281447,14227145850,53210,50550,50550,-2660,-5.0,52400,-810,-1.52,50550,50550,1399-6-5
532,تسه9706,امتياز تسهيلات مسكن شهريور97,277,2605,1920085522,762826,750010,740000,-22826,-2.99,737077,-25749,-3.38,724685,765000,1399-6-5
533,دامين,داروسازي‌ امين‌,277,1367197,22621056010,15790,16150,16570,780,4.94,16140,350,2.22,16150,16570,1399-6-5
534,كاذر,فرآورده‌هاي‌نسوزآذر,276,795370,30470624700,36490,38310,38310,1820,4.99,37640,1150,3.15,38310,38310,1399-6-5
535,وسين,بيمه سينا,274,7241979,175132778157,23479,24183,24183,704,3.0,24183,704,3.0,24183,24183,1399-6-5
536,تشتاد,صنايع توليدي اشتاد ايران‌,272,1231566,17475220106,13999,13580,14418,419,2.99,14167,168,1.2,13580,14418,1399-6-5
537,الماس,صندوق س.امين تدبيرگران فردا-س,270,202728,28934768683,135971,143000,144000,8029,5.9,142727,6756,4.97,139999,145900,1399-6-5
538,تسه9811,امتياز تسهيلات مسكن بهمن98,270,1827,1383846860,791089,751600,751561,-39528,-5.0,757442,-33647,-4.25,751535,790000,1399-6-5
539,شصفها,پتروشيمي‌ اصفهان‌,269,152982,15650679742,100630,100377,102642,2012,2.0,102304,1674,1.66,98650,102642,1399-6-5
540,اتكاي,بيمه اتكايي ايرانيان,269,2311709,33137502571,13743,14430,14430,687,5.0,14123,380,2.77,13754,14430,1399-6-5
541,سفاسي,شركت فارسيت اهواز,269,1246267,14724644605,12180,11815,11815,-365,-3.0,11884,-296,-2.43,11815,11815,1399-6-5
542,تاپكيش,تجارت الكترونيك پارسيان كيش,267,1048272,46661731536,42394,44513,44513,2119,5.0,44285,1891,4.46,44513,44513,1399-6-5
543,ثروتم,صندوق س. ثروت آفرين پارسيان-س,259,174850,18787485450,104508,106000,107500,2992,2.86,107449,2941,2.81,106000,111000,1399-6-5
544,گكوثر,هتل پارسيان كوثر اصفهان,255,252855,52679304990,198418,208338,208338,9920,5.0,208338,9920,5.0,208338,208338,1399-6-5
545,قچار,فراوردههاي غذايي وقند چهارمحال,255,99106,18418949206,195632,185851,185851,-9781,-5.0,191520,-4112,-2.1,185851,185851,1399-6-5
546,دلر,داروسازي‌ اكسير,255,786622,77196262410,93470,98140,98140,4670,5.0,98140,4670,5.0,95910,98140,1399-6-5
547,جم پيلن,پلي پروپيلن جم - جم پيلن,254,764098,64298846700,80150,84150,84150,4000,4.99,83970,3820,4.77,84150,84150,1399-6-5
548,ساروج,بين المللي ساروج بوشهر,254,229577,6003850905,25792,26564,26430,638,2.47,25900,108,0.42,25019,26564,1399-6-5
549,بخاور,بيمه زندگي خاورميانه,252,2036902,17894184070,8367,8785,8785,418,5.0,8512,145,1.73,8785,8785,1399-6-5
550,ودي,بيمه  دي,249,2037329,58905293377,27537,28913,28913,1376,5.0,28913,1376,5.0,28913,28913,1399-6-5
551,فالوم,آلومتك‌,246,477219,18498459113,39192,40200,38017,-1175,-3.0,38786,-406,-1.04,38017,40367,1399-6-5
552,فنرژي,گسترش صنايع انرژي آذرآب,242,882232,10385258125,11838,11890,11730,-108,-0.91,11772,-66,-0.56,11602,12000,1399-6-5
553,تسه9709,امتياز تسهيلات مسكن آذر97,241,2606,1966123720,789890,751020,757000,-32890,-4.16,754460,-35430,-4.49,750396,779998,1399-6-5
554,تسه9802,امتياز تسهيلات مسكن ارديبهشت98,241,2199,1653519225,786089,750000,746785,-39304,-5.0,751941,-34148,-4.34,746785,760000,1399-6-5
555,غاذر,كشت‌وصنعت‌پياذر,240,397520,28108639200,67350,70710,70710,3360,4.99,69010,1660,2.46,70710,70710,1399-6-5
556,نيرو,نيرو سرمايه,240,426853,29774382662,67731,69762,69762,2031,3.0,69753,2022,2.99,65780,69762,1399-6-5
557,ثقزوي,شركت عمران و سازندگي قزوين,239,1226921,21620527130,17117,17500,17630,513,3.0,17622,505,2.95,17000,17630,1399-6-5
558,واميد,گروه مديريت سرمايه گذاري اميد,239,3931753,164307957870,39800,41790,41790,1990,5.0,41790,1990,5.0,41790,41790,1399-6-5
559,قپيرا,فرآورده‌هاي‌غدايي‌وقندپيرانشهر,239,68862,5840646580,86830,82600,84750,-2080,-2.4,86590,-240,-0.28,82600,88800,1399-6-5
560,تسه9708,امتياز تسهيلات مسكن آبان97,234,2210,1664207534,782478,745000,755000,-27478,-3.51,753035,-29443,-3.76,745000,779955,1399-6-5
561,پلوله,گازلوله‌,233,1478099,26793149573,17772,18127,18127,355,2.0,18127,355,2.0,18010,18127,1399-6-5
562,قمرو,قند مرودشت‌,233,190535,6838301150,37770,35890,35890,-1880,-4.98,37490,-280,-0.74,35890,35890,1399-6-5
563,فولاژ,فولاد آلياژي ايران,232,2011919,54925388700,26000,27300,27300,1300,5.0,27090,1090,4.19,27300,27300,1399-6-5
564,تسه9803,امتياز تسهيلات مسكن خرداد98,232,2016,1524472674,788840,750000,750000,-38840,-4.92,756187,-32653,-4.14,749398,795000,1399-6-5
565,فيروزه2,صندوق شاخص30 شركت فيروزه- سهام,230,2300000,2300000,193650,1,1,-193649,-100.0,1,-193649,-100.0,1,1,1399-6-5
566,وارس,سرمايه گذاري ارس صبا,230,305670,43912552200,148103,143660,143660,-4443,-3.0,143660,-4443,-3.0,143660,143660,1399-6-5
567,شمواد,توليد مواداوليه الياف مصنوعي,226,273277,17373311998,60547,63574,63574,3027,5.0,62803,2256,3.73,63574,63574,1399-6-5
568,وبرق,س.کارکنان صنعت برق زنجان وقزوي,224,60867,15257348289,258419,250667,250667,-7752,-3.0,251829,-6590,-2.55,250667,250667,1399-6-5
569,قنقش,قند نقش جهان,222,297413,24391137605,83684,82011,82012,-1672,-2.0,82011,-1673,-2.0,82011,82012,1399-6-5
570,ضجار7036,اختيارخ وتجارت-6500-1399/07/22,221,11811,3429078000,258,290,300,42,16.28,290,32,12.4,260,320,1399-6-5
571,تسه9712,امتياز تسهيلات مسكن اسفند97,220,1746,1309529746,784345,745129,747000,-37345,-4.76,750017,-34328,-4.38,745128,760000,1399-6-5
572,شيراز,پتروشيمي‌شيراز,218,2004029,113387960820,53890,56580,56580,2690,4.99,56580,2690,4.99,56580,56580,1399-6-5
573,تسه9809,امتياز تسهيلات مسكن آذر98,217,2056,1564314208,786026,825327,750000,-36026,-4.58,760853,-25173,-3.2,746725,825327,1399-6-5
574,فخاسح,ح . فولاد خراسان,216,156991,5259198500,30450,33500,33500,3050,10.02,33500,3050,10.02,33500,33500,1399-6-5
575,گوهر,صندوق سكه طلاي كيان,212,148428,9228449398,60913,62500,62280,1367,2.24,62175,1262,2.07,62000,62500,1399-6-5
576,تسه9801,امتياز تسهيلات مسكن فروردين98,209,1594,1207276956,793462,775000,753789,-39673,-5.0,757388,-36074,-4.55,753789,830000,1399-6-5
577,كساپا,سايپاشيشه‌,207,571812,12871488120,23690,22510,22510,-1180,-4.98,23370,-320,-1.35,22510,22510,1399-6-5
578,زنگان,صنعت روي زنگان,207,109075,17437493025,168281,159867,159867,-8414,-5.0,165154,-3127,-1.86,159867,159867,1399-6-5
579,تسه9711,امتياز تسهيلات مسكن بهمن 97,202,2132,1603505240,782615,770000,750000,-32615,-4.17,752113,-30502,-3.9,743490,770000,1399-6-5
580,تسه9710,امتياز تسهيلات مسكن دي 97,202,1642,1231771408,783406,744236,750000,-33406,-4.26,750165,-33241,-4.24,744236,765000,1399-6-5
581,زعف9908پ10,زعفران9908نگين طلاي سرخ(پ),201,70801,7245760895,101138,102000,101100,-38,-0.04,102340,1202,1.19,101000,104500,1399-6-5
582,دلقما,دارويي‌ لقمان‌,201,212998,7497529600,37050,35200,35200,-1850,-4.99,36760,-290,-0.78,35200,35200,1399-6-5
583,سيلامح,ح . سيمان‌ ايلام‌,197,2199581,19796259000,9030,9030,9000,-30,-0.33,9000,-30,-0.33,9000,9030,1399-6-5
584,تصميم,صندوق س با درآمد ثابت تصميم,196,3684402,54271437460,14680,14800,14780,100,0.68,14730,50,0.34,14700,14800,1399-6-5
585,ثقزويح,ح.شركت عمران و سازندگي قزوين,194,1579039,20732782070,13130,13130,13130,0,0.0,13130,0,0.0,4000,13130,1399-6-5
586,وپترو,سرمايه‌گذاري صنايع پتروشيمي‌,193,1878885,34195707000,17340,18200,18200,860,4.96,17950,610,3.52,18200,18200,1399-6-5
587,تسه9808,امتياز تسهيلات مسكن آبان98,193,2832,2137139953,783713,822898,744528,-39185,-5.0,754640,-29073,-3.71,744528,822898,1399-6-5
588,قنيشا,قند  نيشابور,191,352407,33637248150,90910,95450,95450,4540,4.99,93910,3000,3.3,95450,95450,1399-6-5
589,سنير,سيمان‌ سفيد ني‌ريز,190,105314,9904781700,99000,94050,94050,-4950,-5.0,98000,-1000,-1.01,94050,94050,1399-6-5
590,لپيام,گسترش صنايع پيام,186,159250,5196646000,33297,32632,32632,-665,-2.0,32936,-361,-1.08,32632,32632,1399-6-5
591,دشيري,شيرين دارو,186,75683,15574804570,212154,205790,205790,-6364,-3.0,206724,-5430,-2.56,205790,205790,1399-6-5
592,دقاضي,داروسازي شهيد قاضي,186,129161,14085101917,107439,104320,110662,3223,3.0,108575,1136,1.06,104300,110662,1399-6-5
593,تكشا,گسترش‌صنايع‌وخدمات‌كشاورزي‌,184,1986652,147588377080,70760,74290,74290,3530,4.99,74290,3530,4.99,74290,74290,1399-6-5
594,حاريا,كشتيراني آريا,183,2105842,37098618514,17104,17617,17617,513,3.0,17617,513,3.0,17617,17617,1399-6-5
595,غمهرا,توليدي‌مهرام‌,183,48695,5350088470,113730,108050,109540,-4190,-3.68,113290,-440,-0.39,108050,113660,1399-6-5
596,فن آوا,گروه فن آوا,181,890133,13546338587,14957,15240,15256,299,2.0,15218,261,1.75,14660,15256,1399-6-5
597,صايند,صندوق س. گنجينه آينده روشن-د,179,1385550,14002081790,10094,10100,10120,26,0.26,10106,12,0.12,10082,10120,1399-6-5
598,وآرينح,ح. شركت توسعه اقتصادي آرين,177,1215734,5513069999,4441,4350,4574,133,2.99,4535,94,2.12,4350,4574,1399-6-5
599,ساينا,صنايع بهداشتي ساينا,176,338423,51172941830,144010,151210,151210,7200,5.0,151210,7200,5.0,151210,151210,1399-6-5
600,شاوان,پالايش نفت لاوان,174,458199,60592235760,125943,132240,132240,6297,5.0,132240,6297,5.0,132240,132240,1399-6-5
601,فمراد,آلومراد,174,42633,6521996340,161030,152980,152980,-8050,-5.0,159900,-1130,-0.7,152980,152980,1399-6-5
602,غبهار,كشت وصنعت بهاران گلبهار خراسان,172,395535,17222384970,44888,43542,43542,-1346,-3.0,43592,-1296,-2.89,43542,43542,1399-6-5
603,تيپيكو,سرمايه گذاري دارويي تامين,166,1227524,65525231120,50840,53380,53380,2540,5.0,52630,1790,3.52,53380,53380,1399-6-5
604,ضجار7031,اختيارخ وتجارت-4600-1399/07/22,165,7972,4626436000,390,519,647,257,65.9,580,190,48.72,420,647,1399-6-5
605,كرماشا,صنايع پتروشيمي كرمانشاه,162,976318,37793269780,36870,38710,38710,1840,4.99,38140,1270,3.44,38710,38710,1399-6-5
606,بميلا,توسعه بازرگاني آهن وفولادميلاد,161,445836,19368899184,42179,43444,43444,1265,3.0,43444,1265,3.0,43444,43444,1399-6-5
607,سكه9912پ04,سكه تمام بهارتحويل1روزه صادرات,160,76000,81822949400,1065963,1076622,1076622,10659,1.0,1076618,10655,1.0,1076230,1076622,1399-6-5
608,سدبير,س. تدبيرگران فارس وخوزستان,155,912815,22926261540,23920,25116,25116,1196,5.0,24377,457,1.91,25116,25116,1399-6-5
609,لوتوسح,ح . تامين سرمايه لوتوس پارسيان,153,947563,13385037460,12890,13770,14180,1290,10.01,14130,1240,9.62,13770,14180,1399-6-5
610,سدشت,صنايع سيمان دشتستان,150,98246,3736242850,36430,38250,38250,1820,5.0,36540,110,0.3,36590,38250,1399-6-5
611,ساروجح,ح . بين المللي ساروج بوشهر,135,730559,12483068042,16606,17100,17104,498,3.0,17087,481,2.9,16120,17104,1399-6-5
612,ثاصفا,شركت‌ ساختمان‌ اصفهان‌,134,214554,5152728864,25279,24016,24016,-1263,-5.0,24942,-337,-1.33,24016,24016,1399-6-5
613,گنجين2,صندوق س. گنجينه يكم آويد-د,134,13400000,13400000,11153,1,1,-11152,-99.99,1,-11152,-99.99,1,1,1399-6-5
614,وسخراج,شركت س استان خراسان جنوبي,133,3012720,5362641600,1700,1780,1780,80,4.71,1710,10,0.59,1780,1780,1399-6-5
615,سخواف,سيمان مجد خواف,131,188809,3579441022,19544,18958,18958,-586,-3.0,19433,-111,-0.57,18958,18958,1399-6-5
616,كي بي سي,شركت كي بي سي,129,1127457,47223536445,39891,41885,41885,1994,5.0,41885,1994,5.0,41885,41885,1399-6-5
617,فيروزا,صندوق بادرآمد ثابت فيروزه آسيا,129,3016491,61224437850,20260,20350,20340,80,0.39,20300,40,0.2,20260,20350,1399-6-5
618,بموتو,موتوژن‌,129,706483,38058239210,51310,53870,53870,2560,4.99,53310,2000,3.9,53870,53870,1399-6-5
619,گپارس,امور رفاهي كارگزاران پارس,127,110999,9159859478,78593,82522,82522,3929,5.0,80197,1604,2.04,82522,82522,1399-6-5
620,پدرخش,درخشان‌ تهران‌,125,28900,6416378000,233700,222020,222020,-11680,-5.0,232120,-1580,-0.68,222020,222020,1399-6-5
621,سخوز,سيمان خوزستان,123,868093,18863660890,20700,21730,21730,1030,4.98,21110,410,1.98,21730,21730,1399-6-5
622,مارون,پتروشيمي مارون,121,147365,18203851085,117647,123529,123529,5882,5.0,118793,1146,0.97,123529,123529,1399-6-5
623,ثنام,س ساختماني ب نام آوران مهندسي,120,321802,7790182816,24956,24208,24208,-748,-3.0,24664,-292,-1.17,24208,24208,1399-6-5
624,تسه9806,امتياز تسهيلات مسكن شهريور98,120,1685,1271419607,784281,760000,751001,-33280,-4.24,754552,-29729,-3.79,745067,770000,1399-6-5
625,بايكا,كارخانجات كابلسازي ‌ايران‌,119,164942,7567209076,48292,45878,45878,-2414,-5.0,47328,-964,-2.0,45878,45878,1399-6-5
626,سخند,صندوق س.سپهرخبرگان نفت-د,117,530740,5392151980,10132,10165,10148,16,0.16,10160,28,0.28,10121,10190,1399-6-5
627,شراز,پالايش نفت شيراز,114,99387,10782694404,103326,108492,108492,5166,5.0,104492,1166,1.13,108492,108492,1399-6-5
628,ثزاگرس,سرمايه گذاري توسعه عمران زاگرس,109,133586,3379870625,25851,25100,25400,-451,-1.74,25755,-96,-0.37,25076,26626,1399-6-5
629,اخزا815,اسنادخزانه-م15بودجه98-010406,108,239706,173979319734,725220,724000,725000,-220,-0.03,725803,583,0.08,723099,728500,1399-6-5
630,ضچاد7024,اختيارخ كچاد-23300-1399/07/07,107,1534,3052205000,1986,2490,1969,-17,-0.86,1990,4,0.2,1860,2490,1399-6-5
631,گنجين,صندوق س. گنجينه يكم آويد-د,106,4642423,51846504764,11153,11160,11169,16,0.14,11168,15,0.13,11160,11300,1399-6-5
632,تسه9807,امتياز تسهيلات مسكن مهر98,105,734,553065656,789588,750121,760000,-29588,-3.75,753495,-36093,-4.57,750121,780000,1399-6-5
633,وحافظ,بيمه حافظ,104,66425,3991212550,61944,60086,60086,-1858,-3.0,61558,-386,-0.62,60086,60086,1399-6-5
634,سكه0012پ01,سكه تمام بهارتحويلي 1روزه رفاه,101,129100,138988819300,1069300,1076622,1076622,7322,0.68,1076598,7298,0.68,1070500,1076622,1399-6-5
635,سپاس,صندوق س. پاداش سهامداري توسعه1,99,1545100,15878337900,10290,10270,10280,-10,-0.1,10280,-10,-0.1,10250,10300,1399-6-5
636,داريك,صندوق س.اعتماد داريك-د,98,345827,3447606242,9920,9988,9990,70,0.71,9969,49,0.49,9902,10000,1399-6-5
637,فافزا,فولاد افزا سپاهان,95,76556,3686936960,49649,48160,48160,-1489,-3.0,49364,-285,-0.57,48160,48160,1399-6-5
638,معيار,سرمايه گذاري معيار صنعت پارس,94,389459,11119833368,27454,28552,28552,1098,4.0,28549,1095,3.99,28552,28552,1399-6-5
639,زعف9908پ05,زعفران9908نگين زرين(پ),90,18581,1893065786,101482,104998,102889,1407,1.39,101882,400,0.39,100501,104998,1399-6-5
640,بنو,بيمه تجارت نو,85,767863,15346509918,19035,19986,19986,951,5.0,19361,326,1.71,19986,19986,1399-6-5
641,لخانه,لوازم‌ خانگي‌ پارس‌,83,80708,4768712888,60913,59086,59086,-1827,-3.0,60444,-469,-0.77,59086,59086,1399-6-5
642,اخزا812,اسنادخزانه-م12بودجه98-001111,82,353908,275476629406,776370,776099,779007,2637,0.34,778385,2015,0.26,776099,780000,1399-6-5
643,ارمغان,ص سرمايه گذاري ارمغان ايرانيان,79,1080674,10940978530,10120,10120,10130,10,0.1,10120,0,0.0,10110,10180,1399-6-5
644,گكيش,توريستي ورفاهي آبادگران كيش,78,79234,5660160024,73645,71436,71436,-2209,-3.0,72999,-646,-0.88,71436,71436,1399-6-5
645,سكه0011پ02,سكه تمام بهارتحويلي 1روزه ملت,74,37500,40371716200,1069533,1076622,1076622,7089,0.66,1076579,7046,0.66,1072622,1076622,1399-6-5
646,وجامي,سرمايه گذاري جامي,73,519309,5510387799,10302,10611,10611,309,3.0,10388,86,0.83,10611,10611,1399-6-5
647,اخزا808,اسنادخزانه-م8بودجه98-000817,72,68791,55761553669,808357,808359,810001,1644,0.2,810594,2237,0.28,808358,812498,1399-6-5
648,تسه9804,امتياز تسهيلات مسكن تير98,70,1042,780074142,778866,740000,750000,-28866,-3.71,748632,-30234,-3.88,740000,759990,1399-6-5
649,سفارود,كارخانه فارسيت درود,68,250430,1731222590,7201,6913,6913,-288,-4.0,7149,-52,-0.72,6913,6913,1399-6-5
650,نگين,ص.س. زمين و ساختمان نگين شهرري,66,302114,15407811500,51000,51000,51000,0,0.0,51000,0,0.0,50990,51000,1399-6-5
651,ضجار7022,اختيارخ وتجارت-2800-1399/07/22,65,1191,1617326000,1044,1250,1340,296,28.35,1358,314,30.08,1110,1498,1399-6-5
652,زعف9908پ14,زعفران9908پوشالمعمول نوين(پ),64,10262,692190069,67557,69976,67475,-82,-0.12,67452,-105,-0.16,65050,69977,1399-6-5
653,غشوكو,شوكو پارس,64,51606,2311277922,46172,44787,44787,-1385,-3.0,46007,-165,-0.36,44787,44787,1399-6-5
654,تسه9805,امتياز تسهيلات مسكن مرداد98,64,711,535449004,782255,750000,750000,-32255,-4.12,753093,-29162,-3.73,743143,769770,1399-6-5
655,اوصتا,صندوق انديشه ورزان صباتامين -د,63,1776273,29183458602,16401,16415,16433,32,0.2,16430,29,0.18,16415,16559,1399-6-5
656,غپونه,نوش پونه مشهد,62,610753,13166002421,20930,21557,21557,627,3.0,21354,424,2.03,21557,21557,1399-6-5
657,آساميد,صندوق س.مشترك آسمان اميد -د,60,1120634,11877461683,10568,10615,10605,37,0.35,10599,31,0.29,10569,10615,1399-6-5
658,اخزا811,اسنادخزانه-م11بودجه98-001013,58,165682,131436343212,787033,788011,796000,8967,1.14,793305,6272,0.8,788011,796500,1399-6-5
659,افران,صندوق س افرا نماد پايدار-ثابت,57,357981,4169291210,11600,11630,11630,30,0.26,11650,50,0.43,11630,11660,1399-6-5
660,شگويا4,پتروشيمي تندگويان,55,3441310,66998864390,18542,19469,19469,927,5.0,19469,927,5.0,19469,19469,1399-6-5
661,اخزا814,اسنادخزانه-م14بودجه98-010318,55,60234,44079620567,729969,730000,732000,2031,0.28,731806,1837,0.25,730000,733800,1399-6-5
662,اخزا817,اسنادخزانه-م17بودجه98-010512,55,182752,130262731380,710802,710800,711900,1098,0.15,712784,1982,0.28,710655,713500,1399-6-5
663,پلاست,كارخانجات توليدي پلاستيران,54,31693,1361404508,44284,42956,42956,-1328,-3.0,44190,-94,-0.21,42956,42956,1399-6-5
664,اخزا809,اسنادخزانه-م9بودجه98-000923,53,76615,61200023703,794605,795000,800000,5395,0.68,798799,4194,0.53,795000,800000,1399-6-5
665,پكوير,كوير تاير,52,44809,822945380,17770,18390,17900,130,0.73,17780,10,0.06,17900,18390,1399-6-5
666,ياقوت2,صندوق س ياقوت آگاه-ثابت,52,500001000,500001000,10880,1,1,-10879,-99.99,1,-10879,-99.99,1,1,1399-6-5
667,شكف,كف,50,327455,11076492830,32525,33826,33826,1301,4.0,33826,1301,4.0,33826,33826,1399-6-5
668,سكه0112پ03,سكه تمام بهارتحويلي1روزه سامان,49,63200,68039150000,1068156,1076622,1076622,8466,0.79,1076569,8413,0.79,1070023,1076622,1399-6-5
669,ثعتما,س. ساختماني اعتماد گستر,49,74273,2131115189,29580,28693,28693,-887,-3.0,29479,-101,-0.34,28693,28693,1399-6-5
670,زعف9908پ17,زعفران9908پوشالمعمول بيرجند(پ),49,5450,355450213,65938,67999,66000,62,0.09,65220,-718,-1.09,64180,67999,1399-6-5
671,ثغربح,ح.شركت سرمايه گذاري مسكن شمالغ,48,289287,3435334420,12449,13071,11830,-619,-4.97,11875,-574,-4.61,11830,13071,1399-6-5
672,سايرا,ايرانيت‌,48,505253,17658642176,35583,34872,36294,711,2.0,34950,-633,-1.78,34872,36294,1399-6-5
673,اخزا806,اسنادخزانه-م6بودجه98-000519,46,124100,107487012222,862590,847503,860000,-2590,-0.3,866132,3542,0.41,847503,877000,1399-6-5
674,اخزا818,اسنادخزانه-م18بودجه98-010614,44,93285,65616696303,701262,700500,705000,3738,0.53,703400,2138,0.3,699021,705000,1399-6-5
675,اراد43,مرابحه عام دولت4-ش.خ 0205,43,5746423,5378077285700,935900,935900,935900,0,0.0,935900,0,0.0,935900,935900,1399-6-5
676,كهرام,توليدي گرانيت بهسرام,42,434385,21106767150,46277,48590,48590,2313,5.0,48423,2146,4.64,48590,48590,1399-6-5
677,دارا2,صندوق س. دارا الگوريتم-د,42,4200000,4200000,10051,1,1,-10050,-99.99,1,-10050,-99.99,1,1,1399-6-5
678,مارون4,پتروشيمي مارون,41,5684771,702506945867,117647,123577,123577,5930,5.04,123577,5930,5.04,123577,123577,1399-6-5
679,اخزا816,اسنادخزانه-م16بودجه98-010503,40,129382,92684534354,713926,714000,714044,118,0.02,716363,2437,0.34,713166,717400,1399-6-5
680,ولراز,ليزينگ رازي,39,79289,1719619832,22358,21688,21688,-670,-3.0,22299,-59,-0.26,21688,21688,1399-6-5
681,اخزا813,اسنادخزانه-م13بودجه98-010219,37,23366,17305452847,741065,739008,742500,1435,0.19,740625,-440,-0.06,738998,744871,1399-6-5
682,تابا,تابان نيرو سپاهان,36,46532,1493072284,33079,32087,32087,-992,-3.0,33003,-76,-0.23,32087,32087,1399-6-5
683,شاوان4,پالايش نفت لاوان,36,344900,45609576000,125943,132240,132240,6297,5.0,132240,6297,5.0,132240,132240,1399-6-5
684,اخزا722,اسنادخزانه-م22بودجه97-000428,35,239043,208727572804,864840,859000,870000,5160,0.6,873180,8340,0.96,859000,887500,1399-6-5
685,آكورد2,صندوق س. آرمان آتي كوثر-د,34,3400000,3400000,28494,1,1,-28493,-100.0,1,-28493,-100.0,1,1,1399-6-5
686,ضصاد8020,اختيارخ وبصادر-4400-1399/08/11,33,1151,983014000,675,750,828,153,22.67,854,179,26.52,750,900,1399-6-5
687,ثقزويح4,ح.شركت عمران و سازندگي قزوين,33,34249852,341136650240,13130,0,9120,-4010,-30.54,9960,-3170,-24.14,0,0,1399-6-5
688,شپنا2,پالايش نفت اصفهان,32,29332954,1079159377660,35040,36790,36790,1750,4.99,36790,1750,4.99,36790,36790,1399-6-5
689,فملي2,ملي‌ صنايع‌ مس‌ ايران‌,32,18144380,554673696600,29120,30570,30570,1450,4.98,30570,1450,4.98,30570,30570,1399-6-5
690,اخزا821,اسنادخزانه-م21بودجه98-020906,31,65452,37777468261,579884,577000,578198,-1686,-0.29,577178,-2706,-0.47,577000,580000,1399-6-5
691,ضملي8077,اختيارخ فملي -29750-1399/08/06,30,229,2435178000,8411,10900,9800,1389,16.51,10634,2223,26.43,9800,11000,1399-6-5
692,حرهشا,رهشاد سپاهان (سهامي عام,30,18362,1090592628,62520,59394,59394,-3126,-5.0,62337,-183,-0.29,59394,59394,1399-6-5
693,ضترا8037,اختيارخ شتران-12806-1399/08/11,30,183,3304536000,15158,18000,18000,2842,18.75,18058,2900,19.13,18000,19000,1399-6-5
694,شسم,توليد سموم‌ علف‌ كش,30,62187,4757740809,73565,76507,76507,2942,4.0,74893,1328,1.81,76507,76507,1399-6-5
695,اخزا704,اسنادخزانه-م4بودجه97-991022,30,55932,52737306479,940627,940000,943500,2873,0.31,942883,2256,0.24,939000,945000,1399-6-5
696,پست9908-04,پسته فندقي32-30سبزدانه9908,28,124,168042945,1358880,1342315,1396000,37120,2.73,1355185,-3695,-0.27,1342315,1396000,1399-6-5
697,فخوز2,فولاد  خوزستان,28,6609433,287840807150,41480,43550,43550,2070,4.99,43550,2070,4.99,43550,43550,1399-6-5
698,وتجارت2,بانك تجارت,27,91259199,285641292870,2990,3130,3130,140,4.68,3130,140,4.68,3130,3130,1399-6-5
699,فولاد2,فولاد مباركه اصفهان,27,31199094,558775773540,17060,17910,17910,850,4.98,17910,850,4.98,17910,17910,1399-6-5
700,ضغدر8040,اختيارخ وغدير-13000-1399/08/26,27,109,1127200000,5663,14800,9300,3637,64.22,10341,4678,82.61,8900,14800,1399-6-5
701,كرونا2,تامين مالي جمعي صرفا اهداي سود,26,7055,70550000,10000,10000,10000,0,0.0,10000,0,0.0,10000,10000,1399-6-5
702,زعف9908پ06,زعفران 9908پوشالمعمول زرين(پ),26,5789,374635288,65971,66712,64200,-1771,-2.68,64715,-1256,-1.9,64200,66712,1399-6-5
703,فپنتا,سپنتا,26,7385,2187289300,282080,296180,296180,14100,5.0,282650,570,0.2,296180,296180,1399-6-5
704,ضصاد8000,اختيارخ وبصادر-1200-1399/08/11,26,219,569670000,2138,2499,2800,662,30.96,2601,463,21.66,2490,2800,1399-6-5
705,زعف9908پ13,زعفران9908پوشالمعمول روستا(پ),26,3361,216988878,65910,65205,64180,-1730,-2.62,64561,-1349,-2.05,64180,66000,1399-6-5
706,زعف9908پ11,زعفران9908نگين سحرخيز(پ),25,3095,327643720,103249,104392,103400,151,0.15,105862,2613,2.53,101200,106194,1399-6-5
707,زعف9908پ16,زعفران9908نگين بيرجند(پ),25,10735,1096108823,100369,101800,102500,2131,2.12,102106,1737,1.73,101066,102500,1399-6-5
708,اخزا721,اسنادخزانه-م21بودجه97-000728,24,40912,33587774062,817142,818000,819001,1859,0.23,820976,3834,0.47,818000,822000,1399-6-5
709,ضخود7056,اختيارخ خودرو-3800-1399/07/09,23,272,401500000,1217,2199,1350,133,10.93,1476,259,21.28,1350,2199,1399-6-5
710,شتولي,تولي‌پرس‌,23,46763,840751977,17627,17979,17979,352,2.0,17654,27,0.15,17979,17979,1399-6-5
711,ضملي8082,اختيارخ فملي-39750-1399/08/06,23,231,1389235000,5073,6800,5811,738,14.55,6014,941,18.55,5811,6800,1399-6-5
712,ضخود7053,اختيارخ خودرو-3200-1399/07/09,23,257,453659000,1731,1800,1790,59,3.41,1765,34,1.96,1700,2500,1399-6-5
713,زير0003پ02,زيره سبز0003 دانش(پ),22,306,130187785,452834,446495,430000,-22834,-5.04,425450,-27384,-6.05,403976,446495,1399-6-5
714,تكنار,مجتمع معادن مس تكنار,22,46333,2947659127,60590,63619,63619,3029,5.0,61006,416,0.69,63619,63619,1399-6-5
715,اراد47,مرابحه عام دولت4-ش.خ 0008,22,4200000,4069632000000,968960,968960,968960,0,0.0,968960,0,0.0,968960,968960,1399-6-5
716,شبندر2,پالايش نفت بندرعباس,22,3845773,162637740170,40280,42290,42290,2010,4.99,42290,2010,4.99,42290,42290,1399-6-5
717,كصدف,كاشي صدف سرام استقلال آباده,21,213101,2811441493,12935,13193,13193,258,1.99,13005,70,0.54,13193,13193,1399-6-5
718,ضجار7010,اختيارخ وتجارت-1200-1399/07/22,20,90,215584000,2240,2299,2400,160,7.14,2395,155,6.92,2299,2500,1399-6-5
719,اخزا820,اسنادخزانه-م20بودجه98-020806,20,89850,52113163962,580128,580151,581000,872,0.15,580002,-126,-0.02,580000,581000,1399-6-5
720,زعف9908پ09,زعفران9908نگين نوين(پ),20,1030,106169042,102533,106194,102200,-333,-0.32,103077,544,0.53,101454,106194,1399-6-5
721,زير0003پ04,زيره سبز0003شركت مينوبذر(پ),20,425,181346587,418636,410000,446498,27862,6.66,426698,8062,1.93,404000,446498,1399-6-5
722,اطلس2,صندوق س.توسعه اندوخته آينده-س,20,200000,200000,200556,1,1,-200555,-100.0,1,-200555,-100.0,1,1,1399-6-5
723,ضخود7054,اختيارخ خودرو-3400-1399/07/09,19,71,128390000,1549,1850,1700,151,9.75,1808,259,16.72,1700,1850,1399-6-5
724,نمرينو,ايران‌ مرينوس‌,19,84235,6631821550,74990,78730,78730,3740,4.99,75450,460,0.61,78730,78730,1399-6-5
725,ضخود7055,اختيارخ خودرو-3600-1399/07/09,19,141,232968000,1395,1600,1401,6,0.43,1652,257,18.42,1401,2300,1399-6-5
726,اخزا703,اسنادخزانه-م3بودجه97-990721,18,8270,8084698433,977276,978000,978700,1424,0.15,977593,317,0.03,970048,978700,1399-6-5
727,آوا2,صندوق س.سهام آواي معيار-س,18,20000000,20000000,9422,1,1,-9421,-99.99,1,-9421,-99.99,1,1,1399-6-5
728,ضملي8073,اختيارخ فملي -21750-1399/08/06,17,127,2046000000,17833,16200,16500,-1333,-7.47,16110,-1723,-9.66,15200,16500,1399-6-5
729,اخزا624,اسنادخزانه-م24بودجه96-990625,17,7291,7223510813,989091,990000,991100,2009,0.2,990743,1652,0.17,989091,991100,1399-6-5
730,ضصاد8017,اختيارخ وبصادر-3800-1399/08/11,16,277,330363000,802,1200,1110,308,38.4,1193,391,48.75,1000,1250,1399-6-5
731,ضجار7021,اختيارخ وتجارت-2600-1399/07/22,16,373,514225000,1195,1500,1375,180,15.06,1379,184,15.4,1300,1500,1399-6-5
732,ضشنا7053,اختيارخ شپنا-3758-1399/07/28,16,96,3289555000,32526,34000,34777,2251,6.92,34266,1740,5.35,34000,35000,1399-6-5
733,زعف9908پ15,زعفران9908پوشالمعمول طلاسرخ(پ),16,1620,105183430,64803,64350,65500,697,1.08,64928,125,0.19,64300,67778,1399-6-5
734,ضگل8066,اختيارخ كگل-25100-1399/08/21,16,290,551040000,4500,480,4000,-500,-11.11,1900,-2600,-57.78,480,4000,1399-6-5
735,غگز,گز سكه,15,192659,6839009182,35498,35498,35498,0,0.0,35498,0,0.0,35498,35498,1399-6-5
736,اخزا713,اسنادخزانه-م13بودجه97-000518,15,29457,25403158387,847360,850000,865000,17640,2.08,862381,15021,1.77,850000,865000,1399-6-5
737,ضجار7030,اختيارخ وتجارت-4400-1399/07/22,15,993,630607000,475,630,650,175,36.84,635,160,33.68,599,650,1399-6-5
738,زعف9908پ12,زعفران9908پوشالمعمول سحرخيز(پ),15,1656,113595128,70528,70934,68000,-2528,-3.58,68596,-1932,-2.74,66000,70934,1399-6-5
739,ساذري,آذريت‌,15,2960,470299600,154258,158885,158885,4627,3.0,154360,102,0.07,158885,158885,1399-6-5
740,ضجار7026,اختيارخ وتجارت-3600-1399/07/22,15,343,343565000,796,1100,1000,204,25.63,1002,206,25.88,835,1100,1399-6-5
741,زعف9908پ08,زعفران9908نگين روستا(پ),15,1556,159773900,101500,102000,100900,-600,-0.59,102682,1182,1.16,100600,103300,1399-6-5
742,اخزا805,اسنادخزانه-م5بودجه98-000422,15,56482,48578565350,858464,860000,860124,1660,0.19,860072,1608,0.19,855000,869999,1399-6-5
743,ضخود7068,اختيارخ خودرو-8000-1399/07/09,15,126,70180000,733,380,600,-133,-18.14,557,-176,-24.01,299,630,1399-6-5
744,شستا993,اجاره ت.اجتماعي-كاردان991226,15,259,265812921,1024699,1035000,1014711,-9988,-0.97,1026305,1606,0.16,1014711,1035000,1399-6-5
745,ضصاد8019,اختيارخ وبصادر-4200-1399/08/11,15,634,620441000,769,990,1000,231,30.04,979,210,27.31,949,1000,1399-6-5
746,ومشان,س. فني و مهندسي مشانير,14,8296,479641536,59604,57816,57816,-1788,-3.0,59560,-44,-0.07,57816,57816,1399-6-5
747,اخزا807,اسنادخزانه-م7بودجه98-000719,14,78535,64648121000,820869,823000,820001,-868,-0.11,823176,2307,0.28,820001,824000,1399-6-5
748,ضجار7024,اختيارخ وتجارت-3200-1399/07/22,14,226,248170000,1004,1070,1300,296,29.48,1098,94,9.36,1049,1300,1399-6-5
749,اخزا718,اسنادخزانه-م18بودجه97-000525,14,61993,54091684980,872733,869998,872733,0,0.0,872545,-188,-0.02,844115,872733,1399-6-5
750,ضخود7057,اختيارخ خودرو-4000-1399/07/09,14,347,443643000,1033,1220,1311,278,26.91,1279,246,23.81,1220,1350,1399-6-5
751,فنورد,نوردوقطعات‌ فولادي‌,14,25287,2955797430,111330,116890,116890,5560,4.99,111640,310,0.28,116890,116890,1399-6-5
752,ضپنا7039,اختيارخ رمپنا-25556-1399/07/13,13,141,1592900000,12285,12500,10900,-1385,-11.27,11297,-988,-8.04,10500,12500,1399-6-5
753,ضغدر8041,اختيارخ وغدير-14000-1399/08/26,13,60,541399000,6800,9700,8400,1600,23.53,9023,2223,32.69,8400,9700,1399-6-5
754,ضصاد8015,اختيارخ وبصادر-3400-1399/08/11,12,54,64445000,1081,980,1200,119,11.01,1193,112,10.36,980,1290,1399-6-5
755,وبصادر2,بانك صادرات ايران,12,21036013,74677846150,3390,3550,3550,160,4.72,3550,160,4.72,3550,3550,1399-6-5
756,وآفري,بيمه كارآفرين,12,163964,1913459880,11331,11670,11670,339,2.99,11359,28,0.25,11670,11670,1399-6-5
757,ضجار7019,اختيارخ وتجارت-2200-1399/07/22,12,248,403550000,798,1500,1700,902,113.03,1627,829,103.88,1500,1700,1399-6-5
758,اخزا723,اسنادخزانه-م23بودجه97-000824,12,18888,15335570736,807965,809999,814000,6035,0.75,811921,3956,0.49,809999,814000,1399-6-5
759,كاردان2,صندوق س تجارت شاخصي كاردان,12,1200000,1200000,202500,1,1,-202499,-100.0,1,-202499,-100.0,1,1,1399-6-5
760,ضصاد8012,اختيارخ وبصادر-2800-1399/08/11,11,312,509080000,1282,1640,1630,348,27.15,1632,350,27.3,1470,1650,1399-6-5
761,شرق1400,مشاركت ليزينگ ايران وشرق140010,11,59,58939151,1004531,998000,998000,-6531,-0.65,998969,-5562,-0.55,998000,1006000,1399-6-5
762,صايپا012,صكوك مرابحه سايپا012-3ماهه 16%,11,1076,1059503850,999381,1000000,980000,-19381,-1.94,984669,-14712,-1.47,980000,1049350,1399-6-5
763,ضبدر8066,اختيارخ شبندر-43580-1399/08/18,11,18,225850000,12500,13000,12850,350,2.8,12547,47,0.38,11000,13000,1399-6-5
764,ضملي8079,اختيارخ فملي-33750-1399/08/06,11,247,2216248000,4308,8800,8700,4392,101.95,8973,4665,108.29,8500,9200,1399-6-5
765,اخزا810,اسنادخزانه-م10بودجه98-001006,10,42783,33800496035,789845,790111,790000,155,0.02,790045,200,0.03,790000,790111,1399-6-5
766,اراد45,مرابحه عام دولت4-ش.خ 0107,10,1750000,1659350000000,948200,948200,948200,0,0.0,948200,0,0.0,948200,948200,1399-6-5
767,ضصاد8018,اختيارخ وبصادر-4000-1399/08/11,10,121,121078000,811,1000,1039,228,28.11,1001,190,23.43,910,1090,1399-6-5
768,فسديد,لوله‌وتجهيزات‌ سديد - ورشكسته,9,53349,5754329838,105748,107862,107862,2114,2.0,107862,2114,2.0,107862,107862,1399-6-5
769,زير0003پ01,زيره سبز0003كيميابذر(پ),9,217,96609810,425237,430000,446498,21261,5.0,445206,19969,4.7,430000,446498,1399-6-5
770,ضترا8017,اختيارخ شتران-3126-1399/08/11,9,9,293500000,30667,31000,33500,2833,9.24,32611,1944,6.34,31000,33500,1399-6-5
771,ضجار7023,اختيارخ وتجارت-3000-1399/07/22,9,105,115005000,1001,1001,1100,99,9.89,1095,94,9.39,1001,1100,1399-6-5
772,ضترا8018,اختيارخ شتران-3421-1399/08/11,9,10,323000000,27000,31000,32500,5500,20.37,32300,5300,19.63,31000,33000,1399-6-5
773,ضگل8067,اختيارخ كگل-26000-1399/08/21,9,170,383539000,5000,3000,2111,-2889,-57.78,2256,-2744,-54.88,2100,3000,1399-6-5
774,تفيرو,مهندسي فيروزا,9,5462,108431624,19089,19852,19852,763,4.0,19097,8,0.04,19852,19852,1399-6-5
775,ضخود7039,اختيارخ خودرو-1500-1399/07/09,9,116,386557000,3304,3300,3390,86,2.6,3332,28,0.85,3300,3400,1399-6-5
776,ضملي8076,اختيارخ فملي -27750-1399/08/06,8,111,1370000000,11541,12400,11000,-541,-4.69,12342,801,6.94,11000,12500,1399-6-5
777,ضصاد8008,اختيارخ وبصادر-2000-1399/08/11,8,55,110199000,1918,2000,2000,82,4.28,2004,86,4.48,2000,2149,1399-6-5
778,ضپنا7042,اختيارخ رمپنا-32306-1399/07/13,8,51,276149000,6967,5200,6800,-167,-2.4,5415,-1552,-22.28,5200,6800,1399-6-5
779,ضفلا8093,اختيارخ فولاد-29775-1399/08/28,8,280,713791000,1923,2100,3800,1877,97.61,2549,626,32.55,2100,3800,1399-6-5
780,ضفلا8060,اختيارخ فولاد-3507-1399/08/28,7,7,164017608,13100,15500,15001,1901,14.51,14572,1472,11.24,14100,15500,1399-6-5
781,صايپا908,صكوك مرابحه سايپا908-3ماهه 18%,7,127,128033000,1005450,1015000,1001000,-4450,-0.44,1008134,2684,0.27,1001000,1015000,1399-6-5
782,ضخود7062,اختيارخ خودرو-5000-1399/07/09,7,58,55920000,937,920,900,-37,-3.95,964,27,2.88,900,1099,1399-6-5
783,ضجار7016,اختيارخ وتجارت-1800-1399/07/22,7,34,71600000,1847,2000,2000,153,8.28,2106,259,14.02,2000,2300,1399-6-5
784,ضخود7058,اختيارخ خودرو-4200-1399/07/09,7,64,81121000,1400,1300,1151,-249,-17.79,1268,-132,-9.43,1151,1300,1399-6-5
785,وسالت,بانك قرض الحسنه رسالت,7,5684,24537828,4151,4317,4317,166,4.0,4151,0,0.0,4317,4317,1399-6-5
786,سپرمي,پرميت‌,7,7147,59956183,8473,8389,8389,-84,-0.99,8472,-1,-0.01,8389,8389,1399-6-5
787,عسناسنگ,سلف كنستانتره سنگ آهن سناباد,7,15,101101800,6620000,6748700,6748700,128700,1.94,6740120,120120,1.81,6620000,6748700,1399-6-5
788,پست9908-02,پسته فندقي32-30طلاسبززرند9908,7,31,43033200,1412963,1396000,1355000,-57963,-4.1,1388168,-24795,-1.75,1355000,1396000,1399-6-5
789,آگاس2,صندوق س.هستي بخش آگاه-س,6,1500000,1500000,295148,1,1,-295147,-100.0,1,-295147,-100.0,1,1,1399-6-5
790,پست9908-08,پسته فندقي32-30زرينمه ولات9908,6,525,704715375,1358880,1342315,1342315,-16565,-1.22,1342315,-16565,-1.22,1342315,1342315,1399-6-5
791,ضخود7059,اختيارخ خودرو-4400-1399/07/09,6,91,112500000,1600,1500,1200,-400,-25.0,1236,-364,-22.75,1000,1500,1399-6-5
792,آتيمس2,صندوق س.آرمان آتيه درخشان مس-س,6,600000,600000,251199,1,1,-251198,-100.0,1,-251198,-100.0,1,1,1399-6-5
793,ضملي8081,اختيارخ فملي-37750-1399/08/06,6,115,1008980000,1,9000,7000,6999,699900.0,8774,8773,877300.0,7000,9000,1399-6-5
794,تملي704,تسهيلات مسكن ب. ملي-تير97,6,26,12037407,471602,480424,480425,8823,1.87,462977,-8625,-1.83,448022,480425,1399-6-5
795,خعمرا,توسعه و عمران شهرستان نائين,6,4388,59703128,13210,13606,13606,396,3.0,13211,1,0.01,13606,13606,1399-6-5
796,جم2,پتروشيمي جم,6,835725,34365012000,39170,41120,41120,1950,4.98,41120,1950,4.98,41120,41120,1399-6-5
797,كابگن,توليدي و صنعتي آبگينه‌,5,29000,128122000,4332,4418,4418,86,1.99,4334,2,0.05,4418,4418,1399-6-5
798,عپلي جم,سلف پلي اتيلن سنگين تزريقي,5,55,76024074,1382010,1382010,1382654,644,0.05,1382256,246,0.02,1382010,1382654,1399-6-5
799,ضفلا8076,اختيارخ فولاد-8775-1399/08/28,5,49,655994000,12256,11000,13499,1243,10.14,13388,1132,9.24,11000,14000,1399-6-5
800,ضخود7050,اختيارخ خودرو-1200-1399/07/09,5,27,96046000,3195,3600,3450,255,7.98,3557,362,11.33,3450,3600,1399-6-5
801,ضمخا7036,اختيارخ اخابر-2750-1399/07/30,5,5,117000000,22000,23000,23500,1500,6.82,23400,1400,6.36,23000,24000,1399-6-5
802,سرو2,صندوق س سروسودمند مدبران-سهام,5,500000,500000,66690,1,1,-66689,-100.0,1,-66689,-100.0,1,1,1399-6-5
803,ضجار7033,اختيارخ وتجارت-5000-1399/07/22,5,210,130000000,450,500,650,200,44.44,619,169,37.56,500,650,1399-6-5
804,اخزا720,اسنادخزانه-م20بودجه97-000324,5,61774,55028860000,879984,890000,892000,12016,1.37,890809,10825,1.23,890000,892000,1399-6-5
805,ضجار7027,اختيارخ وتجارت-3800-1399/07/22,5,104,93848000,700,1050,999,299,42.71,902,202,28.86,800,1050,1399-6-5
806,صينا205,صكوك منفعت سينا دارو-3ماهه 19%,5,42,41940377,1032900,990002,990017,-42883,-4.15,998580,-34320,-3.32,990002,1020001,1399-6-5
807,شتهران,داروسازي تهران شيمي,5,20495,171235725,8192,8355,8355,163,1.99,8195,3,0.04,8355,8355,1399-6-5
808,تملي703,تسهيلات مسكن ب. ملي-خرداد97,5,143,17021147,113361,119029,119029,5668,5.0,119029,5668,5.0,119029,119029,1399-6-5
809,صايند2,صندوق س. گنجينه آينده روشن-د,5,500000,500000,10094,1,1,-10093,-99.99,1,-10093,-99.99,1,1,1399-6-5
810,ضفلا8088,اختيارخ فولاد-19775-1399/08/28,4,12,72900000,5071,6300,5700,629,12.4,6075,1004,19.8,5700,6300,1399-6-5
811,ضفلا8089,اختيارخ فولاد-21775-1399/08/28,4,21,108800000,5100,5200,5000,-100,-1.96,5181,81,1.59,5000,5200,1399-6-5
812,ضگل8055,اختيارخ كگل-11100-1399/08/21,4,400,4660000000,13000,11400,12000,-1000,-7.69,11650,-1350,-10.38,11400,12000,1399-6-5
813,ضبدر8061,اختيارخ شبندر-31580-1399/08/18,4,21,408600000,10000,19000,19850,9850,98.5,19457,9457,94.57,19000,19900,1399-6-5
814,ضفلا8082,اختيارخ فولاد-13775-1399/08/28,4,6,59600000,8151,9000,10000,1849,22.68,9933,1782,21.86,9000,10600,1399-6-5
815,تملي707,تسهيلات مسكن ب. ملي-مهر97,4,66,12918270,186856,185932,196198,9342,5.0,195731,8875,4.75,185932,196198,1399-6-5
816,ضشنا7054,اختيارخ شپنا-4094-1399/07/28,4,13,457800000,32000,35000,34000,2000,6.25,35215,3215,10.05,34000,36900,1399-6-5
817,كمند2,صندوق س. با درآمد ثابت كمند,4,44000000,44000000,10180,1,1,-10179,-99.99,1,-10179,-99.99,1,1,1399-6-5
818,اخزا804,اسنادخزانه-م4بودجه98-000421,4,5873,5051468119,860989,861000,860000,-989,-0.11,860117,-872,-0.1,860000,861000,1399-6-5
819,ضملي8068,اختيارخ فملي -15750-1399/08/06,4,6,119998000,18800,20000,19999,1199,6.38,20000,1200,6.38,19999,20000,1399-6-5
820,ضملي8075,اختيارخ فملي -25750-1399/08/06,4,130,1730000000,11700,13700,12000,300,2.56,13308,1608,13.74,12000,13700,1399-6-5
821,ضفار8041,اختيارخ فارس-16826-1399/08/06,4,4,21900000,5400,6000,5500,100,1.85,5475,75,1.39,4900,6000,1399-6-5
822,حكمت01,مشاركت حكمت ايرانيان 140107,4,26010,25619849990,985000,984999,985000,0,0.0,985000,0,0.0,984999,985000,1399-6-5
823,ضبدر8060,اختيارخ شبندر-29580-1399/08/18,4,26,547500000,19731,20000,21500,1769,8.97,21058,1327,6.73,20000,21500,1399-6-5
824,آرمان,بيمه آرمان,4,8684,35908340,4054,4135,4135,81,2.0,4054,0,0.0,4135,4135,1399-6-5
825,ضصاد8011,اختيارخ وبصادر-2600-1399/08/11,4,221,425950000,1543,1700,2000,457,29.62,1927,384,24.89,1700,2000,1399-6-5
826,ضجار7014,اختيارخ وتجارت-1600-1399/07/22,4,7,14000000,1471,2000,2000,529,35.96,2000,529,35.96,2000,2000,1399-6-5
827,ضملي8087,اختيارخ فملي-59750-1399/08/06,4,127,267600000,1800,2050,2100,300,16.67,2107,307,17.06,2050,2300,1399-6-5
828,آسام2,صندوق س.آرمان سپهر آشنا-م,4,400000,400000,124041,1,1,-124040,-100.0,1,-124040,-100.0,1,1,1399-6-5
829,فولاژ2,فولاد آلياژي ايران,4,3175660,86695518000,26000,27300,27300,1300,5.0,27300,1300,5.0,27300,27300,1399-6-5
830,ضخود7049,اختيارخ خودرو-3000-1399/07/09,4,32,64300000,2000,2100,2000,0,0.0,2009,9,0.45,2000,2100,1399-6-5
831,ضجار7018,اختيارخ وتجارت-2000-1399/07/22,4,20,36450000,1512,1800,1840,328,21.69,1822,310,20.5,1800,1850,1399-6-5
832,ضصاد8009,اختيارخ وبصادر-2200-1399/08/11,3,20,42000000,1799,2100,2100,301,16.73,2100,301,16.73,2100,2100,1399-6-5
833,صايپا112,صكوك مرابحه سايپا112-3ماهه 16%,3,14,14560000,1000022,1040000,1040000,39978,4.0,1040000,39978,4.0,1040000,1040000,1399-6-5
834,طسان7050,اختيارف پارسان-11000-99/07/15,3,30,8018000,82,299,219,137,167.07,267,185,225.61,219,300,1399-6-5
835,ضپنا7036,اختيارخ رمپنا-21506-1399/07/13,3,9,135500000,21567,15500,15000,-6567,-30.45,15056,-6511,-30.19,15000,15500,1399-6-5
836,ضمخا7032,اختيارخ اخابر-4750-1399/07/30,3,10,214595000,20305,21000,23298,2993,14.74,21459,1154,5.68,21000,23298,1399-6-5
837,ضصاد8013,اختيارخ وبصادر-3000-1399/08/11,3,10,15500000,1309,1550,1550,241,18.41,1550,241,18.41,1550,1550,1399-6-5
838,ضشنا7076,اختيارخ شپنا-19864-1399/07/28,3,3,56499000,11252,19000,18999,7747,68.85,18833,7581,67.37,18500,19000,1399-6-5
839,ضفار8037,اختيارخ فارس-12826-1399/08/06,3,100,850000000,7000,8500,8500,1500,21.43,8500,1500,21.43,8500,8500,1399-6-5
840,ضبدر8063,اختيارخ شبندر-35580-1399/08/18,3,7,119800000,14000,17000,17300,3300,23.57,17114,3114,22.24,17000,17500,1399-6-5
841,ضفار8036,اختيارخ فارس-11826-1399/08/06,3,55,545000000,11500,10000,9900,-1600,-13.91,9909,-1591,-13.83,9500,10000,1399-6-5
842,پرند,صندوق س. پروژه آرمان پرند مپنا,3,199300,1128436600,5658,5662,5662,4,0.07,5662,4,0.07,5662,5662,1399-6-5
843,ضملي8069,اختيارخ فملي -16750-1399/08/06,3,20,360000000,14273,18000,18000,3727,26.11,18000,3727,26.11,18000,18000,1399-6-5
844,اعتماد2,صندوق س.اعتماد آفرين پارسيان-د,3,21500000,21500000,32042,1,1,-32041,-100.0,1,-32041,-100.0,1,1,1399-6-5
845,صايپا203,صكوك مرابحه سايپا203-3ماهه 16%,3,1013,942111000,922150,950000,930000,7850,0.85,930021,7871,0.85,930000,950000,1399-6-5
846,تملي705,تسهيلات مسكن ب. ملي-مرداد97,3,7,1036700,141048,148100,148100,7052,5.0,148100,7052,5.0,148100,148100,1399-6-5
847,كيش1402,اجاره س. و توسعه كيش14020820,3,300,306000000,1000000,1020000,1020000,20000,2.0,1020000,20000,2.0,1020000,1020000,1399-6-5
848,ضجار7017,اختيارخ وتجارت-1900-1399/07/22,3,5,9013000,1300,1741,1900,600,46.15,1803,503,38.69,1741,1900,1399-6-5
849,ضگل8061,اختيارخ كگل-17100-1399/08/21,3,3,21999000,5500,11000,999,-4501,-81.84,7333,1833,33.33,999,11000,1399-6-5
850,ضفلا8087,اختيارخ فولاد-18775-1399/08/28,2,17,104600000,5495,6200,6100,605,11.01,6153,658,11.97,6100,6200,1399-6-5
851,ضجار7028,اختيارخ وتجارت-4000-1399/07/22,2,63,49959000,475,793,793,318,66.95,793,318,66.95,793,793,1399-6-5
852,صخود412,ص مرابحه خودرو412- 3ماهه 18%,2,29,28452299,981707,981111,981119,-588,-0.06,981114,-593,-0.06,981111,981119,1399-6-5
853,پشاهن,توليدي پلاستيك‌ شاهين,2,1571,12148543,7365,7733,7733,368,5.0,7365,0,0.0,7733,7733,1399-6-5
854,صمسكن912,ص دين مسكن جنوب-ماهانه16درصد,2,134,25114280,178496,187420,187420,8924,5.0,187420,8924,5.0,187420,187420,1399-6-5
855,ضبدر8069,اختيارخ شبندر-55580-1399/08/18,2,2,20001000,9720,10001,10000,280,2.88,10000,280,2.88,10000,10001,1399-6-5
856,ضبدر8071,اختيارخ شبندر-65580-1399/08/18,2,3,25000000,4145,8000,8500,4355,105.07,8333,4188,101.04,8000,8500,1399-6-5
857,ضچاد7025,اختيارخ كچاد-26000-1399/07/07,2,81,121503000,2500,1500,1503,-997,-39.88,1500,-1000,-40.0,1500,1503,1399-6-5
858,اميد99,مشارکت ليزينگ اميد9907,2,130,130650000,1010000,1010000,1000000,-10000,-0.99,1005000,-5000,-0.5,1000000,1010000,1399-6-5
859,ضگل8054,اختيارخ كگل-10100-1399/08/21,2,8,86000000,13900,10000,12000,-1900,-13.67,10750,-3150,-22.66,10000,12000,1399-6-5
860,صايپا998,صكوك مرابحه سايپا998-3ماهه 18%,2,174,173170550,994950,1004800,994950,0,0.0,995233,283,0.03,994950,1004800,1399-6-5
861,ضترا8027,اختيارخ شتران-6353-1399/08/11,2,4,52000000,20000,3000,23000,3000,15.0,13000,-7000,-35.0,3000,23000,1399-6-5
862,ضفلا8090,اختيارخ فولاد-23775-1399/08/28,2,3,14970000,4333,4990,4990,657,15.16,4990,657,15.16,4990,4990,1399-6-5
863,ضمخا7037,اختيارخ اخابر-2950-1399/07/30,2,2,46500000,1,23000,23500,23499,2349900.0,23250,23249,2324900.0,23000,23500,1399-6-5
864,ضغدر8047,اختيارخ وغدير-20000-1399/08/26,2,2,15591000,6375,7796,7795,1420,22.27,7795,1420,22.27,7795,7796,1399-6-5
865,ضفلا8078,اختيارخ فولاد-9775-1399/08/28,2,10,114000000,9964,11400,11400,1436,14.41,11400,1436,14.41,11400,11400,1399-6-5
866,ضصاد8010,اختيارخ وبصادر-2400-1399/08/11,2,2,3800000,1643,1800,2000,357,21.73,1900,257,15.64,1800,2000,1399-6-5
867,ضسپا8021,اختيارخ خساپا-3000-1399/08/26,2,22,35200000,1500,1600,1600,100,6.67,1600,100,6.67,1600,1600,1399-6-5
868,ضترا8040,اختيارخ شتران-16326-1399/08/11,2,11,163800000,9500,14100,17000,7500,78.95,14891,5391,56.75,14100,17000,1399-6-5
869,ضملي8070,اختيارخ فملي -17750-1399/08/06,2,2,37400000,15000,18700,18700,3700,24.67,18700,3700,24.67,18700,18700,1399-6-5
870,اخزا716,اسنادخزانه-م16بودجه97-000407,2,408,354144000,872209,868000,868000,-4209,-0.48,868000,-4209,-0.48,868000,868000,1399-6-5
871,ضسپا8020,اختيارخ خساپا-2800-1399/08/26,2,148,333502000,1600,2458,1840,240,15.0,2253,653,40.81,1840,2458,1399-6-5
872,تملي710,تسهيلات مسكن ب. ملي-دي97,2,24,5351352,212356,222973,222973,10617,5.0,222973,10617,5.0,222973,222973,1399-6-5
873,ضپنا7045,اختيارخ رمپنا-40407-1399/07/13,2,14,56000000,5000,4000,4000,-1000,-20.0,4000,-1000,-20.0,4000,4000,1399-6-5
874,ضگل8057,اختيارخ كگل-13100-1399/08/21,2,10,87000000,5904,8700,8700,2796,47.36,8700,2796,47.36,8700,8700,1399-6-5
875,ضفار8017,اختيارخ فارس-3076-1399/08/06,2,2,20560000,1,560,20000,19999,1999900.0,10280,10279,1027900.0,560,20000,1399-6-5
876,ضغدر8039,اختيارخ وغدير-12000-1399/08/26,2,5,49500000,8000,9900,9900,1900,23.75,9900,1900,23.75,9900,9900,1399-6-5
877,ضپار8014,اختيارخ خپارس-2800-1399/08/18,1,1,11000000,11600,11000,11000,-600,-5.17,11000,-600,-5.17,11000,11000,1399-6-5
878,شستا992,اجاره تامين اجتماعي-سپهر991226,1,15,15015075,1001010,1001005,1001005,-5,0.0,1001005,-5,0.0,1001005,1001005,1399-6-5
879,ضچاد7017,اختيارخ كچاد-14300-1399/07/07,1,5,35000000,8200,7000,7000,-1200,-14.63,7000,-1200,-14.63,7000,7000,1399-6-5
880,ضخوز7023,اختيارخ فخوز-31470-1399/07/20,1,1,18000000,16000,18000,18000,2000,12.5,18000,2000,12.5,18000,18000,1399-6-5
881,ضخوز7017,اختيارخ فخوز-19470-1399/07/20,1,5,145000000,27000,29000,29000,2000,7.41,29000,2000,7.41,29000,29000,1399-6-5
882,ضغدر8044,اختيارخ وغدير-17000-1399/08/26,1,35,201950000,5146,5770,5770,624,12.13,5770,624,12.13,5770,5770,1399-6-5
883,ضپار8013,اختيارخ خپارس-2600-1399/08/18,1,1,11000000,10589,11000,11000,411,3.88,11000,411,3.88,11000,11000,1399-6-5
884,تملي612,تسهيلات مسكن بانك ملي-اسفند96,1,1,1184927,1128502,1184927,1184927,56425,5.0,1184927,56425,5.0,1184927,1184927,1399-6-5
885,تملي712,تسهيلات مسكن ب. ملي-اسفند97,1,1,228743,217851,228743,228743,10892,5.0,228743,10892,5.0,228743,228743,1399-6-5
886,ضشنا7075,اختيارخ شپنا-18522-1399/07/28,1,10,145000000,10264,14500,14500,4236,41.27,14500,4236,41.27,14500,14500,1399-6-5
887,تملي706,تسهيلات مسكن ب. ملي-شهريور97,1,3,356862,113290,118954,118954,5664,5.0,118954,5664,5.0,118954,118954,1399-6-5
888,اخزا819,اسنادخزانه-م19بودجه98-020322,1,336,207162816,604270,616556,616556,12286,2.03,616556,12286,2.03,616556,616556,1399-6-5
889,ضغدر8046,اختيارخ وغدير-19000-1399/08/26,1,1,7000000,4667,7000,7000,2333,49.99,7000,2333,49.99,7000,7000,1399-6-5
890,دمعيار2,صندوق س. توازن معيار-د,1,6000000,6000000,10017,1,1,-10016,-99.99,1,-10016,-99.99,1,1,1399-6-5
891,ضگل8056,اختيارخ كگل-12100-1399/08/21,1,14,149800000,15443,10700,10700,-4743,-30.71,10700,-4743,-30.71,10700,10700,1399-6-5
892,ضفار8040,اختيارخ فارس-15826-1399/08/06,1,6,30000000,9500,5000,5000,-4500,-47.37,5000,-4500,-47.37,5000,5000,1399-6-5
893,تملي711,تسهيلات مسكن ب. ملي-بهمن97,1,1,237757,226436,237757,237757,11321,5.0,237757,11321,5.0,237757,237757,1399-6-5
894,افرا2,افرانت,1,19000000,1471550000000,74639,77450,77450,2811,3.77,77450,2811,3.77,77450,77450,1399-6-5
895,ضخود7069,اختيارخ خودرو-8500-1399/07/09,1,2,800000,400,400,400,0,0.0,400,0,0.0,400,400,1399-6-5
896,غنيلي,مجتمع توليدي نيلي صنعت كرمان,1,15000,286350000,19092,19090,19090,-2,-0.01,19090,-2,-0.01,19090,19090,1399-6-5
897,ضشنا7073,اختيارخ شپنا-15837-1399/07/28,1,1,25000000,13500,25000,25000,11500,85.19,25000,11500,85.19,25000,25000,1399-6-5
898,ضشنا7048,اختيارخ شپنا-2685-1399/07/28,1,1,35500000,32518,35500,35500,2982,9.17,35500,2982,9.17,35500,35500,1399-6-5
899,تبريز112,مشاركت شهرداري تبريز-3ماهه18%,1,5,4999995,998808,999999,999999,1191,0.12,999999,1191,0.12,999999,999999,1399-6-5
900,صخابر102,صكوك اجاره مخابرات-3 ماهه 16%,1,1000,997000000,990069,997000,997000,6931,0.7,997000,6931,0.7,997000,997000,1399-6-5
901,ضچاد7020,اختيارخ كچاد-17300-1399/07/07,1,2,11000000,4414,5500,5500,1086,24.6,5500,1086,24.6,5500,5500,1399-6-5
902,تملي802,تسهيلات مسكن ب. ملي-ارديبهشت98,1,1,229304,218385,229304,229304,10919,5.0,229304,10919,5.0,229304,229304,1399-6-5
903,ضبدر8062,اختيارخ شبندر-33580-1399/08/18,1,5,90000000,20000,18000,18000,-2000,-10.0,18000,-2000,-10.0,18000,18000,1399-6-5
904,ضجار7025,اختيارخ وتجارت-3400-1399/07/22,1,3,3000000,1097,1000,1000,-97,-8.84,1000,-97,-8.84,1000,1000,1399-6-5
905,ضغدر8042,اختيارخ وغدير-15000-1399/08/26,1,50,385000000,6111,7700,7700,1589,26.0,7700,1589,26.0,7700,7700,1399-6-5
906,ضجار7020,اختيارخ وتجارت-2400-1399/07/22,1,1,1580000,1408,1580,1580,172,12.22,1580,172,12.22,1580,1580,1399-6-5
907,ضچاد7018,اختيارخ كچاد-15300-1399/07/07,1,1,6600000,4500,6600,6600,2100,46.67,6600,2100,46.67,6600,6600,1399-6-5
908,اشاد102,مشاركت دولتي10-شرايط خاص001226,1,85,80325000,945101,945000,945000,-101,-0.01,945000,-101,-0.01,945000,945000,1399-6-5
909,شتران2,پالايش نفت تهران,1,1000000,36480000000,34750,36480,36480,1730,4.98,36480,1730,4.98,36480,36480,1399-6-5
910,ضفلا8068,اختيارخ فولاد-4751-1399/08/28,1,1,24120000,13500,15000,15000,1500,11.11,15000,1500,11.11,15000,15000,1399-6-5
911,ضملي8058,اختيارخ فملي -7750-1399/08/06,1,100,2300000000,22273,23000,23000,727,3.26,23000,727,3.26,23000,23000,1399-6-5
912,صخود0004,صكوك رهني خودرو0004- 3ماهه 16%,1,2,1940000,970000,970000,970000,0,0.0,970000,0,0.0,970000,970000,1399-6-5
913,ضفلا8086,اختيارخ فولاد-17775-1399/08/28,1,1,6610000,6355,6610,6610,255,4.01,6610,255,4.01,6610,6610,1399-6-5
914,صخود0012,ص مرابحه خودرو0012- 3ماهه 18%,1,10,10400000,1040000,1040000,1040000,0,0.0,1040000,0,0.0,1040000,1040000,1399-6-5
915,مگچسا104,مشاركت گچساران- 3 ماهه 18%,1,2,1939200,961000,969600,969600,8600,0.89,969600,8600,0.89,969600,969600,1399-6-5
916,ضفار8038,اختيارخ فارس-13826-1399/08/06,1,1,8400000,7500,8400,8400,900,12.0,8400,900,12.0,8400,8400,1399-6-5
917,تملي701,تسهيلات مسكن ب. ملي-فروردين97,1,1,252253,240241,252253,252253,12012,5.0,252253,12012,5.0,252253,252253,1399-6-5
918,ضملي8080,اختيارخ فملي-35750-1399/08/06,1,12,108000000,3200,9000,9000,5800,181.25,9000,5800,181.25,9000,9000,1399-6-5
919,ضگل8060,اختيارخ كگل-16100-1399/08/21,1,20,140000000,4700,7000,7000,2300,48.94,7000,2300,48.94,7000,7000,1399-6-5
920,عفولاد4,اوراق سلف ورق گرم فولاد اصفهان,1,6000,5243814000,873559,873969,873969,410,0.05,873969,410,0.05,873969,873969,1399-6-5
921,تملي801,تسهيلات مسكن ب. ملي-فروردين98,1,1,176352,167955,176352,176352,8397,5.0,176352,8397,5.0,176352,176352,1399-6-5
922,ضبدر8065,اختيارخ شبندر-39580-1399/08/18,1,5,70500000,12489,14100,14100,1611,12.9,14100,1611,12.9,14100,14100,1399-6-5
923,ضفلا8091,اختيارخ فولاد-25775-1399/08/28,1,8,35040000,3973,4380,4380,407,10.24,4380,407,10.24,4380,4380,1399-6-5
924,شجم2,صنايع پتروشيمي تخت جمشيد,1,37795935,421235695575,11332,11145,11145,-187,-1.65,11145,-187,-1.65,11145,11145,1399-6-5
925,ضشنا7055,اختيارخ شپنا-4429-1399/07/28,1,1,36000000,28000,36000,36000,8000,28.57,36000,8000,28.57,36000,36000,1399-6-5
926,ضصاد8022,اختيارخ وبصادر-4800-1399/08/11,1,5,3750000,300,750,750,450,150.0,750,450,150.0,750,750,1399-6-5
927,ضخود7044,اختيارخ خودرو-2000-1399/07/09,1,20,56000000,2000,2800,2800,800,40.0,2800,800,40.0,2800,2800,1399-6-5
928,ضپار8019,اختيارخ خپارس-3800-1399/08/18,1,1,10001000,10329,10001,10001,-328,-3.18,10001,-328,-3.18,10001,10001,1399-6-5
929,ضشنا7085,اختيارخ شپنا-37311-1399/07/28,1,4,28000000,5000,7000,7000,2000,40.0,7000,2000,40.0,7000,7000,1399-6-5
930,صخود1412,ص مرابحه خودرو1412- 3ماهه 18%,1,9,9045000,1005000,1005000,1005000,0,0.0,1005000,0,0.0,1005000,1005000,1399-6-5
931,اجاد22,اجاره دولتي آپرورش-لوتوس991118,1,50,50000000,1010000,1000000,1000000,-10000,-0.99,1000000,-10000,-0.99,1000000,1000000,1399-6-5
932,ضخوز7022,اختيارخ فخوز-29470-1399/07/20,1,4,88000000,20000,22000,22000,2000,10.0,22000,2000,10.0,22000,22000,1399-6-5
933,كايتا,ايتالران‌,1,1,116033,110508,116033,116033,5525,5.0,110508,0,0.0,116033,116033,1399-6-5
934,كرانه99,مرابحه بنا گستر كرانه991222,1,1,984000,985094,984000,984000,-1094,-0.11,984000,-1094,-0.11,984000,984000,1399-6-5
935,ضچاد7022,اختيارخ كچاد-19300-1399/07/07,1,1,5000000,8083,5000,5000,-3083,-38.14,5000,-3083,-38.14,5000,5000,1399-6-5
936,ضملي8067,اختيارخ فملي -14750-1399/08/06,1,1,18000000,16082,18000,18000,1918,11.93,18000,1918,11.93,18000,18000,1399-6-5
937,ضسپا8015,اختيارخ خساپا-1900-1399/08/26,1,30,69000000,2350,2300,2300,-50,-2.13,2300,-50,-2.13,2300,2300,1399-6-5
938,فاسمين2,كالسيمين‌,1,8900000,668212000000,74370,75080,75080,710,0.95,75080,710,0.95,75080,75080,1399-6-5
