,نماد,نام,تعداد,حجم,ارزش,دیروز,اولین,آخرین معامله - مقدار,آخرین معامله - تغییر,آخرین معامله - درصد,قیمت پایانی - مقدار,قیمت پایانی - تغییر,قیمت پایانی - درصد,کمترین,بیشترین,تاریخ
0,وكبهمن,مديريت سرمايه گذاري كوثربهمن,133755,59088489,1393584740035,22517,23300,23642,1125,5.0,23585,1068,4.74,23000,23642,1399-10-15
1,بوعلي,پتروشيمي بوعلي سينا,111866,41445964,2332894454340,58210,59380,55300,-2910,-5.0,56290,-1920,-3.3,55300,60500,1399-10-15
2,دارا يكم,صندوق واسطه گري مالي يكم-سهام,46647,21472980,3402029048380,150800,153000,160300,9500,6.3,158430,7630,5.06,150610,164960,1399-10-15
3,شستا,سرمايه گذاري تامين اجتماعي,46580,129011606,2754404451190,21290,21290,21080,-210,-0.99,21350,60,0.28,20920,22000,1399-10-15
4,بركت,گروه دارويي بركت,45351,131055822,3480391972010,27760,27100,26380,-1380,-4.97,26560,-1200,-4.32,26380,28380,1399-10-15
5,بپيوند,برق و انرژي پيوندگستر پارس,41182,44063486,980668038653,23107,22700,21953,-1154,-4.99,22256,-851,-3.68,21952,23100,1399-10-15
6,ولپارس,ليزينگ پارسيان,40951,108664456,823695730610,7920,7750,7530,-390,-4.92,7580,-340,-4.29,7530,7960,1399-10-15
7,پالايش,صندوق پالايشي يکم-سهام,40334,30742892,2367125240570,75560,77500,76600,1040,1.38,77000,1440,1.91,75000,78400,1399-10-15
8,خودرو,ايران‌ خودرو,39873,1046244915,3227598473310,2980,3060,3090,110,3.69,3080,100,3.36,2980,3120,1399-10-15
9,چخزر,صنايع چوب خزر كاسپين,39114,1635357,58262863839,33931,35627,35627,1696,5.0,35627,1696,5.0,35627,35627,1399-10-15
10,وسپهر,سرمايه گذاري مالي سپهرصادرات,38704,93966294,973299227585,10377,10400,10401,24,0.23,10358,-19,-0.18,10225,10503,1399-10-15
11,شپنا,پالايش نفت اصفهان,38701,195245899,2371915742700,11900,12100,12230,330,2.77,12150,250,2.1,11730,12450,1399-10-15
12,شاروم,پتروشيمي اروميه,31126,25637261,769035485692,31330,30600,29764,-1566,-5.0,29997,-1333,-4.25,29764,31500,1399-10-15
13,ثاميد,توسعه و عمران اميد,29685,206590083,416626722940,1950,1980,2040,90,4.62,2020,70,3.59,1910,2040,1399-10-15
14,كاما,باما,29081,106469388,2653720737250,24360,24250,25570,1210,4.97,24920,560,2.3,23500,25570,1399-10-15
15,خساپا,سايپا,28869,941253077,2162523493670,2200,2280,2310,110,5.0,2300,100,4.55,2220,2310,1399-10-15
16,وتجارت,بانك تجارت,25767,594591972,1975856319350,3190,3370,3270,80,2.51,3320,130,4.08,3220,3450,1399-10-15
17,خگستر,گسترش‌سرمايه‌گذاري‌ايران‌خودرو,25617,439598537,1639259458690,3670,3710,3700,30,0.82,3730,60,1.63,3590,3840,1399-10-15
18,امين,تامين سرمايه امين,25521,21435791,233716535710,10490,10680,11010,520,4.96,10900,410,3.91,10450,11010,1399-10-15
19,سيتا,سرمايه گذاري سيمان تامين,22447,30908724,471493196770,15220,15300,15120,-100,-0.66,15250,30,0.2,15010,15600,1399-10-15
20,غزر,صنعتي زر ماكارون,21984,3172864,159339999950,49420,48400,51480,2060,4.17,50220,800,1.62,48300,51800,1399-10-15
21,ثبهساز,بهساز كاشانه تهران,21653,86289508,221900335120,2470,2550,2590,120,4.86,2570,100,4.05,2470,2590,1399-10-15
22,آبادا,توليد نيروي برق آبادان,21203,6952714,125749161180,17270,18100,18130,860,4.98,18090,820,4.75,17770,18130,1399-10-15
23,بگيلان,توسعه مسير برق گيلان,20631,6645349,152666022749,22776,22502,22865,89,0.39,22973,197,0.86,22200,23590,1399-10-15
24,فولاد,فولاد مباركه اصفهان,20590,84691004,1074519281720,12640,12720,12640,0,0.0,12690,50,0.4,12570,13000,1399-10-15
25,شتران,پالايش نفت تهران,18636,79575092,821535758290,10030,10060,10420,390,3.89,10320,290,2.89,9940,10530,1399-10-15
26,فزرين,زرين معدن آسيا,18304,85006651,2060414609743,23827,25018,24001,174,0.73,24238,411,1.72,22810,25018,1399-10-15
27,زملارد,كشاورزي و دامپروري ملارد شير,18226,2380853,126278062267,50514,53039,53039,2525,5.0,53039,2525,5.0,53039,53039,1399-10-15
28,وپويا,سرمايه گذاري پويا,17054,21005300,154733474736,7107,7440,7462,355,5.0,7366,259,3.64,7070,7462,1399-10-15
29,گدنا,تهيه توزيع غذاي دنا آفرين فدك,17035,14840626,704566970158,47547,49924,45170,-2377,-5.0,47476,-71,-0.15,45170,49924,1399-10-15
30,ثشاهد,سرمايه‌ گذاري‌ شاهد,16572,53058665,1126836630800,21780,21600,21050,-730,-3.35,21240,-540,-2.48,20700,22390,1399-10-15
31,خبهمن,گروه‌بهمن‌,16445,69874308,2031226806590,30140,30000,28640,-1500,-4.98,29070,-1070,-3.55,28640,30400,1399-10-15
32,فملي,ملي‌ صنايع‌ مس‌ ايران‌,16245,44208266,611576362160,13660,14000,13720,60,0.44,13830,170,1.24,13630,14150,1399-10-15
33,غبهنوش,بهنوش‌ ايران‌,16034,15287747,1634355064970,106850,101510,111800,4950,4.63,106910,60,0.06,101510,112190,1399-10-15
34,پيزد,مجتمع صنايع لاستيك يزد,15949,3040419,232411216070,79630,78520,75649,-3981,-5.0,76441,-3189,-4.0,75649,79630,1399-10-15
35,وبملت,بانك ملت,15741,290052820,1457582676740,4840,4950,4940,100,2.07,5030,190,3.93,4910,5080,1399-10-15
36,شبندر,پالايش نفت بندرعباس,14526,44718742,1125186043340,24350,24790,25300,950,3.9,25160,810,3.33,24150,25560,1399-10-15
37,رافزا,رايان هم افزا,13990,81707,3315261525,38643,40575,40575,1932,5.0,38764,121,0.31,40575,40575,1399-10-15
38,زدشت,كشت و صنعت دشت خرم دره,13406,19687605,871747868240,45625,43612,44920,-705,-1.55,44279,-1346,-2.95,43344,46490,1399-10-15
39,انرژي3,سايراشخاص بورس انرژي,13035,2051238,883442037410,418520,430000,425900,7380,1.76,430690,12170,2.91,415200,439400,1399-10-15
40,وپارس,بانك‌پارسيان‌,12997,258394668,967473871130,3650,3750,3690,40,1.1,3740,90,2.47,3650,3830,1399-10-15
41,خكمك,كمك‌فنرايندامين‌,12903,24799832,1188534341920,48180,48500,48000,-180,-0.37,47930,-250,-0.52,45780,50570,1399-10-15
42,وبصادر,بانك صادرات ايران,12819,302036099,954990126150,3030,3160,3120,90,2.97,3160,130,4.29,3070,3180,1399-10-15
43,حكشتي,كشتيراني جمهوري اسلامي ايران,12459,30318080,659200052290,21380,21600,21650,270,1.26,21740,360,1.68,21070,22390,1399-10-15
44,ديران,ايران‌دارو,12069,28454635,933544551440,32270,32260,32570,300,0.93,32810,540,1.67,30660,33880,1399-10-15
45,دانا,بيمه دانا,12009,104639791,1125370386290,11090,11000,10600,-490,-4.42,10750,-340,-3.07,10540,11290,1399-10-15
46,ثاخت,بين‌المللي‌توسعه‌ساختمان,11957,166536414,837609095860,5190,5050,4940,-250,-4.82,5030,-160,-3.08,4940,5260,1399-10-15
47,خزاميا,زامياد,11820,70809639,820062426480,11530,11700,11410,-120,-1.04,11580,50,0.43,11020,12000,1399-10-15
48,شگويا,پتروشيمي تندگويان,11604,41021066,433851411923,10514,10631,10509,-5,-0.05,10576,62,0.59,10310,10774,1399-10-15
49,زمگسا,كشاورزي‌ ودامپروي‌ مگسال‌,10828,16528694,677715960890,42080,39980,41220,-860,-2.04,41000,-1080,-2.57,39980,43350,1399-10-15
50,پترول,گروه پتروشيمي س. ايرانيان,10689,42871278,469431558360,10720,11000,10970,250,2.33,10950,230,2.15,10700,11200,1399-10-15
51,غپينو,پارس‌ مينو,10611,121746628,1098711719180,9450,9110,8980,-470,-4.97,9020,-430,-4.55,8980,9420,1399-10-15
52,كبافق,معادن‌ بافق‌,10516,10878486,702937317550,66790,67700,63460,-3330,-4.99,64620,-2170,-3.25,63460,69000,1399-10-15
53,نهال,صندوق س. طلاي سرخ نوويرا,10484,18586713,185867130000,10000,10000,10000,0,0.0,10000,0,0.0,10000,10000,1399-10-15
54,غگل,گلوكوزان‌,10371,99185012,503346717830,5060,5110,5000,-60,-1.19,5070,10,0.2,4970,5240,1399-10-15
55,غسالم,سالمين‌,9320,83213862,468257758710,5810,5600,5530,-280,-4.82,5630,-180,-3.1,5520,5900,1399-10-15
56,نوري,پتروشيمي نوري,8819,7194539,523715328650,70730,72500,72000,1270,1.8,72790,2060,2.91,70960,74020,1399-10-15
57,وخارزم,سرمايه گذاري خوارزمي,8785,47657202,440684788140,9100,9160,9190,90,0.99,9250,150,1.65,8980,9490,1399-10-15
58,تليسه,دامداري تليسه نمونه,8661,51869565,313023920441,6004,6000,6100,96,1.6,6035,31,0.52,5800,6248,1399-10-15
59,ثقزوي,شركت عمران و سازندگي قزوين,8626,15455343,598210644684,38263,38675,37700,-563,-1.47,38706,443,1.16,37116,39410,1399-10-15
60,كماسه,تامين‌ ماسه‌ ريخته‌گري‌,8479,13473790,930349984160,66760,64700,70090,3330,4.99,69050,2290,3.43,64500,70090,1399-10-15
61,وملي,گروه‌ صنعتي‌ ملي‌ (هلدينگ‌,8435,1975987,571776734930,293820,281200,283990,-9830,-3.35,289360,-4460,-1.52,281200,301000,1399-10-15
62,خپارس,پارس‌ خودرو,8415,69937336,526593652730,7380,7540,7470,90,1.22,7530,150,2.03,7240,7730,1399-10-15
63,فوكا,فولاد كاويان,8415,47598883,717821095934,15468,15110,15004,-464,-3.0,15081,-387,-2.5,15004,15830,1399-10-15
64,سبزوا,سيمان لار سبزوار,8295,62973314,298209536385,4772,4611,4820,48,1.01,4735,-37,-0.78,4534,4990,1399-10-15
65,زكوثر,سرمايه گذاري كشاورزي كوثر,8167,18945175,496758080830,27040,27100,26880,-160,-0.59,26220,-820,-3.03,25690,27490,1399-10-15
66,خصدرا,صنعتي‌ دريايي‌ ايران‌,8149,105630796,447109247704,4353,4265,4223,-130,-2.99,4233,-120,-2.76,4223,4336,1399-10-15
67,فروس,فروسيليس‌ ايران‌,8136,73032178,447063773470,6300,6100,6070,-230,-3.65,6120,-180,-2.86,5990,6440,1399-10-15
68,غبهار,كشت وصنعت بهاران گلبهار خراسان,7944,12333618,678333136835,55242,56899,53585,-1657,-3.0,54999,-243,-0.44,53585,56899,1399-10-15
69,گكوثر,هتل پارسيان كوثر اصفهان,7678,112464151,527911603994,4904,4904,4659,-245,-5.0,4694,-210,-4.28,4659,5000,1399-10-15
70,وساپا,سرمايه‌گذاري‌ سايپا,7622,82460134,709235212320,8250,8520,8660,410,4.97,8600,350,4.24,8210,8660,1399-10-15
71,ختوقا,قطعات‌ اتومبيل‌ ايران‌,7556,123201750,441141186940,3460,3540,3550,90,2.6,3580,120,3.47,3350,3630,1399-10-15
72,چكاپا,گروه صنايع كاغذ پارس,7379,62968796,400986510630,6400,6500,6310,-90,-1.41,6370,-30,-0.47,6170,6640,1399-10-15
73,دبالك,مواد اوليه دارويي البرز بالك,7376,16535391,478561448563,29435,28580,28200,-1235,-4.2,28942,-493,-1.67,27964,30789,1399-10-15
74,فرابورس,فرابورس ايران,7350,9776880,499894556802,52174,52497,50025,-2149,-4.12,51130,-1044,-2.0,50000,53000,1399-10-15
75,ثغرب,شركت سرمايه گذاري مسكن شمالغرب,7276,41799376,399160004009,9678,9195,9500,-178,-1.84,9549,-129,-1.33,9195,10000,1399-10-15
76,ونيكي,سرمايه‌گذاري‌ ملي‌ايران‌,7185,22161824,382460284500,17770,17600,17010,-760,-4.28,17260,-510,-2.87,16890,18100,1399-10-15
77,پتاير,ايران‌ تاير,6917,3308821,586428144090,172860,171010,180700,7840,4.54,177230,4370,2.53,167320,181490,1399-10-15
78,البرز,بيمه البرز,6899,163679198,1023014413510,5980,6180,6270,290,4.85,6250,270,4.52,6100,6270,1399-10-15
79,ثفارس,عمران‌وتوسعه‌فارس‌,6793,45352755,543160643110,11630,11350,12210,580,4.99,11980,350,3.01,11330,12210,1399-10-15
80,وپست,پست بانك ايران,6546,24855451,495372705120,19580,20400,19190,-390,-1.99,19930,350,1.79,19000,20550,1399-10-15
81,كالا,بورس كالاي ايران,6545,7981644,401471619960,51100,52000,49170,-1930,-3.78,50300,-800,-1.57,48890,52290,1399-10-15
82,وغدير,سرمايه‌گذاري‌غدير(هلدينگ‌,6350,25601196,300777659550,11520,11610,11800,280,2.43,11750,230,2.0,11600,11890,1399-10-15
83,ملت,بيمه ملت,6191,24100870,533479251480,21620,20850,22060,440,2.04,22140,520,2.41,20850,22700,1399-10-15
84,صبا,سرمايه گذاري صبا تامين,6137,17556413,136602795657,7565,7591,7825,260,3.44,7781,216,2.86,7580,7900,1399-10-15
85,لپارس,پارس‌ الكتريك‌,5957,3481242,454713627350,125620,124860,131900,6280,5.0,130620,5000,3.98,124860,131900,1399-10-15
86,خرينگ,رينگ‌سازي‌مشهد,5905,7821603,532750219060,70910,69250,67370,-3540,-4.99,68110,-2800,-3.95,67370,72800,1399-10-15
87,قثابت,قند ثابت‌ خراسان‌,5818,5628946,437610348000,76490,79990,79210,2720,3.56,77740,1250,1.63,73520,79990,1399-10-15
88,شبريز,پالايش نفت تبريز,5804,12889652,377703429700,29140,29200,29100,-40,-0.14,29300,160,0.55,28500,30100,1399-10-15
89,غگيلا,شيرپاستوريزه پگاه گيلان,5784,489490,10644939030,20712,21747,21747,1035,5.0,20918,206,0.99,21747,21747,1399-10-15
90,ودي,بيمه  دي,5709,30212541,790427873308,26383,26200,26990,607,2.3,26162,-221,-0.84,25120,27250,1399-10-15
91,كفپارس,فرآورده‌هاي‌ نسوز پارس‌,5666,44438878,283909972920,6610,6600,6320,-290,-4.39,6390,-220,-3.33,6280,6600,1399-10-15
92,غمهرا,توليدي‌مهرام‌,5661,3646279,343661938070,94070,98760,89370,-4700,-5.0,94250,180,0.19,89370,98770,1399-10-15
93,ونوين,بانك‌اقتصادنوين‌,5619,88543493,459356173810,5080,5080,5150,70,1.38,5190,110,2.17,5000,5320,1399-10-15
94,تبرك,گروه كارخانجات صنعتي تبرك,5564,11306725,256763874659,22688,22898,22270,-418,-1.84,22709,21,0.09,21800,23330,1399-10-15
95,چكارن,كارتن‌ ايران‌,5547,65429046,320654371610,4700,5000,4750,50,1.06,4900,200,4.26,4750,5150,1399-10-15
96,شتوكا,توكا رنگ فولاد سپاهان,5503,10033990,655599470499,62227,65338,65338,3111,5.0,65338,3111,5.0,65000,65338,1399-10-15
97,قرن,پديده شيمي قرن,5426,6178497,418906861700,68020,69800,66700,-1320,-1.94,67800,-220,-0.32,65010,70800,1399-10-15
98,دتوليد,داروسازي توليد دارو,5374,8754864,308013696441,36502,35442,34680,-1822,-4.99,35182,-1320,-3.62,34677,37680,1399-10-15
99,هاي وب,داده گسترعصرنوين-هاي وب,5348,19988382,538364244990,25690,26950,26970,1280,4.98,26930,1240,4.83,25870,26970,1399-10-15
100,كمنگنز,معادن‌منگنزايران‌,5284,3206668,412395385830,126840,122500,133180,6340,5.0,128610,1770,1.4,120500,133180,1399-10-15
101,پدرخش,درخشان‌ تهران‌,5260,3653669,612625778580,163560,168850,171730,8170,5.0,167670,4110,2.51,156100,171730,1399-10-15
102,خمحركه,نيرو محركه‌,5186,42769548,271677136820,6120,6410,6420,300,4.9,6350,230,3.76,6150,6420,1399-10-15
103,بزاگرس,نيروگاه زاگرس كوثر,5029,22301563,236341519427,10533,10277,10934,401,3.81,10598,65,0.62,10011,10995,1399-10-15
104,زگلدشت,كشت و دام گلدشت نمونه اصفهان,4945,4575892,272505340421,61658,59260,58576,-3082,-5.0,59552,-2106,-3.42,58576,62296,1399-10-15
105,تنوينح,ح . تامين سرمايه نوين,4880,21440197,99126710953,4459,4470,4630,171,3.83,4623,164,3.68,4460,4670,1399-10-15
106,كهمدا,شيشه‌ همدان‌,4864,18337221,250825269050,13580,14220,13190,-390,-2.87,13680,100,0.74,13000,14220,1399-10-15
107,بجهرم,توسعه مولد نيروگاهي جهرم,4786,44118025,172048130795,3746,3810,3933,187,4.99,3900,154,4.11,3770,3933,1399-10-15
108,دماوند,توليد نيروي برق دماوند,4705,4716441,277982710147,58250,57840,59900,1650,2.83,58939,689,1.18,56000,61000,1399-10-15
109,فروي,ذوب روي اصفهان,4673,3309263,262591427188,75667,79400,79450,3783,5.0,79350,3683,4.87,78500,79450,1399-10-15
110,غفارس,شير پاستوريزه پگاه فارس,4665,37733741,471565129927,12990,12341,12341,-649,-5.0,12497,-493,-3.8,12341,13250,1399-10-15
111,خاهن,آهنگري‌ تراكتورسازي‌ ايران‌,4606,8626431,360912549570,43020,43000,40920,-2100,-4.88,41840,-1180,-2.74,40870,43700,1399-10-15
112,وگردش,بانك گردشگري,4595,19802491,483427229647,25060,24400,24309,-751,-3.0,24412,-648,-2.59,24309,25050,1399-10-15
113,كگهر,سنگ آهن گهرزمين,4549,9009775,495965740039,52493,55117,55117,2624,5.0,55048,2555,4.87,54000,55117,1399-10-15
114,ثباغ,شهر سازي و خانه سازي باغميشه,4533,12430022,303625240016,24467,25650,23260,-1207,-4.93,24427,-40,-0.16,23244,25690,1399-10-15
115,غشهداب,كشت و صنعت شهداب ناب خراسان,4476,39362157,196515002538,4974,4920,4900,-74,-1.49,4992,18,0.36,4820,5120,1399-10-15
116,شسينا,صنايع‌شيميايي‌سينا,4475,2099948,339746673680,158550,152000,166470,7920,5.0,161790,3240,2.04,152000,166470,1399-10-15
117,وملل,اعتباري ملل,4419,43625627,753498277991,16697,17349,17000,303,1.81,17272,575,3.44,16900,17530,1399-10-15
118,ساوه,سيمان ساوه,4357,1803164,98009942975,51916,53000,54511,2595,5.0,54354,2438,4.7,53000,54511,1399-10-15
119,فارس,صنايع پتروشيمي خليج فارس,4306,14758036,181505463010,12120,12360,12210,90,0.74,12300,180,1.49,12040,12600,1399-10-15
120,تاپيكو,س. نفت و گاز و پتروشيمي تأمين,4301,18366595,259400502690,13810,14000,13990,180,1.3,14120,310,2.24,13710,14480,1399-10-15
121,تملت,تامين سرمايه بانك ملت,4060,16576349,141888158900,8230,8080,8640,410,4.98,8560,330,4.01,8080,8640,1399-10-15
122,قصفها,قنداصفهان‌,4044,1359999,238336751290,180070,173210,173000,-7070,-3.93,175250,-4820,-2.68,171070,181000,1399-10-15
123,ورنا,سرمايه‌گذاري‌ رنا(هلدينگ‌,4041,26685194,222226534660,8070,8110,8470,400,4.96,8330,260,3.22,8000,8470,1399-10-15
124,فاراك,ماشين‌ سازي‌ اراك‌,4032,22958781,167257224890,7150,7110,7100,-50,-0.7,7290,140,1.96,7100,7450,1399-10-15
125,ولغدر,ليزينگ‌خودروغدير,3972,14761603,412825218770,27000,25810,28320,1320,4.89,27970,970,3.59,25810,28350,1399-10-15
126,جهرم,پتروشيمي جهرم,3897,49401752,122391411791,2543,2420,2520,-23,-0.9,2477,-66,-2.6,2416,2600,1399-10-15
127,ومعادن,توسعه‌معادن‌وفلزات‌,3868,14820572,195644761240,12800,13190,13100,300,2.34,13200,400,3.13,12860,13440,1399-10-15
128,خاور,ايران خودرو ديزل,3868,40370425,337529454173,8603,8345,8345,-258,-3.0,8361,-242,-2.81,8345,8600,1399-10-15
129,ثعمرا,عمران و توسعه شاهد,3850,14689175,192741554237,12969,12760,13230,261,2.01,13121,152,1.17,12330,13600,1399-10-15
130,فاسمين,كالسيمين‌,3843,18529373,373018067220,19280,19790,20240,960,4.98,20130,850,4.41,19370,20240,1399-10-15
131,ولساپا,ليزينگ رايان‌ سايپا,3782,49257855,204233378300,3990,4130,4180,190,4.76,4150,160,4.01,4010,4180,1399-10-15
132,رنيك,جنرال مكانيك,3779,9286662,236564258794,25156,24600,25400,244,0.97,25474,318,1.26,24300,26230,1399-10-15
133,كمند,صندوق س. با درآمد ثابت كمند,3759,174420252,1772901844094,10159,10164,10168,9,0.09,10165,6,0.06,10164,10168,1399-10-15
134,كگل,معدني و صنعتي گل گهر,3758,14183437,282223184110,19760,20640,19630,-130,-0.66,19900,140,0.71,19430,20640,1399-10-15
135,اخابر,مخابرات ايران,3742,28446062,385326715210,13000,13250,13650,650,5.0,13550,550,4.23,13000,13650,1399-10-15
136,غمارگ,مارگارين‌,3730,6871388,265830773720,40030,41900,38050,-1980,-4.95,38690,-1340,-3.35,38030,41900,1399-10-15
137,چافست,افست‌,3664,9049096,185102747430,20890,20050,20450,-440,-2.11,20460,-430,-2.06,19850,21300,1399-10-15
138,افرا,افرانت,3653,8339361,450091953678,51696,54280,53000,1304,2.52,53972,2276,4.4,52650,54280,1399-10-15
139,شيران,س. صنايع‌شيميايي‌ايران,3643,9642422,376004145750,37530,38500,39400,1870,4.98,38990,1460,3.89,38240,39400,1399-10-15
140,شغدير,پتروشيمي غدير,3624,6063751,420817726417,70453,70500,67560,-2893,-4.11,69399,-1054,-1.5,67100,71499,1399-10-15
141,دشيمي,شيمي‌ داروئي‌ داروپخش‌,3623,5249438,344296990160,68700,65270,65270,-3430,-4.99,65590,-3110,-4.53,65270,68000,1399-10-15
142,وپاسار,بانك  پاسارگاد,3621,36747753,438676992540,11500,11570,11990,490,4.26,11940,440,3.83,11570,12000,1399-10-15
143,تاپكيش,تجارت الكترونيك پارسيان كيش,3577,14748876,337406808929,22355,22228,23472,1117,5.0,22877,522,2.34,21278,23472,1399-10-15
144,فسا,پتروشيمي فسا,3576,61902841,139132057400,2279,2166,2253,-26,-1.14,2248,-31,-1.36,2166,2392,1399-10-15
145,حفارس,حمل و نقل بين المللي خليج فارس,3567,37502103,181781961630,4850,4930,4740,-110,-2.27,4850,0,0.0,4690,5030,1399-10-15
146,كاوه,فولاد كاوه جنوب كيش,3518,11675595,240934358430,20670,20690,20570,-100,-0.48,20640,-30,-0.15,20210,21280,1399-10-15
147,وهنر,گروه توسعه هنر ايران,3437,49929867,274580515731,5497,5333,5375,-122,-2.22,5499,2,0.04,5333,5661,1399-10-15
148,وهور,مديريت انرژي اميد  تابان هور,3433,6490896,289731082686,43022,44000,43610,588,1.37,44637,1615,3.75,43000,45173,1399-10-15
149,نوين,بيمه نوين,3393,26511332,216861193504,7872,7800,8265,393,4.99,8180,308,3.91,7750,8265,1399-10-15
150,داراب,پتروشيمي داراب,3336,54321807,146634264909,2748,2666,2666,-82,-2.98,2699,-49,-1.78,2666,2800,1399-10-15
151,كوير,توليدي فولاد سپيد فراب كوير,3334,10785877,233621761750,22290,22490,21230,-1060,-4.76,21660,-630,-2.83,21180,22900,1399-10-15
152,فالوم,آلومتك‌,3332,10066005,401502401520,38940,39980,39876,936,2.4,39887,947,2.43,38011,40108,1399-10-15
153,بموتو,موتوژن‌,3331,3821885,237787837560,59510,62890,61290,1780,2.99,62220,2710,4.55,60000,64950,1399-10-15
154,شكربن,كربن‌ ايران‌,3288,4999177,570974785330,109320,114410,114780,5460,4.99,114210,4890,4.47,109400,114780,1399-10-15
155,كچاد,معدني‌وصنعتي‌چادرملو,3285,10028414,220962770680,21640,22540,21760,120,0.55,22030,390,1.8,21650,22600,1399-10-15
156,قاسم,قاسم ايران,3268,17080310,239671087457,14593,14400,14125,-468,-3.21,14032,-561,-3.84,13864,14700,1399-10-15
157,غگلستا,شير پاستوريزه پگاه گلستان,3263,8460674,236030985815,28463,28000,27040,-1423,-5.0,27897,-566,-1.99,27040,29000,1399-10-15
158,كترام,توليدي‌ كاشي‌ تكسرام‌,3232,7020175,329106771000,44760,45780,46990,2230,4.98,46880,2120,4.74,44760,46990,1399-10-15
159,كيميا,معدني كيمياي زنجان گستران,3196,5769830,227382517497,40753,39220,39680,-1073,-2.63,39409,-1344,-3.3,38716,41000,1399-10-15
160,آرمان,بيمه آرمان,3185,34958426,336367290946,9434,9905,9230,-204,-2.16,9622,188,1.99,8963,9905,1399-10-15
161,سيلام,سيمان‌ ايلام‌,3179,16226630,168393270980,10580,10600,10330,-250,-2.36,10380,-200,-1.89,10060,10890,1399-10-15
162,سباقر,سيمان باقران,3156,10257629,185043168162,18120,17577,17600,-520,-2.87,18040,-80,-0.44,17577,18650,1399-10-15
163,سفارس,سيمان فارس و خوزستان,3124,11543538,199802924700,16720,16820,17500,780,4.67,17310,590,3.53,16670,17550,1399-10-15
164,حسينا,توسعه خدمات دريايي وبندري سينا,3085,2884013,219055496380,76090,77990,75080,-1010,-1.33,75955,-135,-0.18,74510,78600,1399-10-15
165,ثاصفا,شركت‌ ساختمان‌ اصفهان‌,3064,8647572,261177608572,30804,29880,30609,-195,-0.63,30202,-602,-1.95,29880,31540,1399-10-15
166,ميهن,بيمه ميهن,3062,27038833,177212280895,6314,6278,6629,315,4.99,6554,240,3.8,6278,6629,1399-10-15
167,رتكو,كنترل‌خوردگي‌تكين‌كو,3060,12358874,245875869050,19250,20210,20210,960,4.99,19890,640,3.32,18910,20210,1399-10-15
168,سمگا,گروه سرمايه گذاري ميراث فرهنگي,3042,15286647,604161824812,38037,38410,39938,1901,5.0,39522,1485,3.9,38000,39938,1399-10-15
169,فاذر,صنايع‌ آذرآب‌,3024,7784271,252487633150,31090,32000,32640,1550,4.99,32440,1350,4.34,31110,32640,1399-10-15
170,سيمرغ,سيمرغ,3012,9542972,194605051760,19460,20420,20430,970,4.98,20390,930,4.78,19700,20430,1399-10-15
171,وحكمت,بيمه حكمت صبا,2979,24659792,136393297499,5634,5700,5494,-140,-2.48,5531,-103,-1.83,5465,5721,1399-10-15
172,ونيرو,سرمايه‌گذاري‌نيرو,2975,39730796,144763717010,3510,3580,3680,170,4.84,3640,130,3.7,3530,3680,1399-10-15
173,فخوز,فولاد  خوزستان,2973,11174223,167495825710,14790,15040,14960,170,1.15,14990,200,1.35,14800,15200,1399-10-15
174,دتوزيعح,ح . توزيع دارو پخش,2966,10292974,367757424008,35075,33322,36828,1753,5.0,35729,654,1.86,33322,36828,1399-10-15
175,فبيرا,بسته‌ بندي‌ ايران‌,2919,29876438,116156738797,3988,3869,3970,-18,-0.45,3888,-100,-2.51,3869,3987,1399-10-15
176,غويتا,ويتانا,2902,4375903,231666362180,50630,53000,53161,2531,5.0,52941,2311,4.56,51510,53161,1399-10-15
177,فرآور,فرآوري‌موادمعدني‌ايران‌,2883,12075477,367087679140,29110,29170,30560,1450,4.98,30400,1290,4.43,28850,30560,1399-10-15
178,شفارس,صنايع‌ شيميايي‌ فارس‌,2852,5228657,309141923340,58000,57010,60900,2900,5.0,59120,1120,1.93,57010,60900,1399-10-15
179,زبينا,كشاورزي و دامپروري بينالود,2795,3089440,163504509928,52477,54261,51490,-987,-1.88,52924,447,0.85,51410,54463,1399-10-15
180,خريخت,صنايع‌ريخته‌گري‌ايران‌,2786,29298797,122727302600,4100,4250,4100,0,0.0,4190,90,2.2,3980,4300,1399-10-15
181,ساربيل,سيمان آرتا اردبيل,2770,3283830,134608075550,42000,40200,42110,110,0.26,40990,-1010,-2.4,39900,43500,1399-10-15
182,سپح,ح . پرداخت الكترونيك سامان كيش,2762,4251959,77903517800,18640,17100,18200,-440,-2.36,18320,-320,-1.72,17100,19500,1399-10-15
183,والبر,سرمايه‌ گذاري‌ البرز(هلدينگ‌,2760,8865544,173466851460,19920,20000,19570,-350,-1.76,19570,-350,-1.76,19050,20000,1399-10-15
184,ومهان,گروه توسعه مالي مهر آيندگان,2748,8779063,133807431293,15235,15490,15245,10,0.07,15242,7,0.05,15020,15500,1399-10-15
185,ستران,سيمان‌ تهران‌,2734,5499348,178182066440,32320,32000,32150,-170,-0.53,32400,80,0.25,31000,33840,1399-10-15
186,سخاش,سيمان‌خاش‌,2719,1119322,156298633430,134700,141430,135300,600,0.45,139640,4940,3.67,131840,141430,1399-10-15
187,زنجان,صنايع كشاورزي وكود زنجان,2696,36371032,407513866728,10882,11208,11208,326,3.0,11204,322,2.96,10880,11208,1399-10-15
188,تماوند,تامين سرمايه دماوند,2683,16807008,341076512414,20963,21004,20390,-573,-2.73,20294,-669,-3.19,19915,21480,1399-10-15
189,آريان,سرمايه گذاري پارس آريان,2655,29369212,484681557350,16462,16500,16490,28,0.17,16503,41,0.25,16132,16950,1399-10-15
190,فلوله,لوله‌وماشين‌سازي‌ايران‌,2594,6823973,150597961260,22540,22000,22000,-540,-2.4,22070,-470,-2.09,21420,23410,1399-10-15
191,شصدف,صنعتي دوده فام,2569,101834,2802573514,26211,27521,27521,1310,5.0,26281,70,0.27,27521,27521,1399-10-15
192,كپارس,كاشي‌ پارس‌,2519,1580705,305539026820,185850,187000,195140,9290,5.0,193290,7440,4.0,186000,195140,1399-10-15
193,كلوند,كاشي‌ الوند,2511,4403668,145946908210,32860,32850,33670,810,2.47,33140,280,0.85,31600,34000,1399-10-15
194,مرقام,ايران‌ارقام‌,2510,5742022,135768409070,23270,24200,23390,120,0.52,23640,370,1.59,22250,24400,1399-10-15
195,سرو,صندوق س سروسودمند مدبران-سهام,2440,2351297,171708180660,70640,72120,73230,2590,3.67,73030,2390,3.38,72120,73430,1399-10-15
196,دفارا,داروسازي‌ فارابي‌,2439,4367953,320615370560,71190,68400,74740,3550,4.99,73400,2210,3.1,67640,74740,1399-10-15
197,سشرق,سيمان‌ شرق‌,2403,20712265,151948303960,7050,7400,7300,250,3.55,7340,290,4.11,7100,7400,1399-10-15
198,وصنعت,سرمايه گذاري توسعه صنعت وتجارت,2388,20854800,149979198240,6860,7200,7200,340,4.96,7190,330,4.81,6990,7200,1399-10-15
199,خكاوه,سايپا ديزل,2388,28803076,155136467225,5251,5250,5408,157,2.99,5386,135,2.57,5195,5408,1399-10-15
200,قشرين,قند شيرين خراسان,2368,16142464,308813541537,18500,18018,19425,925,5.0,19131,631,3.41,18018,19425,1399-10-15
201,رمپنا,گروه مپنا (سهامي عام),2324,7325718,134246275950,17950,18770,17980,30,0.17,18330,380,2.12,17760,18840,1399-10-15
202,ختراكح,ح . ريخته‌گري‌ تراكتورسازي‌,2316,6881060,104264207140,15470,14500,14750,-720,-4.65,15150,-320,-2.07,14250,16090,1399-10-15
203,كحافظ,كاشي‌ وسراميك‌ حافظ‌,2285,8028575,145275872070,17380,17980,18240,860,4.95,18090,710,4.09,17710,18240,1399-10-15
204,دي,بانك دي,2279,12243595,455461734000,39386,37200,37200,-2186,-5.55,37200,-2186,-5.55,37200,37200,1399-10-15
205,دسانكو,داروسازي سبحان انكولوژي,2278,7943483,172340816632,20985,20800,22034,1049,5.0,21696,711,3.39,20230,22034,1399-10-15
206,شپديس,پتروشيمي پرديس,2269,2424055,242387151860,100160,101480,100000,-160,-0.16,99990,-170,-0.17,99000,101480,1399-10-15
207,وشمال,س. چشم انداز توسعه شمال,2246,1843856,186400336342,99272,102250,98000,-1272,-1.28,101093,1821,1.83,96294,102250,1399-10-15
208,فباهنر,مس‌ شهيدباهنر,2246,1775139,101763687980,56970,56980,56890,-80,-0.14,57330,360,0.63,56120,58980,1399-10-15
209,شكلر,نيروكلر,2218,3512081,224406825780,61320,63900,64380,3060,4.99,63900,2580,4.21,61320,64380,1399-10-15
210,تپمپي,پمپ‌ سازي‌ ايران‌,2217,6089299,198708997630,31290,31290,32850,1560,4.99,32630,1340,4.28,31290,32850,1399-10-15
211,ركيش,كارت اعتباري ايران كيش,2198,10417722,245866317780,22510,23000,23630,1120,4.98,23600,1090,4.84,22810,23630,1399-10-15
212,پكوير,كوير تاير,2196,4987097,101759683790,21260,20220,20200,-1060,-4.99,20400,-860,-4.05,20200,21760,1399-10-15
213,چفيبر,فيبر ايران‌,2193,14326757,185493787760,12340,12950,12950,610,4.94,12950,610,4.94,12800,12950,1399-10-15
214,سصوفي,سيمان‌ صوفيان‌,2189,6576566,111004102710,17050,16610,16660,-390,-2.29,16880,-170,-1.0,16200,17710,1399-10-15
215,دلقما,دارويي‌ لقمان‌,2189,4321557,123276104360,29730,28700,28430,-1300,-4.37,28530,-1200,-4.04,28250,29430,1399-10-15
216,هجرت,پخش هجرت,2173,3929339,147528857574,35941,37700,37090,1149,3.2,37545,1604,4.46,36500,37738,1399-10-15
217,افق,فروشگاههاي زنجيره اي افق كوروش,2161,2962935,251978213100,81560,83000,85630,4070,4.99,85040,3480,4.27,82000,85630,1399-10-15
218,وتوصا,گروه س توسعه صنعتي ايران,2158,15485598,389167299100,23970,25160,25160,1190,4.96,25130,1160,4.84,24440,25160,1399-10-15
219,رانفور,خدمات‌انفورماتيك‌,2137,3952848,130720718720,32620,34000,32460,-160,-0.49,33070,450,1.38,32400,34000,1399-10-15
220,ثنوسا,نوسازي‌وساختمان‌تهران‌,2129,20267845,330801193420,15590,15800,16360,770,4.94,16320,730,4.68,15600,16360,1399-10-15
221,زاگرس,پتروشيمي زاگرس,2125,766901,170916359512,216971,221180,221600,4629,2.13,222866,5895,2.72,219140,227000,1399-10-15
222,تاصيكو,سرمايه گذاري صدرتامين,2123,19507702,195477412870,10080,10350,9980,-100,-0.99,10020,-60,-0.6,9870,10350,1399-10-15
223,چكاوهح,ح . صنايع‌كاغذسازي‌كاوه‌,2114,12335327,160180446390,12090,11810,13300,1210,10.01,12990,900,7.44,11810,13300,1399-10-15
224,وبانك,سرمايه گذاري گروه توسعه ملي,2110,8785956,80024946660,9030,9050,9100,70,0.78,9090,60,0.66,8950,9370,1399-10-15
225,ريشمك,توليد و صادرات ريشمك,2104,1915133,124914973552,65345,64935,64510,-835,-1.28,65225,-120,-0.18,64057,67620,1399-10-15
226,وبوعلي,سرمايه‌گذاري‌بوعلي‌,2095,16536475,108434114890,6310,6500,6620,310,4.91,6560,250,3.96,6310,6620,1399-10-15
227,خفنر,فنرسازي‌خاور,2051,14615649,352685500530,23070,24220,24220,1150,4.98,24130,1060,4.59,23140,24220,1399-10-15
228,وصنا,گروه‌صنايع‌بهشهرايران‌,2048,11275164,94824459340,8480,8200,8480,0,0.0,8410,-70,-0.83,8060,8720,1399-10-15
229,سمازن,سيمان‌مازندران‌,2008,10685722,116932098100,11180,11170,10940,-240,-2.15,10940,-240,-2.15,10630,11310,1399-10-15
230,سدور,سيمان‌ دورود,2007,10287538,131719659100,12200,12810,12810,610,5.0,12800,600,4.92,12330,12810,1399-10-15
231,تاصيكوح,ح . سرمايه گذاري صدرتامين,2006,83410132,675476474700,10010,8000,8300,-1710,-17.08,8100,-1910,-19.08,8000,8800,1399-10-15
232,پاكشو,گروه صنعتي پاكشو,1999,1186337,102524711440,87830,87000,86000,-1830,-2.08,86420,-1410,-1.61,85060,89000,1399-10-15
233,ثمسكن,سرمايه‌گذاري‌ مسكن‌,1991,19309919,116014979700,5760,5780,6040,280,4.86,6010,250,4.34,5720,6040,1399-10-15
234,وخاور,بانك خاورميانه,1981,29037678,302179997370,9930,10420,10420,490,4.93,10410,480,4.83,10100,10420,1399-10-15
235,وبهمن,سرمايه‌گذاري‌بهمن‌,1973,7913321,190226370790,23670,24490,23950,280,1.18,24040,370,1.56,23100,24840,1399-10-15
236,بنو,بيمه تجارت نو,1972,4327339,139929736740,31229,31800,32580,1351,4.33,32336,1107,3.54,31310,32750,1399-10-15
237,وتوكا,سرمايه‌گذاري‌توكافولاد(هلدينگ,1968,15154048,214098198220,13630,13880,14310,680,4.99,14130,500,3.67,13350,14310,1399-10-15
238,وايران,ليزينگ ايرانيان,1965,14790446,183805166710,12030,12000,12630,600,4.99,12430,400,3.33,11520,12630,1399-10-15
239,شفارا,پتروشيمي فارابي,1964,19939083,97210618320,4837,4820,4692,-145,-3.0,4875,38,0.79,4692,4982,1399-10-15
240,فولاژ,فولاد آلياژي ايران,1961,5872033,117822360610,19750,19210,20430,680,3.44,20070,320,1.62,19210,20560,1399-10-15
241,دامين,داروسازي‌ امين‌,1952,5508592,97384837890,18380,18480,17470,-910,-4.95,17680,-700,-3.81,17470,18620,1399-10-15
242,دتوزيع,توزيع دارو پخش,1950,5488230,217855463000,38710,39500,40645,1935,5.0,39695,985,2.54,36975,40645,1399-10-15
243,لبوتان,گروه‌صنعتي‌بوتان‌,1948,1244132,108056154540,88580,86000,84360,-4220,-4.76,86850,-1730,-1.95,84160,92000,1399-10-15
244,زكشت,كشاورزي مكانيزه اصفهان كشت,1939,3689124,138151316329,39145,37300,37188,-1957,-5.0,37448,-1697,-4.34,37188,38990,1399-10-15
245,اعتلا,شركت سرمايه گذاري اعتلاء البرز,1915,10428070,106102385140,10658,10210,10126,-532,-4.99,10175,-483,-4.53,10126,10500,1399-10-15
246,شسپا,نفت سپاهان,1910,6753331,176957723190,25120,26360,26370,1250,4.98,26200,1080,4.3,25500,26370,1399-10-15
247,كساوه,صنايع‌ كاشي‌ و سراميك‌ سينا,1880,3484615,329725231310,90990,89170,95530,4540,4.99,94620,3630,3.99,87200,95530,1399-10-15
248,ارفع,شركت آهن و فولاد ارفع,1877,7735999,112139522226,14480,14230,14650,170,1.17,14496,16,0.11,14230,14980,1399-10-15
249,اتكام,شركت بيمه اتكايي امين,1872,16772164,112121055830,6713,6500,6800,87,1.3,6685,-28,-0.42,6410,6900,1399-10-15
250,حاريا,كشتيراني آريا,1871,3267691,105404402689,31984,31025,32869,885,2.77,32257,273,0.85,31025,32900,1399-10-15
251,وشهر,بانك شهر,1869,17004689,113121679890,6591,6800,6660,69,1.05,6652,61,0.93,6591,6800,1399-10-15
252,زنگان,صنعت روي زنگان,1840,1386140,136660467830,94915,96663,99660,4745,5.0,98591,3676,3.87,90190,99660,1399-10-15
253,دكوثر,داروسازي‌ كوثر,1836,3407387,83080886160,24600,24100,24200,-400,-1.63,24380,-220,-0.89,23620,25250,1399-10-15
254,قچار,فراوردههاي غذايي وقند چهارمحال,1828,2449314,175860879672,69131,69000,72587,3456,5.0,71800,2669,3.86,69000,72587,1399-10-15
255,تكشا,گسترش‌صنايع‌وخدمات‌كشاورزي‌,1826,3269193,200333364390,58370,61280,61280,2910,4.99,61280,2910,4.99,61000,61280,1399-10-15
256,غالبر,لبنيات‌ كالبر,1825,6792913,93637514980,14340,13630,13630,-710,-4.95,13780,-560,-3.91,13630,14590,1399-10-15
257,ددام,داروسازي زاگرس فارمد پارس,1823,5525487,82346730610,15640,14950,14860,-780,-4.99,14900,-740,-4.73,14860,15370,1399-10-15
258,غصينو,صنعتي مينو,1822,2070026,153545396254,76677,74000,72844,-3833,-5.0,74176,-2501,-3.26,72844,78000,1399-10-15
259,آگاس,صندوق س.هستي بخش آگاه-س,1809,1294872,94166737420,71607,72900,72743,1136,1.59,72723,1116,1.56,72050,73900,1399-10-15
260,وساخت,سرمايه‌ گذاري‌ ساختمان‌ايران‌,1795,3386678,220466624480,62000,65100,65100,3100,5.0,65100,3100,5.0,64000,65100,1399-10-15
261,دلرح,ح . داروسازي‌ اكسير,1794,2380072,100482046010,39310,39990,43240,3930,10.0,42220,2910,7.4,38030,43240,1399-10-15
262,وتوسم,سرمايه‌گذاري‌توسعه‌ملي‌,1782,6150948,81520775280,12730,12600,13300,570,4.48,13250,520,4.08,12430,13360,1399-10-15
263,تسه9909,امتياز تسهيلات مسكن آذر99,1778,44335,27179323824,628447,625000,597025,-31422,-5.0,613044,-15403,-2.45,597025,625000,1399-10-15
264,حفاري,حفاري شمال,1772,20743677,238539042280,10970,11180,11510,540,4.92,11500,530,4.83,11180,11510,1399-10-15
265,ونفت,سرمايه‌گذاري‌ صنعت‌ نفت‌,1748,8518357,155223285170,17460,18300,18330,870,4.98,18220,760,4.35,17630,18330,1399-10-15
266,قشير,قند شيروان قوچان و بجنورد,1741,3956721,130727978914,31488,33062,33062,1574,5.0,33039,1551,4.93,32580,33062,1399-10-15
267,پاسا,ايران‌ياساتايرورابر,1732,5348074,142402118060,26730,26200,26400,-330,-1.23,26630,-100,-0.37,25890,27400,1399-10-15
268,وليز,ليزينگ‌ايران‌,1719,9279837,77107914270,8460,8450,8250,-210,-2.48,8310,-150,-1.77,8100,8530,1399-10-15
269,فسرب,ملي‌ سرب‌وروي‌ ايران‌,1714,724283,92703405730,127780,129050,126300,-1480,-1.16,127990,210,0.16,125790,132000,1399-10-15
270,فسازان,غلتك سازان سپاهان,1713,4844019,186232594100,37010,37010,38860,1850,5.0,38450,1440,3.89,37010,38860,1399-10-15
271,ثجوان,تامين مسكن جوانان,1704,9012670,132374734758,14184,13620,14893,709,5.0,14688,504,3.55,13620,14893,1399-10-15
272,مدير,ص.س.مديريت ثروت ص.بازنشستگي-س,1695,7209674,73572058125,10076,10280,10169,93,0.92,10205,129,1.28,10060,10310,1399-10-15
273,هرمز,فولاد هرمزگان جنوب,1695,7936477,116444081286,14596,14530,14648,52,0.36,14672,76,0.52,14500,15100,1399-10-15
274,تايرا,تراكتورسازي‌ايران‌,1693,4503687,168047984860,38300,38590,36990,-1310,-3.42,37310,-990,-2.58,36450,39210,1399-10-15
275,شپاكسا,پاكسان‌,1687,3626363,130258041280,35970,34710,36240,270,0.75,35920,-50,-0.14,34710,36700,1399-10-15
276,كهمداح,ح . شيشه‌ همدان‌,1686,7878606,83637224890,10830,11200,10440,-390,-3.6,10620,-210,-1.94,10160,11280,1399-10-15
277,پلاسك,پلاسكوكار,1680,11297083,90048018410,7710,7700,8090,380,4.93,7970,260,3.37,7600,8090,1399-10-15
278,غشان,شيرپاستوريزه‌پگاه‌خراسان‌,1679,9102686,69971759810,7470,7410,7840,370,4.95,7690,220,2.95,7400,7840,1399-10-15
279,لكما,كارخانجات‌مخابراتي‌ايران‌,1653,11698963,96931754063,8053,8294,8294,241,2.99,8285,232,2.88,8101,8294,1399-10-15
280,وبيمه,سرمايه‌ گذاري‌ صنعت‌ بيمه‌,1645,18759684,60545333200,3180,3270,3300,120,3.77,3230,50,1.57,3090,3330,1399-10-15
281,بهپاك,صنعتي بهپاك,1633,3575193,154620975390,45310,43400,43110,-2200,-4.86,43248,-2062,-4.55,43045,46000,1399-10-15
282,فولاي,صنايع فولاد آلياژي يزد,1626,2776778,119197822119,41090,40410,43144,2054,5.0,42927,1837,4.47,40410,43144,1399-10-15
283,ميدكو,هلدينگ صنايع  معدني خاورميانه,1624,6356558,199030497054,30693,30693,31500,807,2.63,31311,618,2.01,30639,31600,1399-10-15
284,كرازي,كارخانجات‌توليدي‌شيشه‌رازي‌,1619,5002969,154573763280,29430,30900,30900,1470,4.99,30900,1470,4.99,30000,30900,1399-10-15
285,فجر,فولاد اميركبيركاشان,1595,1676950,109812112260,66370,67470,64820,-1550,-2.34,65480,-890,-1.34,64440,67470,1399-10-15
286,دلر,داروسازي‌ اكسير,1594,1604472,74128650200,46290,44010,47280,990,2.14,46200,-90,-0.19,43980,48490,1399-10-15
287,لوتوس,تامين سرمايه لوتوس پارسيان,1578,6233784,86079783630,13260,13300,13920,660,4.98,13810,550,4.15,13270,13920,1399-10-15
288,بالاس,مهندسي ساختمان تاسيسات راه آهن,1574,1497475,87303288412,55718,57900,58503,2785,5.0,58300,2582,4.63,57000,58503,1399-10-15
289,سپاها,سيمان‌سپاهان‌,1572,9829729,92488670560,9230,9010,9370,140,1.52,9410,180,1.95,9010,9560,1399-10-15
290,درهآور,دارويي ره آورد تامين,1566,2137083,98556804882,44416,45850,46636,2220,5.0,46117,1701,3.83,44720,46636,1399-10-15
291,كفرآور,فرآورده هاي سيمان شرق,1506,4916343,127611270581,25470,26190,25870,400,1.57,25957,487,1.91,24900,26234,1399-10-15
292,بخاور,بيمه زندگي خاورميانه,1504,8316011,72668468009,8559,8200,8750,191,2.23,8738,179,2.09,8200,8986,1399-10-15
293,بورس,بورس اوراق بهادار تهران,1502,1773017,100588474290,56320,56320,56200,-120,-0.21,56730,410,0.73,56000,57700,1399-10-15
294,حسير,ريل سير كوثر,1493,5406107,90325827598,15975,16001,16773,798,5.0,16708,733,4.59,16001,16773,1399-10-15
295,تنوين,تامين سرمايه نوين,1479,15572351,99704218840,6280,6210,6430,150,2.39,6400,120,1.91,6210,6490,1399-10-15
296,خاذين,سايپاآذين‌,1477,16945576,97103009720,5530,5530,5800,270,4.88,5730,200,3.62,5380,5800,1399-10-15
297,دعبيد,لابراتوارداروسازي‌  دكترعبيدي‌,1475,1872992,55603854690,30460,30950,29310,-1150,-3.78,29690,-770,-2.53,29000,30950,1399-10-15
298,كروي,توسعه‌ معادن‌ روي‌ ايران‌,1474,5477496,237887651280,41370,43430,43430,2060,4.98,43430,2060,4.98,43430,43430,1399-10-15
299,شصفها,پتروشيمي‌ اصفهان‌,1455,1375822,193958270138,140509,137699,142950,2441,1.74,140976,467,0.33,137699,143319,1399-10-15
300,فاما,صنعتي‌ آما,1452,3728177,81360902060,21020,21440,22040,1020,4.85,21820,800,3.81,20060,22070,1399-10-15
301,امين يكم,صندوق درآمد ثابت امين يكم فردا,1438,46630480,475394494019,10182,10186,10195,13,0.13,10195,13,0.13,10186,10200,1399-10-15
302,غمينوح,ح . شركت صنايع غذايي مينو شرق,1436,6976993,72264415755,10295,10000,10615,320,3.11,10358,63,0.61,9920,10809,1399-10-15
303,فسپا,گروه‌صنعتي‌سپاهان‌,1402,2160881,102576247810,47640,49500,46100,-1540,-3.23,47470,-170,-0.36,45900,49500,1399-10-15
304,سبهان,سيمان‌ بهبهان‌,1394,1001068,87858172870,83680,87800,87860,4180,5.0,87760,4080,4.88,85210,87860,1399-10-15
305,قلرست,قند لرستان‌,1388,3191582,95039542160,28690,29970,29270,580,2.02,29780,1090,3.8,28000,30120,1399-10-15
306,بايكا,كارخانجات كابلسازي ‌ايران‌,1385,1604901,87383892618,55978,57549,54299,-1679,-3.0,54448,-1530,-2.73,54299,57549,1399-10-15
307,فايرا,آلومينيوم‌ايران‌,1383,8644316,215131912380,25070,25440,24090,-980,-3.91,24890,-180,-0.72,24050,26000,1399-10-15
308,وسپه,سرمايه‌گذاري‌ سپه‌,1378,5379297,77667030580,14220,14290,14160,-60,-0.42,14440,220,1.55,14060,14900,1399-10-15
309,وكارح,ح . بانك‌ كارآفرين‌,1372,45254773,133375742420,2680,2820,2950,270,10.07,2950,270,10.07,2820,2950,1399-10-15
310,سيدكو,سرمايه گذاري توسعه صنايع سيمان,1370,8515036,61761284140,7150,7500,7130,-20,-0.28,7250,100,1.4,7130,7590,1399-10-15
311,غديس,پاكديس,1349,5902940,70707159081,11588,11900,12167,579,5.0,11978,390,3.37,11250,12167,1399-10-15
312,ثشرق,سرمايه گذاري مسكن شمال شرق,1345,13436715,86488126240,6410,6680,6250,-160,-2.5,6440,30,0.47,6110,6680,1399-10-15
313,وپترو,سرمايه‌گذاري صنايع پتروشيمي‌,1333,4520482,81921338200,17280,18100,18140,860,4.98,18120,840,4.86,17610,18140,1399-10-15
314,شپارس,بين‌ المللي‌ محصولات‌  پارس‌,1331,3306387,68684263560,21380,20600,20540,-840,-3.93,20770,-610,-2.85,20370,21740,1399-10-15
315,وسكاب,س.ص.بازنشستگي كاركنان بانكها,1307,10449369,68872108710,6370,6380,6670,300,4.71,6590,220,3.45,6380,6680,1399-10-15
316,همراه,شركت ارتباطات سيار ايران,1303,2313925,72923458850,31210,31220,31490,280,0.9,31440,230,0.74,31000,32300,1399-10-15
317,چدن,توليدي چدن سازان,1300,4016448,143094211130,34090,35150,35790,1700,4.99,35630,1540,4.52,34800,35790,1399-10-15
318,غگلپا,شير پاستوريزه پگاه گلپايگان,1294,1028658,77137790611,76528,74998,72702,-3826,-5.0,74989,-1539,-2.01,72702,79300,1399-10-15
319,ارزش,صندوق س ارزش آفرين بيدار-سهام,1288,5618710,59774870290,10460,10600,10650,190,1.82,10640,180,1.72,10490,10760,1399-10-15
320,دتماد,توليدمواداوليه‌داروپخش‌,1283,1694232,101026526840,57460,57460,60000,2540,4.42,59630,2170,3.78,57000,60330,1399-10-15
321,كگاز,شيشه‌ و گاز,1278,3407291,77652459760,21860,22500,22950,1090,4.99,22790,930,4.25,22020,22950,1399-10-15
322,شبصير,توليدات پتروشيمي قائد بصير,1272,732135,91785526588,127708,130000,124680,-3028,-2.37,125367,-2341,-1.83,122000,130000,1399-10-15
323,خلنت,لنت‌ ترمزايران‌,1271,811921,87653087600,105590,110000,110860,5270,4.99,107960,2370,2.24,103000,110860,1399-10-15
324,غدشت,دشت‌ مرغاب‌,1270,403981,119350192030,307090,307090,291740,-15350,-5.0,295440,-11650,-3.79,291740,307900,1399-10-15
325,گوهران,سرمايه گذاري توسعه گوهران اميد,1261,6370791,57816517097,8931,8820,9000,69,0.77,9075,144,1.61,8820,9280,1399-10-15
326,پخش,پخش البرز,1260,2061933,84533145491,41893,40550,40060,-1833,-4.38,40997,-896,-2.14,39799,42960,1399-10-15
327,شپترو,پتروشيمي آبادان,1258,20810893,126169445103,5922,6099,6099,177,2.99,6063,141,2.38,5900,6099,1399-10-15
328,بكهنوج,توليد برق ماهتاب كهنوج,1245,20432491,51908361510,2424,2545,2545,121,4.99,2540,116,4.79,2462,2545,1399-10-15
329,پارسان,گسترش نفت و گاز پارسيان,1241,5192013,115610882870,22080,22120,22060,-20,-0.09,22270,190,0.86,22000,22810,1399-10-15
330,اپرداز,آتيه داده پرداز,1224,2431240,69575370295,28462,28200,28500,38,0.13,28617,155,0.54,28000,29500,1399-10-15
331,سپ,پرداخت الكترونيك سامان كيش,1218,2457177,49483928690,19920,19940,20120,200,1.0,20140,220,1.1,19000,20910,1399-10-15
332,دابور,داروسازي‌ ابوريحان‌,1214,1279641,63495705870,49720,52000,49010,-710,-1.43,49620,-100,-0.2,48100,52000,1399-10-15
333,وگستر,گسترش سرمايه گذاري ايرانيان,1213,2658849,69547710900,25837,26390,26380,543,2.1,26157,320,1.24,24600,26800,1399-10-15
334,دجابر,داروسازي‌ جابرابن‌حيان‌,1189,2331834,53772635860,22980,23750,22990,10,0.04,23060,80,0.35,22500,23750,1399-10-15
335,زقيام,كشت و دام قيام اصفهان,1186,2644852,95133313325,34506,35950,36231,1725,5.0,35969,1463,4.24,34507,36231,1399-10-15
336,شگل,گلتاش‌,1180,4197990,117687827350,26930,28090,28270,1340,4.98,28030,1100,4.08,27370,28270,1399-10-15
337,شجم,صنايع پتروشيمي تخت جمشيد,1171,7514261,85640437587,11396,11400,11499,103,0.9,11397,1,0.01,11100,11682,1399-10-15
338,غبشهر,صنعتي‌ بهشهر,1162,6147167,173869203450,27020,28000,28370,1350,5.0,28280,1260,4.66,27030,28370,1399-10-15
339,شفن,پتروشيمي فناوران,1160,383465,116937909790,302890,313960,304000,1110,0.37,304950,2060,0.68,300000,314290,1399-10-15
340,كي بي سي,شركت كي بي سي,1151,3798876,137943805632,38143,37000,36236,-1907,-5.0,36312,-1831,-4.8,36236,37361,1399-10-15
341,ثعتما,س. ساختماني اعتماد گستر,1149,2037700,104759520573,51129,49596,52662,1533,3.0,51411,282,0.55,49596,52662,1399-10-15
342,كرماشا,صنايع پتروشيمي كرمانشاه,1149,1532787,64627185880,42670,41090,41720,-950,-2.23,42160,-510,-1.2,41090,43490,1399-10-15
343,پرديس,سرمايه گذاري پرديس,1145,5963418,43857142600,7350,7560,7330,-20,-0.27,7350,0,0.0,7200,7560,1399-10-15
344,اعتماد,صندوق س.اعتماد آفرين پارسيان-د,1141,22422490,766054071140,34150,34162,34172,22,0.06,34165,15,0.04,34162,34172,1399-10-15
345,غگرجي,بيسكويت‌  گرجي‌,1135,2683353,65252047560,23170,24320,24320,1150,4.96,24320,1150,4.96,23850,24320,1399-10-15
346,خديزل,بهمن  ديزل,1121,1881488,101038027484,53610,55497,53610,0,0.0,53701,91,0.17,51560,55497,1399-10-15
347,اتكاي,بيمه اتكايي ايرانيان,1120,2520308,42141665568,17130,16280,16639,-491,-2.87,16744,-386,-2.25,16274,17500,1399-10-15
348,ما,بيمه  ما,1118,8501085,75986435050,8590,8890,9010,420,4.89,8940,350,4.07,8610,9010,1399-10-15
349,شرانل,نفت ايرانول,1106,1440051,52248324507,36058,36400,35720,-338,-0.94,36282,224,0.62,35400,37220,1399-10-15
350,اميد,تامين سرمايه اميد,1103,9674122,107755988980,10610,11140,11140,530,5.0,11140,530,5.0,11000,11140,1399-10-15
351,ولراز,ليزينگ رازي,1098,1303746,72211102936,53796,55408,55409,1613,3.0,55387,1591,2.96,54150,55409,1399-10-15
352,شوينده,مديريت صنعت شوينده ت.ص.بهشهر,1098,1798477,69657398050,39010,39480,38900,-110,-0.28,38730,-280,-0.72,38030,39480,1399-10-15
353,خوساز,محورسازان‌ايران‌خودرو,1083,8097037,68563909090,8080,8390,8480,400,4.95,8470,390,4.83,8200,8480,1399-10-15
354,غشهد,شهد ايران ‌,1074,6831272,52769251070,7730,8020,7700,-30,-0.39,7720,-10,-0.13,7520,8020,1399-10-15
355,سخوز,سيمان خوزستان,1070,3061969,69337577950,21790,22000,22870,1080,4.96,22640,850,3.9,21850,22870,1399-10-15
356,توريل,توکاريل,1064,3281726,97925781942,28422,29840,29843,1421,5.0,29840,1418,4.99,29111,29843,1399-10-15
357,دكيمي,كيميدارو,1061,1296312,39147902650,30600,31980,29980,-620,-2.03,30260,-340,-1.11,29260,31980,1399-10-15
358,لابسا,آبسال‌,1059,1609768,96261280470,56980,59820,59820,2840,4.98,59800,2820,4.95,58000,59820,1399-10-15
359,پكرمان,گروه‌ صنعتي‌ بارز,1055,2737724,83431674660,30560,30000,30400,-160,-0.52,30470,-90,-0.29,29940,31500,1399-10-15
360,بساما,بيمه سامان,1049,2410959,65223523878,26479,25400,27802,1323,5.0,27053,574,2.17,25370,27802,1399-10-15
361,خنصير,مهندسي‌نصيرماشين‌,1049,2091166,178293429070,81420,82010,85490,4070,5.0,85260,3840,4.72,82010,85490,1399-10-15
362,سصفها,سيمان‌اصفهان‌,1049,382397,135914975290,338520,355440,355390,16870,4.98,355430,16910,5.0,350000,355440,1399-10-15
363,شستان,پتروشيمي گلستان,1046,17576128,64453472648,3788,3610,3682,-106,-2.8,3667,-121,-3.19,3541,3682,1399-10-15
364,ولملت,واسپاري ملت,1035,6467990,61945614120,9540,9440,9880,340,3.56,9580,40,0.42,9120,10010,1399-10-15
365,دسبحا,گروه دارويي سبحان,1027,2775183,57257357150,21540,20700,20700,-840,-3.9,20630,-910,-4.22,20470,21190,1399-10-15
366,طلا,صندوق س.پشتوانه طلاي لوتوس,1025,630062,53346516086,81341,84000,84800,3459,4.25,84669,3328,4.09,84000,85490,1399-10-15
367,ثپرديس,سرمايه گذاري مسكن پرديس,1021,6073404,75092575760,11828,12350,12419,591,5.0,12364,536,4.53,12000,12419,1399-10-15
368,كويرح,ح. توليدي فولاد سپيد فراب كوير,1019,6945970,112222645170,17010,17000,16200,-810,-4.76,16160,-850,-5.0,16000,17000,1399-10-15
369,حرهشا,رهشاد سپاهان (سهامي عام,1018,1509594,99863782948,64227,66153,66153,1926,3.0,66153,1926,3.0,66056,66153,1399-10-15
370,شاوان,پالايش نفت لاوان,1012,752120,71290103034,92514,96990,93800,1286,1.39,94786,2272,2.46,93270,97000,1399-10-15
371,سخزر,سيمان‌ خزر,1009,1828199,66563494530,35130,36600,36880,1750,4.98,36410,1280,3.64,34520,36880,1399-10-15
372,فخاس,فولاد خراسان,1004,1633560,47609586880,29860,29700,28990,-870,-2.91,29490,-370,-1.24,28650,29990,1399-10-15
373,پسهند,صنايع‌ لاستيكي‌  سهند,1000,1286130,57159726020,45860,44220,44080,-1780,-3.88,44440,-1420,-3.1,43570,47800,1399-10-15
374,تسه9908,امتياز تسهيلات مسكن آبان99,994,22199,13639255595,630484,625000,598960,-31524,-5.0,614409,-16075,-2.55,598960,625000,1399-10-15
375,زر,صندوق س.پشتوانه سكه طلاي زر,994,2845323,142332653754,47194,48690,49500,2306,4.89,50023,2829,5.99,48690,50700,1399-10-15
376,شفا,سرمايه گذاري شفادارو,993,728416,44603571620,62160,60000,60590,-1570,-2.53,61240,-920,-1.48,59670,63700,1399-10-15
377,كتوكاح,ح.توليدي وخدمات صنايع نسوزتوكا,991,2296754,60208862484,25881,25600,25912,31,0.12,26215,334,1.29,25600,26700,1399-10-15
378,قمرو,قند مرودشت‌,990,1563834,46789903100,30770,30100,29240,-1530,-4.97,29960,-810,-2.63,29240,32000,1399-10-15
379,ثتوسا,س.توسعه و عمران استان اردبيل,989,1713970,89016745920,49463,51936,51936,2473,5.0,51936,2473,5.0,51936,51936,1399-10-15
380,واتي,سرمايه‌ گذاري‌ آتيه‌ دماوند,986,5151012,69049528740,12870,12950,13510,640,4.97,13410,540,4.2,12950,13510,1399-10-15
381,سفاسي,شركت فارسيت اهواز,975,2283974,41209742882,18601,18043,18043,-558,-3.0,18043,-558,-3.0,18043,18043,1399-10-15
382,رتاپ,تجارت الكترونيك  پارسيان,972,6345236,44730437290,6760,6770,7090,330,4.88,7030,270,3.99,6770,7090,1399-10-15
383,ومعلم,بيمه معلم,958,14725008,105086104412,6799,7110,7138,339,4.99,7137,338,4.97,7110,7138,1399-10-15
384,تكنو,تكنوتار,952,3059401,60788647340,18930,19870,19870,940,4.97,19870,940,4.97,19800,19870,1399-10-15
385,كنور,توسعه معدني و صنعتي صبانور,940,1345385,62262315720,46390,46950,45750,-640,-1.38,46280,-110,-0.24,45500,46950,1399-10-15
386,ثرود,سرمايه‌گذاري مسكن زاينده رود,918,4516660,52325209961,11221,10820,11782,561,5.0,11585,364,3.24,10820,11782,1399-10-15
387,وسين,بيمه سينا,917,4112521,89064876544,20670,20583,21703,1033,5.0,21657,987,4.78,20130,21703,1399-10-15
388,ختراك,ريخته‌گري‌ تراكتورسازي‌ ايران‌,914,4285827,75232883580,16730,17560,17560,830,4.96,17550,820,4.9,17310,17560,1399-10-15
389,وبشهر,توسعه‌ صنايع‌ بهشهر(هلدينگ,912,3269872,52077026940,15610,15250,15820,210,1.35,15920,310,1.99,15250,16300,1399-10-15
390,پرداخت,به پرداخت ملت,910,2408988,80594771590,32270,33200,33880,1610,4.99,33460,1190,3.69,31000,33880,1399-10-15
391,ضخود2007,اختيارخ خودرو-3000-1400/02/08,907,34756,21645606000,587,550,605,18,3.07,623,36,6.13,550,650,1399-10-15
392,غشوكو,شوكو پارس,905,1211530,52368227893,44494,43160,43160,-1334,-3.0,43225,-1269,-2.85,43160,45000,1399-10-15
393,كفرا,فراورده‌ هاي‌ نسوزايران‌,900,873521,51292771390,61300,60400,58240,-3060,-4.99,58720,-2580,-4.21,58240,61300,1399-10-15
394,غپاك,لبنيات‌ پاك‌,895,5250939,76690132320,14190,13650,14890,700,4.93,14610,420,2.96,13650,14890,1399-10-15
395,شاراك,پتروشيمي شازند,892,2980260,70780843720,23240,23960,23760,520,2.24,23710,470,2.02,23260,24300,1399-10-15
396,ولصنم,ليزينگ‌صنعت‌ومعدن‌,889,8072754,78402636610,9300,9680,9760,460,4.95,9710,410,4.41,9330,9760,1399-10-15
397,تيپيكو,سرمايه گذاري دارويي تامين,870,778113,42794238860,55030,54900,54410,-620,-1.13,55020,-10,-0.02,54330,56500,1399-10-15
398,فلات,گروه صنايع معادن فلات ايرانيان,869,9119064,129707289919,14234,13807,14661,427,3.0,14224,-10,-0.07,13807,14661,1399-10-15
399,ثامان,سامان‌ گستراصفهان‌,869,2394614,49727046590,19800,20740,20790,990,5.0,20730,930,4.7,20500,20790,1399-10-15
400,پارسيان,بيمه پارسيان,859,4757023,63691832710,13290,13420,13350,60,0.45,13390,100,0.75,13050,13650,1399-10-15
401,وملت,سرمايه گذاري ملت,857,7436615,29802965805,4050,4049,3990,-60,-1.48,4008,-42,-1.04,3969,4131,1399-10-15
402,سغرب,سيمان‌غرب‌,852,2439627,57977585690,23720,24880,24100,380,1.6,23760,40,0.17,23020,24890,1399-10-15
403,هجرتح,ح . پخش هجرت,845,1509042,49717194322,31518,33080,32870,1352,4.29,32946,1428,4.53,32100,33093,1399-10-15
404,كيان,صندوق س. با درآمد ثابت كيان,845,23512492,625195446888,26577,26589,26590,13,0.05,26590,13,0.05,26588,26596,1399-10-15
405,سشمال,سيمان‌ شمال‌,835,5515296,64635579160,11170,11720,11720,550,4.92,11720,550,4.92,11600,11720,1399-10-15
406,حريل,ريل پردازسير,831,9420323,55928457651,5655,5937,5937,282,4.99,5937,282,4.99,5937,5937,1399-10-15
407,غمينو,شركت صنايع غذايي مينو شرق,827,3120242,45205699024,15218,14500,14458,-760,-4.99,14488,-730,-4.8,14458,15016,1399-10-15
408,وسرمد,بيمه  سرمد,819,6230623,53642792105,8395,8200,8646,251,2.99,8610,215,2.56,8200,8646,1399-10-15
409,كاردان,صندوق س تجارت شاخصي كاردان,805,560985,94594309250,167760,170000,167950,190,0.11,168620,860,0.51,165820,172900,1399-10-15
410,حآسا,آسيا سير ارس,800,1125662,64835464744,56109,58308,57790,1681,3.0,57598,1489,2.65,56670,58308,1399-10-15
411,دارو,كارخانجات‌داروپخش‌,794,1137497,34108318320,30420,29200,30560,140,0.46,30100,-320,-1.05,29000,30800,1399-10-15
412,شلرد,كود شيميايي اوره لردگان,793,5016392,44819098645,8681,8910,8941,260,3.0,8935,254,2.93,8768,8941,1399-10-15
413,سكرد,سيمان كردستان,792,3181240,27353569060,8410,8820,8550,140,1.66,8520,110,1.31,8450,8820,1399-10-15
414,غچين,كشت‌ و صنعت‌ چين‌ چين,788,1355349,116221176750,81670,85750,85750,4080,5.0,85750,4080,5.0,85750,85750,1399-10-15
415,وثوق,سرمايه گذاري وثوق امين,781,3219711,52352652629,15974,15974,16453,479,3.0,16260,286,1.79,15974,16453,1399-10-15
416,حتايد,تايدواترخاورميانه,780,6386699,170013927380,25360,26620,26620,1260,4.97,26620,1260,4.97,26620,26620,1399-10-15
417,آپ,آسان پرداخت پرشين,775,6783692,175222764360,24600,25830,25830,1230,5.0,25830,1230,5.0,25830,25830,1399-10-15
418,دكپسول,توليد ژلاتين كپسول ايران,774,755469,34410372836,45332,46000,45900,568,1.25,45486,154,0.34,44420,46800,1399-10-15
419,پارس,پتروشيمي پارس,774,367320,58556394600,157930,159920,157400,-530,-0.34,158810,880,0.56,157000,162500,1399-10-15
420,دالبر,البرزدارو,772,1438198,32741916890,22470,23290,22400,-70,-0.31,22670,200,0.89,22300,23290,1399-10-15
421,ساراب,سيمان‌ داراب‌,759,2385129,30898939140,13350,12830,13000,-350,-2.62,13090,-260,-1.95,12690,13370,1399-10-15
422,قجام,فرآوردههاي غذايي وقندتربت‌جام‌,756,4188737,63174212954,14786,15150,15229,443,3.0,15082,296,2.0,14652,15229,1399-10-15
423,خشرق,الكتريك‌ خودرو شرق‌,748,2652363,65034178920,23380,24440,24540,1160,4.96,24520,1140,4.88,24000,24540,1399-10-15
424,وتوشه,سرمايه‌ گذاري‌ پارس‌ توشه‌,748,1722267,39131102980,22890,22790,22430,-460,-2.01,22750,-140,-0.61,22110,23500,1399-10-15
425,بكام,كارخانجات توليدي شهيد قندي,743,17068694,79710800980,4450,4670,4670,220,4.94,4670,220,4.94,4670,4670,1399-10-15
426,بسويچ,پارس‌سويچ‌,742,1116761,54439751510,46780,49100,49110,2330,4.98,48750,1970,4.21,47090,49110,1399-10-15
427,زماهان,مجتمع توليد گوشت مرغ ماهان,738,1103962,36755451794,31727,33313,33313,1586,5.0,32746,1019,3.21,32700,33313,1399-10-15
428,غپآذر,شير پگاه آذربايجان شرقي,737,1143669,65712319518,55670,53040,58453,2783,5.0,57457,1787,3.21,53040,58453,1399-10-15
429,وپسا,س. پتروشيمي ساختمان  خليج فارس,730,11138650,41205521972,3595,3702,3702,107,2.98,3699,104,2.89,3630,3702,1399-10-15
430,وصندوق,سرمايه‌گذاري‌صندوق‌بازنشستگي‌,719,3497634,52294430920,14910,15500,14720,-190,-1.27,14930,20,0.13,14510,15500,1399-10-15
431,وتعاون,بيمه  تعاون,714,18408815,142815586770,7533,7758,7758,225,2.99,7758,225,2.99,7758,7758,1399-10-15
432,غدام,خوراك‌  دام‌ پارس‌,699,191997,92387036430,458280,481190,481190,22910,5.0,481190,22910,5.0,481190,481190,1399-10-15
433,درازك,دارويي‌ رازك‌,698,1582892,77530278810,46930,47000,49270,2340,4.99,48980,2050,4.37,46500,49270,1399-10-15
434,سمتاز,سيمان ممتازان كرمان,698,1647819,50683169509,30367,30749,31278,911,3.0,30758,391,1.29,29607,31278,1399-10-15
435,كاسپين,داروسازي كاسپين تامين,694,1516332,45873113643,28958,30390,30405,1447,5.0,30129,1171,4.04,29509,30405,1399-10-15
436,وثنو,سرمايه گذاري ساختماني نوين,691,2815300,56834942318,19250,20212,20212,962,5.0,20188,938,4.87,19710,20212,1399-10-15
437,ساروم,سيمان‌اروميه‌,689,2068191,55074174620,25710,25100,26990,1280,4.98,26630,920,3.58,25100,26990,1399-10-15
438,مبين,مبين انرژي خليج فارس,687,2072405,33132754200,16110,16010,16140,30,0.19,16080,-30,-0.19,15730,16480,1399-10-15
439,خودكفا,اقتصادي و خودكفايي آزادگان,682,975924,38684651436,40864,39639,39639,-1225,-3.0,40185,-679,-1.66,39639,39639,1399-10-15
440,سرود,سيمان‌شاهرود,681,2077453,36736770320,17360,17590,18020,660,3.8,17610,250,1.44,16910,18180,1399-10-15
441,نيرو,نيرو سرمايه,680,1068603,60585432996,58082,56400,56340,-1742,-3.0,56696,-1386,-2.39,56340,58870,1399-10-15
442,ساينا,صنايع بهداشتي ساينا,680,161525,32339138811,196623,200000,199999,3376,1.72,199056,2433,1.24,196680,204000,1399-10-15
443,جم,پتروشيمي جم,679,1846087,87102488480,47140,48190,47010,-130,-0.28,47180,40,0.08,46900,48450,1399-10-15
444,خمحور,توليدمحورخودرو,679,696525,55608270770,77550,81000,78700,1150,1.48,79840,2290,2.95,78500,81000,1399-10-15
445,واعتبار,سرمايه گذاري اعتبار ايران,674,5898267,41359246220,7060,7110,7000,-60,-0.85,7020,-40,-0.57,6800,7220,1399-10-15
446,قزوين,كارخانجات‌ قند قزوين‌,672,623325,25019580420,39230,40580,40440,1210,3.08,39690,460,1.17,39610,40990,1399-10-15
447,حخزر,كشتيراني درياي خزر,669,1145863,35264187008,29416,30726,30886,1470,5.0,30314,898,3.05,29571,30886,1399-10-15
448,خكار,ايركا پارت صنعت,668,2341578,61891864370,25210,26400,26470,1260,5.0,26430,1220,4.84,25500,26470,1399-10-15
449,قشهد,شهد,666,1007926,34155048210,34000,35290,32850,-1150,-3.38,33920,-80,-0.24,32640,35600,1399-10-15
450,كطبس,ذغال‌سنگ‌ نگين‌ ط‌بس‌,654,846364,66220218080,74570,77700,78290,3720,4.99,78240,3670,4.92,76850,78290,1399-10-15
451,پارتا,مجتمع‌صنعتي‌آرتاويل‌تاير,654,1582979,102014328866,63748,62800,65660,1912,3.0,64445,697,1.09,61910,65660,1399-10-15
452,وسديد,گروه ‌صنعتي‌سديد,652,2975162,74010129912,25645,24876,24876,-769,-3.0,24876,-769,-3.0,24876,24876,1399-10-15
453,ثنظام,س. ساختماني نظام مهندسي ايران,643,813284,37895864785,45509,44210,46874,1365,3.0,46596,1087,2.39,44210,46874,1399-10-15
454,دسبحان,سبحان دارو,642,1415346,33987045270,23670,23370,24150,480,2.03,23920,250,1.06,23360,24300,1399-10-15
455,فپنتا,سپنتا,637,85485,45378508710,505880,531170,531170,25290,5.0,526100,20220,4.0,520000,531170,1399-10-15
456,نطرين,عطرين نخ قم,637,4182311,45328980421,10357,10674,10874,517,4.99,10810,453,4.37,10500,10874,1399-10-15
457,واميد,گروه مديريت سرمايه گذاري اميد,629,2747360,110226738410,39250,40080,40970,1720,4.38,40030,780,1.99,39900,40970,1399-10-15
458,غشصفا,شيرپاستوريزه‌پگاه‌اصفهان‌,612,1443674,41892820720,29170,29830,29180,10,0.03,29040,-130,-0.45,28210,29830,1399-10-15
459,شراز,پالايش نفت شيراز,612,390053,43355918215,110615,108500,112500,1885,1.7,111103,488,0.44,107300,114630,1399-10-15
460,قهكمت,قندهكمتان‌,610,671254,32688221730,50030,51960,48300,-1730,-3.46,49110,-920,-1.84,47530,51960,1399-10-15
461,سفانو,سيمان فارس نو,609,1416128,47066351800,31800,31220,33390,1590,5.0,33150,1350,4.25,31220,33390,1399-10-15
462,داروح,ح . كارخانجات‌داروپخش,607,719764,19757140890,27760,27760,27400,-360,-1.3,27450,-310,-1.12,26550,28520,1399-10-15
463,فلامي,لاميران‌,595,1597182,87126278100,51960,54550,54550,2590,4.98,54550,2590,4.98,54550,54550,1399-10-15
464,وآوا,سرمايه گذاري آوا نوين,583,2590692,24748880676,9099,9553,9553,454,4.99,9293,194,2.13,9553,9553,1399-10-15
465,كوثر,بيمه كوثر,581,3858014,103633972068,25583,26862,26862,1279,5.0,26862,1279,5.0,26862,26862,1399-10-15
466,جم پيلن,پلي پروپيلن جم - جم پيلن,579,532090,45364445390,82650,82210,85700,3050,3.69,84380,1730,2.09,82210,86480,1399-10-15
467,شخارك,پتروشيمي‌ خارك‌,577,692527,32314151560,46240,45850,46500,260,0.56,46380,140,0.3,45850,47490,1399-10-15
468,داسوه,داروسازي‌ اسوه‌,572,2201604,69685461910,30370,29370,31880,1510,4.97,31650,1280,4.21,29370,31880,1399-10-15
469,كپرور,فرآوري زغال سنگ پروده طبس,556,976131,46044088652,45373,45500,47641,2268,5.0,47054,1681,3.7,45500,47641,1399-10-15
470,شپلي,پلي اكريل ايران,555,3374502,36097047894,10386,10697,10697,311,2.99,10697,311,2.99,10697,10697,1399-10-15
471,كاريس,صندوق س.سپهر كاريزما-س,551,3034374,37815111650,12384,12929,12517,133,1.07,12462,78,0.63,12302,12929,1399-10-15
472,مارون,پتروشيمي مارون,550,174671,25863356013,150565,150000,148000,-2565,-1.7,149901,-664,-0.44,143600,156480,1399-10-15
473,دمعيار,صندوق س. توازن معيار-د,550,28880268,290969365037,10070,10085,10075,5,0.05,10075,5,0.05,10075,10085,1399-10-15
474,عيار,صندوق س. پشتوانه طلاي مفيد,549,704252,21106260921,28932,29600,30000,1068,3.69,29970,1038,3.59,29600,30199,1399-10-15
475,شنفت,نفت‌ پارس‌,536,630612,37261452950,58370,58000,59620,1250,2.14,58820,450,0.77,56000,59920,1399-10-15
476,دروز,داروسازي‌ روزدارو,533,1006083,18604700670,19380,18450,18420,-960,-4.95,19020,-360,-1.86,18420,19300,1399-10-15
477,سهرمز,سيمان‌هرمزگان‌,532,1149812,26559848540,22680,21850,22900,220,0.97,22900,220,0.97,21850,23750,1399-10-15
478,ولبهمن,شركت بهمن ليزينگ,523,6918662,63028778554,8702,8900,9137,435,5.0,9110,408,4.69,8890,9137,1399-10-15
479,گشان,توسعه بين المللي پديده شانديز,522,290686,16792639534,58947,57769,57769,-1178,-2.0,58371,-576,-0.98,57769,57769,1399-10-15
480,خراسان,پتروشيمي خراسان,521,556293,37522873270,68630,69480,67450,-1180,-1.72,67710,-920,-1.34,66450,69990,1399-10-15
481,غنوش,نوش‌ مازندران‌,519,1113330,83410683600,71360,74920,74920,3560,4.99,74920,3560,4.99,74920,74920,1399-10-15
482,دقاضي,داروسازي شهيد قاضي,497,471487,23695669142,50277,48769,51100,823,1.64,50257,-20,-0.04,48769,51785,1399-10-15
483,ولشرق,ليزينگ ايران و شرق,492,2904343,25151610380,8248,8660,8660,412,5.0,8444,196,2.38,8660,8660,1399-10-15
484,سجام,مجتمع سيمان غرب آسيا,492,1309746,16159863556,12699,12319,12319,-380,-2.99,12393,-306,-2.41,12319,12550,1399-10-15
485,سهگمت,سيمان‌هگمتان‌,490,1425774,34472373590,24370,23500,24400,30,0.12,24230,-140,-0.57,23500,24820,1399-10-15
486,حپترو,حمل و نقل پتروشيمي( سهامي عام,487,872633,36065921890,39370,41330,41330,1960,4.98,40600,1230,3.12,41330,41330,1399-10-15
487,سيستم,همكاران سيستم,486,998175,32777739960,32820,32000,32560,-260,-0.79,32830,10,0.03,31640,33370,1399-10-15
488,آوا,صندوق س.سهام آواي معيار-س,483,1954802,16113907612,8144,8200,8260,116,1.42,8243,99,1.22,8110,8390,1399-10-15
489,دپارس,پارس‌ دارو,479,210140,20924747010,102270,97670,100690,-1580,-1.54,101060,-1210,-1.18,97670,101990,1399-10-15
490,خفولا,خدمات فني فولاد يزد,463,1014981,61074451713,58421,60173,60173,1752,3.0,60173,1752,3.0,60173,60173,1399-10-15
491,مفاخر,توسعه فناوري اطلاعات خوارزمي,457,1598410,67489214286,40529,42544,42555,2026,5.0,42223,1694,4.18,41000,42555,1399-10-15
492,كخاك,صنايع‌خاك‌چيني‌ايران‌,448,762635,41883929030,52410,55010,55030,2620,5.0,54410,2000,3.82,54230,55030,1399-10-15
493,اطلس,صندوق س.توسعه اندوخته آينده-س,439,697092,148766239899,210450,211500,214500,4050,1.92,213410,2960,1.41,211500,216000,1399-10-15
494,شكبير,پتروشيمي اميركبير,428,1054387,89524665067,82464,84930,84937,2473,3.0,84520,2056,2.49,84000,84937,1399-10-15
495,وپخش,داروپخش‌ (هلدينگ‌,427,173410,21588805770,126360,124110,125050,-1310,-1.04,125510,-850,-0.67,122000,127120,1399-10-15
496,نمرينو,ايران‌ مرينوس‌,424,374885,20297451580,56700,53870,53870,-2830,-4.99,55590,-1110,-1.96,53870,56140,1399-10-15
497,سكرما,سيمان‌ كرمان‌,422,2527144,50084231180,18880,19820,19820,940,4.98,19800,920,4.87,19720,19820,1399-10-15
498,شبهرن,نفت‌ بهران‌,422,1396063,83317039840,56840,59680,59680,2840,5.0,59680,2840,5.0,59680,59680,1399-10-15
499,شساخت,مهندسي و ساختمان صنايع نفت,421,876039,37123742800,41464,40400,42707,1243,3.0,42258,794,1.91,40400,42707,1399-10-15
500,ياقوت,صندوق س ياقوت آگاه-ثابت,420,5578966,65326363478,11714,11720,11702,-12,-0.1,11709,-5,-0.04,11700,11720,1399-10-15
501,لخزر,پارس‌ خزر,420,123646,24557927090,201010,198000,195800,-5210,-2.59,199770,-1240,-0.62,191040,205000,1399-10-15
502,سبجنو,سيمان‌ بجنورد,410,458876,17094532130,38060,36410,37690,-370,-0.97,37770,-290,-0.76,36410,38680,1399-10-15
503,تشتاد,صنايع توليدي اشتاد ايران‌,409,863268,13843073300,15813,16161,15501,-312,-1.97,15959,146,0.92,15400,16287,1399-10-15
504,سنير,سيمان‌ سفيد ني‌ريز,407,325195,43855797700,128440,134860,134860,6420,5.0,133440,5000,3.89,134860,134860,1399-10-15
505,خچرخش,چرخشگر,407,2744642,62522944760,21700,22780,22780,1080,4.98,22780,1080,4.98,22780,22780,1399-10-15
506,تپولا,مهندسي مرآت پولاد,402,551960,19809292440,34844,35889,35889,1045,3.0,35807,963,2.76,35889,35889,1399-10-15
507,بفجر,فجر انرژي خليج فارس,401,520876,14814788670,28130,28550,28080,-50,-0.18,28190,60,0.21,27900,29190,1399-10-15
508,ضجار1016,اختيارخ وتجارت-4000-1399/10/21,397,20247,75826000,44,44,4,-40,-90.91,4,-40,-90.91,1,49,1399-10-15
509,دسينا,داروسازي‌ سينا,397,1171319,34225759800,29570,28230,28990,-580,-1.96,29320,-250,-0.85,28230,29620,1399-10-15
510,ضسپا1103,اختيارخ خساپا-2500-1399/11/26,389,15239,3019650000,181,210,194,13,7.18,198,17,9.39,171,210,1399-10-15
511,فيروزه,صندوق شاخص30 شركت فيروزه- سهام,388,237503,39429623270,163500,164700,166000,2500,1.53,166020,2520,1.54,162510,167500,1399-10-15
512,آتيمس,صندوق س.آرمان آتيه درخشان مس-س,381,108180,23213933053,215510,217433,213100,-2410,-1.12,214586,-924,-0.43,210001,218990,1399-10-15
513,دفرا,فرآورده‌هاي‌ تزريقي‌ ايران‌,381,499179,13417173970,27330,27280,27170,-160,-0.59,27200,-130,-0.48,26350,27990,1399-10-15
514,ثنام,س ساختماني ب نام آوران مهندسي,380,1075603,22771591113,21825,21171,21171,-654,-3.0,21171,-654,-3.0,21171,21171,1399-10-15
515,خزر,فنرسازي‌زر,374,1381515,48076722000,33150,34800,34800,1650,4.98,34520,1370,4.13,34800,34800,1399-10-15
516,سامان,بانك سامان,370,8204587,96789512839,11454,11797,11797,343,2.99,11797,343,2.99,11797,11797,1399-10-15
517,تكمبا,كمباين‌ سازي‌ ايران‌,368,3593797,48624073410,12890,13530,13530,640,4.97,13510,620,4.81,13530,13530,1399-10-15
518,كساپا,سايپاشيشه‌,366,1043520,43994803200,40160,42160,42160,2000,4.98,41820,1660,4.13,42160,42160,1399-10-15
519,فن آوا,گروه فن آوا,354,1390649,17566988465,12352,12710,12722,370,3.0,12598,246,1.99,12000,12722,1399-10-15
520,غشاذر,پگاه‌آذربايجان‌غربي‌,350,942784,21837947410,22090,23190,23190,1100,4.98,22570,480,2.17,22280,23190,1399-10-15
521,حتوكا,حمل‌ونقل‌توكا,348,854406,33065512200,36860,38700,38700,1840,4.99,37930,1070,2.9,38700,38700,1399-10-15
522,حپارسا,توسعه حمل و نقل ريلي پارسيان,342,1407811,58597317253,39641,41623,41623,1982,5.0,41623,1982,5.0,41623,41623,1399-10-15
523,سكه0012پ01,سكه تمام بهارتحويلي 1روزه رفاه,341,94700,113475490500,1167504,1189900,1198500,30996,2.65,1198263,30759,2.63,1189900,1218000,1399-10-15
524,زپارس,ملي كشت و صنعت و دامپروري پارس,341,823658,88921756860,103370,104950,108530,5160,4.99,107960,4590,4.44,104000,108530,1399-10-15
525,سخواف,سيمان مجد خواف,341,2374784,43807640448,17910,18447,18447,537,3.0,18447,537,3.0,18447,18447,1399-10-15
526,سفار,سيمان‌فارس‌,337,443489,64988878060,139570,146540,146540,6970,4.99,146540,6970,4.99,146540,146540,1399-10-15
527,تسه9710,امتياز تسهيلات مسكن دي 97,337,8231,3873616323,458562,481487,481490,22928,5.0,470613,12051,2.63,435634,481490,1399-10-15
528,مداران,داده‌پردازي‌ايران‌,333,1347239,36496220640,25800,27090,27090,1290,5.0,26690,890,3.45,26950,27090,1399-10-15
529,آساس,صندوق س.آسمان آرماني سهام-س,333,114480,19915523588,172537,174000,173900,1363,0.79,173965,1428,0.83,172001,175895,1399-10-15
530,زشريف,كشت وصنعت شريف آباد,330,1648579,47022418817,27165,28523,28523,1358,5.0,28460,1295,4.77,28523,28523,1399-10-15
531,تسه9907,امتياز تسهيلات مسكن مهر99,327,10416,6414514440,630470,661993,598947,-31523,-5.0,615833,-14637,-2.32,598947,661993,1399-10-15
532,ضسپا1102,اختيارخ خساپا-2000-1399/11/26,325,12581,5506137000,409,404,435,26,6.36,438,29,7.09,380,480,1399-10-15
533,فنفت,صنايع تجهيزات نفت,324,1190076,26547025332,21658,22307,22307,649,3.0,22307,649,3.0,22307,22307,1399-10-15
534,گوهر,صندوق سكه طلاي كيان,323,136667,8176734835,58154,59297,59940,1786,3.07,59830,1676,2.88,59100,60201,1399-10-15
535,تسه9711,امتياز تسهيلات مسكن بهمن 97,311,4149,2476790402,602106,600000,595000,-7106,-1.18,596961,-5145,-0.85,572001,620000,1399-10-15
536,شدوص,دوده‌ صنعتي‌ پارس‌,308,1658074,47022978640,27010,28360,28360,1350,5.0,28110,1100,4.07,28360,28360,1399-10-15
537,ختور,رادياتور ايران‌,307,765212,27914933760,34750,36480,36480,1730,4.98,35680,930,2.68,36480,36480,1399-10-15
538,ضصاد1102,اختيارخ وبصادر-3500-1399/11/12,305,14964,4029332000,243,200,199,-44,-18.11,269,26,10.7,190,320,1399-10-15
539,آكورد,صندوق س. آرمان آتي كوثر-د,295,6794087,204504518470,30082,30104,30102,20,0.07,30100,18,0.06,30100,30105,1399-10-15
540,شيراز,پتروشيمي‌شيراز,289,485609,27523279750,57330,56200,56100,-1230,-2.15,57140,-190,-0.33,54700,59000,1399-10-15
541,شاملا,معدني‌ املاح‌  ايران‌,286,369707,23999217770,66880,64000,65700,-1180,-1.76,65880,-1000,-1.5,63640,66760,1399-10-15
542,خموتور,موتورسازان‌تراكتورسازي‌ايران‌,286,1428052,30860203720,20590,21610,21610,1020,4.95,21130,540,2.62,21610,21610,1399-10-15
543,آينده,بازرگاني آينده سازان بهشت پارس,283,1581979,33235796811,20398,21009,21009,611,3.0,21009,611,3.0,21009,21009,1399-10-15
544,فمراد,آلومراد,281,272091,49498794720,173260,181920,181920,8660,5.0,180740,7480,4.32,181920,181920,1399-10-15
545,افق ملت,صندوق س در سهام افق ملت,281,71282,10053340760,139750,144800,140710,960,0.69,141040,1290,0.92,139040,144900,1399-10-15
546,كمرجان,بازرگاني و توليدي مرجان كار,276,207466,21926251676,100654,105686,105686,5032,5.0,102617,1963,1.95,105686,105686,1399-10-15
547,آ س پ,آ.س.پ,271,2522814,32183538198,12150,12757,12757,607,5.0,12522,372,3.06,12757,12757,1399-10-15
548,ومشان,س. فني و مهندسي مشانير,271,248172,17133546708,67029,69039,69039,2010,3.0,68703,1674,2.5,69039,69039,1399-10-15
549,بمپنا,توليد برق عسلويه  مپنا,267,84436,7923605634,96674,91841,93200,-3474,-3.59,96206,-468,-0.48,91841,96418,1399-10-15
550,ثالوند,سرمايه گذاري مسكن الوند,264,1049067,19075185261,17318,18183,18183,865,4.99,17606,288,1.66,18183,18183,1399-10-15
551,بالبر,كابل‌ البرز,262,624297,23791958670,36300,38110,38110,1810,4.99,37070,770,2.12,38110,38110,1399-10-15
552,سرچشمه,سرمايه گذاري مس سرچشمه,256,3312176,26050264240,7491,7865,7865,374,4.99,7679,188,2.51,7865,7865,1399-10-15
553,فنوال,نورد آلومينيوم‌,254,1343942,35493508220,25160,26410,26410,1250,4.97,26070,910,3.62,26410,26410,1399-10-15
554,افقح,ح .فروشگاه زنجيره اي افق كوروش,250,5609059,461304568600,79570,87530,83000,3430,4.31,82240,2670,3.36,80000,87530,1399-10-15
555,ضخود2006,اختيارخ خودرو-2500-1400/02/08,244,8811,7879296000,839,900,900,61,7.27,894,55,6.56,822,945,1399-10-15
556,كشرق,صنعتي و معدني شمال شرق شاهرود,244,450950,42557053400,89879,94372,94372,4493,5.0,93199,3320,3.69,94372,94372,1399-10-15
557,ثنور,سرمايه گذاري كوه نور,242,2581139,33023092366,12422,12794,12794,372,2.99,12794,372,2.99,12794,12794,1399-10-15
558,غپونه,نوش پونه مشهد,237,1076234,22867820032,20630,21248,21248,618,3.0,21248,618,3.0,21248,21248,1399-10-15
559,وآرين,شركت توسعه اقتصادي آرين,235,1832387,9544903883,5058,5209,5209,151,2.99,5127,69,1.36,5209,5209,1399-10-15
560,شلعاب,لعابيران‌,233,810458,10941183000,12860,13500,13500,640,4.98,12990,130,1.01,13500,13500,1399-10-15
561,حبندر,دريايي و کشتيراني خط دريابندر,233,1835082,62134041438,32873,33859,33859,986,3.0,33859,986,3.0,33859,33859,1399-10-15
562,بكاب,صنايع‌جوشكاب‌يزد,233,126644,49873673640,375060,393810,393810,18750,5.0,391220,16160,4.31,393810,393810,1399-10-15
563,وثخوز,سرمايه گذاري و توسعه خوزستان,227,565262,42533139190,71662,75245,75245,3583,5.0,75245,3583,5.0,75245,75245,1399-10-15
564,كسعدي,كاشي‌ سعدي‌,226,1011578,20929548820,19710,20690,20690,980,4.97,20080,370,1.88,20690,20690,1399-10-15
565,فجام,جام‌دارو,224,1140807,11659047540,9740,10220,10220,480,4.93,9840,100,1.03,10220,10220,1399-10-15
566,وكادو,تكادو,224,883605,22459471890,24678,25418,25418,740,3.0,25418,740,3.0,25418,25418,1399-10-15
567,تسه9712,امتياز تسهيلات مسكن اسفند97,212,2672,1635217683,618674,600020,600000,-18674,-3.02,611983,-6691,-1.08,590010,649599,1399-10-15
568,ضخود2008,اختيارخ خودرو-3500-1400/02/08,209,6562,3042364000,498,550,450,-48,-9.64,464,-34,-6.83,431,550,1399-10-15
569,شمواد,توليد مواداوليه الياف مصنوعي,202,320406,19686385452,59653,61442,61442,1789,3.0,61294,1641,2.75,61442,61442,1399-10-15
570,لپيام,گسترش صنايع پيام,196,567485,23172115005,39644,40833,40833,1189,3.0,40833,1189,3.0,40833,40833,1399-10-15
571,پارند,صندوق س. پارند پايدار سپهر,193,2317674,26494918233,11433,11439,11440,7,0.06,11432,-1,-0.01,11420,11440,1399-10-15
572,لازما,كارخانه هاي صنعتي آزمايش,192,1526225,40770048425,26190,26713,26713,523,2.0,26713,523,2.0,26713,26713,1399-10-15
573,ضخود2009,اختيارخ خودرو-4000-1400/02/08,192,5038,1765637000,372,361,349,-23,-6.18,350,-22,-5.91,330,389,1399-10-15
574,وسنا,سرمايه گذاري نيروگاهي ايران,189,2593485,49579652745,18207,19117,19117,910,5.0,19117,910,5.0,19117,19117,1399-10-15
575,تسه9904,امتياز تسهيلات مسكن تير99,188,3032,1874405806,632852,664494,615000,-17852,-2.82,618208,-14644,-2.31,601210,664494,1399-10-15
576,تسه9801,امتياز تسهيلات مسكن فروردين98,188,1942,1227439233,632320,663900,610000,-22320,-3.53,632049,-271,-0.04,601002,663900,1399-10-15
577,تسه9810,امتياز تسهيلات مسكن دي98,185,2900,1755281706,622604,653734,592000,-30604,-4.92,605270,-17334,-2.78,591474,653734,1399-10-15
578,سكه9912پ04,سكه تمام بهارتحويل1روزه صادرات,183,100000,119447483700,1166211,1194000,1197998,31787,2.73,1194475,28264,2.42,1187100,1198000,1399-10-15
579,بميلا,توسعه بازرگاني آهن وفولادميلاد,182,1876405,42288539485,21464,22537,22537,1073,5.0,22537,1073,5.0,22537,22537,1399-10-15
580,ولانا,شركت ليزينگ آريا دانا,182,974340,27889508160,27791,28624,28624,833,3.0,28624,833,3.0,28624,28624,1399-10-15
581,معيار,سرمايه گذاري معيار صنعت پارس,180,380310,13693061550,36739,36005,36005,-734,-2.0,36005,-734,-2.0,36005,36005,1399-10-15
582,تسه9902,امتياز تسهيلات مسكن ارديبهشت99,178,1697,1037786487,630810,631095,599270,-31540,-5.0,611542,-19268,-3.05,599270,631095,1399-10-15
583,زعف0008پ10,زعفران0008نگين طلاي سرخ(پ),177,35690,4477401434,124364,125900,125399,1035,0.83,125453,1089,0.88,123710,125900,1399-10-15
584,خفناور,مهندسي صنعتي روان فن آور,174,702579,21304303017,29440,30323,30323,883,3.0,30303,863,2.93,30323,30323,1399-10-15
585,غاذر,كشت‌وصنعت‌پياذر,171,818144,43664345280,50830,53370,53370,2540,5.0,52750,1920,3.78,53370,53370,1399-10-15
586,آساميد,صندوق س.مشترك آسمان اميد -د,169,6910053,78466297173,11350,11350,11355,5,0.04,11355,5,0.04,11345,11360,1399-10-15
587,وايرا,سرمايه گذاري صنايع ايران,168,1874541,22871274741,11620,12201,12201,581,5.0,12201,581,5.0,12201,12201,1399-10-15
588,لسرما,سرما آفرين‌,167,847809,25239273930,28360,29770,29770,1410,4.97,29030,670,2.36,29770,29770,1399-10-15
589,فنورد,نوردوقطعات‌ فولادي‌,166,168489,47011800780,265740,279020,279020,13280,5.0,276790,11050,4.16,279020,279020,1399-10-15
590,ورازي,بيمه رازي,166,1664453,19951798111,11417,11987,11987,570,4.99,11987,570,4.99,11987,11987,1399-10-15
591,دارا,صندوق س. دارا الگوريتم-د,164,3935940,39625528073,10068,10075,10060,-8,-0.08,10068,0,0.0,10051,10075,1399-10-15
592,وآتوس,س.آرين توسكا قيمت اسمي 350ريال,163,632768,29906504984,45887,47263,47263,1376,3.0,47263,1376,3.0,47260,47263,1399-10-15
593,ضصاد1101,اختيارخ وبصادر-3000-1399/11/12,160,7298,2172393000,478,649,299,-179,-37.45,298,-180,-37.66,270,630,1399-10-15
594,ثزاگرس,سرمايه گذاري توسعه عمران زاگرس,159,361937,17921672492,47159,49516,49516,2357,5.0,49134,1975,4.19,49516,49516,1399-10-15
595,كقزوي,شيشه‌ قزوين‌,158,1292839,13265820979,9963,10261,10261,298,2.99,10155,192,1.93,10261,10261,1399-10-15
596,صايند,صندوق س. گنجينه آينده روشن-د,158,4017810,39971105420,9939,9945,9940,1,0.01,9948,9,0.09,9925,9955,1399-10-15
597,كيان2,صندوق س. با درآمد ثابت كيان,156,15600000,15600000,26577,1,1,-26576,-100.0,1,-26576,-100.0,1,1,1399-10-15
598,شپاس,نفت پاسارگاد,150,834954,19341709410,22062,23165,23165,1103,5.0,22466,404,1.83,23165,23165,1399-10-15
599,داوه,داروسازي آوه سينا,148,332491,7365008141,21097,22151,22151,1054,5.0,21241,144,0.68,22151,22151,1399-10-15
600,سدشت,صنايع سيمان دشتستان,144,138044,5185089660,38450,37200,37000,-1450,-3.77,38360,-90,-0.23,36650,38880,1399-10-15
601,تسه9802,امتياز تسهيلات مسكن ارديبهشت98,137,1263,787851815,622725,630000,595000,-27725,-4.45,623794,1069,0.17,593000,653861,1399-10-15
602,تسه9905,امتياز تسهيلات مسكن مرداد99,136,1272,806981360,627300,658665,630000,2700,0.43,634419,7119,1.13,595943,658665,1399-10-15
603,وكار,بانك‌ كارآفرين‌,130,4388468,14833021840,3220,3380,3380,160,4.97,3260,40,1.24,3380,3380,1399-10-15
604,تسه9906,امتياز تسهيلات مسكن شهريور99,128,799,490800562,631238,600666,600000,-31238,-4.95,614269,-16969,-2.69,600000,662799,1399-10-15
605,چكاوه,صنايع‌كاغذسازي‌كاوه‌,128,499385,6067527750,11580,12150,12150,570,4.92,11650,70,0.6,12150,12150,1399-10-15
606,واحصا,احياء صنايع خراسان,127,502472,22017318096,41732,43818,43818,2086,5.0,43813,2081,4.99,43818,43818,1399-10-15
607,تابا,تابان نيرو سپاهان,126,126177,5268772989,40541,41757,41757,1216,3.0,40840,299,0.74,41757,41757,1399-10-15
608,ولتجار,واسپاري تجارت وسرمايه ايرانيان,124,804591,7771544469,9378,9659,9659,281,3.0,9476,98,1.04,9659,9659,1399-10-15
609,تسه9903,امتياز تسهيلات مسكن خرداد99,122,901,571141701,628342,612015,596925,-31417,-5.0,633898,5556,0.88,596925,659759,1399-10-15
610,زعف0008پ11,زعفران0008نگين سحرخيز(پ),122,72554,8980791761,123380,120100,123977,597,0.48,123781,401,0.33,120100,124955,1399-10-15
611,اوان,مبين وان كيش,122,951054,53589990792,53665,56348,56348,2683,5.0,56185,2520,4.7,56348,56348,1399-10-15
612,نتوس,پشم‌ بافي‌ توس,121,584060,9509664920,15507,16282,16282,775,5.0,15848,341,2.2,16282,16282,1399-10-15
613,ضخود2010,اختيارخ خودرو-4500-1400/02/08,120,3938,799090000,289,280,200,-89,-30.8,203,-86,-29.76,198,400,1399-10-15
614,تصميم,صندوق س با درآمد ثابت تصميم,118,841517,12895180948,15311,15328,15326,15,0.1,15324,13,0.08,15322,15328,1399-10-15
615,كمينا,شيشه سازي مينا,118,630730,22152499060,33450,35122,35122,1672,5.0,35122,1672,5.0,35122,35122,1399-10-15
616,ساروج,بين المللي ساروج بوشهر,112,284249,6492463173,22279,22945,22947,668,3.0,22463,184,0.83,21710,22947,1399-10-15
617,وجامي,سرمايه گذاري جامي,111,1201092,15144569028,12009,12609,12609,600,5.0,12431,422,3.51,12609,12609,1399-10-15
618,قپيرا,فرآورده‌هاي‌غدايي‌وقندپيرانشهر,111,295090,34118305800,110120,115620,115620,5500,4.99,113480,3360,3.05,115620,115620,1399-10-15
619,تسه9803,امتياز تسهيلات مسكن خرداد98,111,766,481553892,611115,641670,581020,-30095,-4.92,628660,17545,2.87,580560,641670,1399-10-15
620,خپويش,سازه‌ پويش‌,108,160587,7626276630,45230,47490,47490,2260,5.0,45540,310,0.69,47490,47490,1399-10-15
621,تسه9812,امتياز تسهيلات مسكن اسفند98,106,1205,750723470,605711,635996,610000,4289,0.71,623007,17296,2.86,575426,635996,1399-10-15
622,ضپاس1005,اختيارخ وپارس-4500-1399/10/30,106,5044,222406000,37,70,28,-9,-24.32,44,7,18.92,20,74,1399-10-15
623,زعف0008پ08,زعفران0008نگين روستا(پ),106,66441,8172297997,122970,123998,123000,30,0.02,123001,31,0.03,121999,124111,1399-10-15
624,وزمين,بانك ايران زمين,101,2758625,34551778125,12280,12525,12525,245,2.0,12525,245,2.0,12525,12525,1399-10-15
625,سدبير,س. تدبيرگران فارس وخوزستان,100,733301,46747938750,60715,63750,63750,3035,5.0,63188,2473,4.07,63750,63750,1399-10-15
626,تسه9901,امتياز تسهيلات مسكن فروردين99,91,942,586719693,623740,654927,592553,-31187,-5.0,622845,-895,-0.14,592553,654927,1399-10-15
627,كپشير,پشم‌شيشه‌ايران‌,87,262424,7109066160,25800,27090,27090,1290,5.0,25970,170,0.66,27090,27090,1399-10-15
628,بشهاب,لامپ‌  پارس‌ شهاب‌,87,43820,4130911400,89790,94270,94270,4480,4.99,90120,330,0.37,94270,94270,1399-10-15
629,سپر,صندوق س سپر سرمايه بيدار- ثابت,87,649980,7224201169,11039,11051,11130,91,0.82,11114,75,0.68,11051,11130,1399-10-15
630,ضجار1015,اختيارخ وتجارت-3500-1399/10/21,86,3066,168004000,143,110,47,-96,-67.13,55,-88,-61.54,35,150,1399-10-15
631,سايرا,ايرانيت‌,85,319760,11551824019,35425,36133,36133,708,2.0,36127,702,1.98,35666,36133,1399-10-15
632,سكه0011پ02,سكه تمام بهارتحويلي 1روزه ملت,81,25400,30397913300,1168236,1185000,1198950,30714,2.63,1196768,28532,2.44,1185000,1200000,1399-10-15
633,پلاست,كارخانجات توليدي پلاستيران,80,87687,4826818602,53443,55046,55046,1603,3.0,53803,360,0.67,55046,55046,1399-10-15
634,تسه9811,امتياز تسهيلات مسكن بهمن98,79,1057,658625584,614491,601400,620000,5509,0.9,623108,8617,1.4,601400,645215,1399-10-15
635,سپاس,صندوق س. پاداش سهامداري توسعه1,79,940292,9558167973,10162,10161,10165,3,0.03,10165,3,0.03,10161,10172,1399-10-15
636,زفكا,كشت و دامداري فكا,78,392443,4420870395,10729,11265,11265,536,5.0,10774,45,0.42,11265,11265,1399-10-15
637,ثاژن,سخت آژند,77,604005,5703619215,9258,9443,9443,185,2.0,9361,103,1.11,9443,9443,1399-10-15
638,كهرام,توليدي گرانيت بهسرام,72,35747,3101624202,84239,86766,86766,2527,3.0,84605,366,0.43,86766,86766,1399-10-15
639,تسه9809,امتياز تسهيلات مسكن آذر98,72,788,498256966,604176,634384,574000,-30176,-4.99,632306,28130,4.66,574000,634384,1399-10-15
640,گكيش,توريستي ورفاهي آبادگران كيش,71,171147,11106584565,63005,64895,64895,1890,3.0,63965,960,1.52,64895,64895,1399-10-15
641,ضخود2005,اختيارخ خودرو-2000-1400/02/08,70,3476,4492179000,1251,1270,1300,49,3.92,1292,41,3.28,1269,1350,1399-10-15
642,ضسپا1101,اختيارخ خساپا-1800-1399/11/26,67,3375,1981460000,530,566,600,70,13.21,587,57,10.75,566,699,1399-10-15
643,بذر,صندوق س بذر اميد آفرين-سهام,67,39118,4221430400,106840,109760,107590,750,0.7,107920,1080,1.01,107500,109760,1399-10-15
644,سكارون,سيمان كارون,67,91471,19845365218,210639,216958,216958,6319,3.0,216300,5661,2.69,216958,216958,1399-10-15
645,افران,صندوق س افرا نماد پايدار-ثابت,66,863209,10697663340,12391,12389,12391,0,0.0,12393,2,0.02,12387,12400,1399-10-15
646,كتوكا,توليدي و خدمات صنايع نسوز توكا,65,126736,3523387536,26478,27801,27801,1323,5.0,26566,88,0.33,27801,27801,1399-10-15
647,اطلس2,صندوق س.توسعه اندوخته آينده-س,65,650000,650000,210450,1,1,-210449,-100.0,1,-210449,-100.0,1,1,1399-10-15
648,آكورد2,صندوق س. آرمان آتي كوثر-د,65,6500000,6500000,30082,1,1,-30081,-100.0,1,-30081,-100.0,1,1,1399-10-15
649,الماس,صندوق س.امين تدبيرگران فردا-س,64,16063,2058269379,126235,128000,128600,2365,1.87,128137,1902,1.51,128000,128600,1399-10-15
650,ضپيك1020,اختيارخ تاپيكو-14000-99/10/16,63,1060,160957000,151,200,70,-81,-53.64,152,1,0.66,34,200,1399-10-15
651,پلوله,گازلوله‌,62,270818,5050213764,18464,18648,18648,184,1.0,18645,181,0.98,18647,18648,1399-10-15
652,سلار,شركت سيمان لارستان,62,314109,18002843226,55645,57314,57314,1669,3.0,57020,1375,2.47,57314,57314,1399-10-15
653,سخند,صندوق س.سپهرخبرگان نفت-د,61,2133840,21654394950,10152,10148,10148,-4,-0.04,10148,-4,-0.04,10148,10164,1399-10-15
654,زعف0008پ05,زعفران0008نگين زرين(پ),60,46147,5688968285,123025,124500,124000,975,0.79,123279,254,0.21,122000,124500,1399-10-15
655,سفارود,كارخانه فارسيت درود,60,165716,2342395660,13858,14135,14135,277,2.0,13918,60,0.43,14135,14135,1399-10-15
656,اخزا903,اسنادخزانه-م3بودجه99-011110,59,246188,169365047371,678507,677083,684001,5494,0.81,687950,9443,1.39,677083,691000,1399-10-15
657,ضپاس1003,اختيارخ وپارس-3500-1399/10/30,58,1823,610207000,282,351,280,-2,-0.71,335,53,18.79,280,399,1399-10-15
658,اخزا815,اسنادخزانه-م15بودجه98-010406,58,28043,21622012264,772409,770001,771900,-509,-0.07,771031,-1378,-0.18,769050,773480,1399-10-15
659,دشيري,شيرين دارو,56,25699,5059310732,191134,196868,196868,5734,3.0,192474,1340,0.7,196868,196868,1399-10-15
660,سنوين,سرمايه گذاري اقتصاد نوين,55,200886,1812947929,9164,9030,9015,-149,-1.63,9138,-26,-0.28,8982,9110,1399-10-15
661,ضپاس1004,اختيارخ وپارس-4000-1399/10/30,55,2314,340940000,147,150,121,-26,-17.69,147,0,0.0,121,150,1399-10-15
662,فيروزا,صندوق بادرآمد ثابت فيروزه آسيا,55,397639,8673550332,21790,21780,21810,20,0.09,21813,23,0.11,21721,21821,1399-10-15
663,آسام,صندوق س.آرمان سپهر آشنا-م,52,21990,2473719880,112539,109202,112999,460,0.41,112493,-46,-0.04,109202,113000,1399-10-15
664,صنوين,صندوق سرمايه‌گذاري صنوين-مختلط,52,10593,1093141840,102420,104000,103250,830,0.81,103190,770,0.75,103000,104000,1399-10-15
665,تسه9808,امتياز تسهيلات مسكن آبان98,50,675,401244731,610579,612790,580055,-30524,-5.0,594437,-16142,-2.64,580055,641107,1399-10-15
666,ضپيك1019,اختيارخ تاپيكو-12000-99/10/16,50,562,933786000,1749,1700,1620,-129,-7.38,1662,-87,-4.97,1300,2000,1399-10-15
667,فنرژي,گسترش صنايع انرژي آذرآب,49,143059,1970923843,13507,13777,13777,270,2.0,13558,51,0.38,13777,13777,1399-10-15
668,سكه0112پ03,سكه تمام بهارتحويلي1روزه سامان,49,12300,14713532800,1164833,1193999,1198500,33667,2.89,1196222,31389,2.69,1192001,1199900,1399-10-15
669,فاهواز,نورد و لوله اهواز,48,94998,1702744152,18289,17924,17924,-365,-2.0,18274,-15,-0.08,17924,17924,1399-10-15
670,جوين,كشت و صنعت جوين,48,412972,11833299688,27820,28654,28654,834,3.0,28292,472,1.7,28654,28654,1399-10-15
671,ارمغان,ص سرمايه گذاري ارمغان ايرانيان,47,180868,1840364022,10175,10170,10177,2,0.02,10175,0,0.0,10170,10181,1399-10-15
672,اخزا901,اسنادخزانه-م1بودجه99-010621,47,41443,30614705014,738878,736000,738780,-98,-0.01,738718,-160,-0.02,735000,742000,1399-10-15
673,وساغربي,شركت س استان آذربايجان غربي,47,2549685,1886766900,770,740,740,-30,-3.9,770,0,0.0,740,740,1399-10-15
674,اخزا808,اسنادخزانه-م8بودجه98-000817,46,106301,91889948591,863551,863000,865989,2438,0.28,864432,881,0.1,859005,866000,1399-10-15
675,اخزا902,اسنادخزانه-م2بودجه99-011019,45,93550,64400376287,684891,683001,689000,4109,0.6,688406,3515,0.51,683001,690001,1399-10-15
676,ضصاد1103,اختيارخ وبصادر-4000-1399/11/12,44,1115,95326000,146,198,80,-66,-45.21,85,-61,-41.78,70,198,1399-10-15
677,اخزا817,اسنادخزانه-م17بودجه98-010512,43,28391,21503699416,758374,755122,757000,-1374,-0.18,757413,-961,-0.13,755122,759999,1399-10-15
678,وسصفا,شركت س استان اصفهان,41,1382634,1410286680,1070,1020,1020,-50,-4.67,1070,0,0.0,1020,1020,1399-10-15
679,تسه9806,امتياز تسهيلات مسكن شهريور98,40,322,195403862,608049,638451,577647,-30402,-5.0,606844,-1205,-0.2,577647,638451,1399-10-15
680,اخزا904,اسنادخزانه-م4بودجه99-011215,39,80115,53793946331,663909,668000,673900,9991,1.5,671459,7550,1.14,666000,674200,1399-10-15
681,تسه9807,امتياز تسهيلات مسكن مهر98,38,337,211357156,615478,646251,615478,0,0.0,627173,11695,1.9,584705,646251,1399-10-15
682,ضصاد1100,اختيارخ وبصادر-2500-1399/11/12,38,1534,1082935000,764,800,626,-138,-18.06,706,-58,-7.59,620,900,1399-10-15
683,كشم0001پ01,كشمش سبز0001خليل آباد(پ),37,747,313475118,400208,417000,420217,20009,5.0,419645,19437,4.86,417000,420218,1399-10-15
684,ضفلا1156,اختيارخ فولاد-16000-1399/11/28,36,682,253112000,340,440,350,10,2.94,371,31,9.12,330,450,1399-10-15
685,ضشنا1035,اختيارخ شپنا-14000-1399/10/23,35,457,86039000,281,250,220,-61,-21.71,188,-93,-33.1,125,250,1399-10-15
686,ضپاس1001,اختيارخ وپارس-2500-1399/10/30,35,644,755516000,1044,1180,1200,156,14.94,1173,129,12.36,1102,1234,1399-10-15
687,ضغدر1119,اختيارخ وغدير-10000-1399/11/26,35,771,1976122000,2347,2600,2362,15,0.64,2563,216,9.2,2362,2600,1399-10-15
688,عيار2,صندوق س. پشتوانه طلاي مفيد,34,340000,340000,28932,1,1,-28931,-100.0,1,-28931,-100.0,1,1,1399-10-15
689,ضپاس1002,اختيارخ وپارس-3000-1399/10/30,34,478,364290000,642,800,711,69,10.75,762,120,18.69,604,900,1399-10-15
690,اخزا809,اسنادخزانه-م9بودجه98-000923,34,20435,17353746668,849076,846010,851990,2914,0.34,849217,141,0.02,846010,851990,1399-10-15
691,وآفري,بيمه كارآفرين,33,1825710,35491802400,18874,19440,19440,566,3.0,19440,566,3.0,19440,19440,1399-10-15
692,اخزا814,اسنادخزانه-م14بودجه98-010318,33,97594,75887467290,776907,775005,775966,-941,-0.12,777583,676,0.09,775005,778000,1399-10-15
693,ثروتم,صندوق س. ثروت آفرين پارسيان-س,33,14010,1293094230,90806,90720,91501,695,0.77,92298,1492,1.64,90720,92515,1399-10-15
694,گپارس,امور رفاهي كارگزاران پارس,32,10307,1679958544,158245,162992,162992,4747,3.0,158618,373,0.24,162992,162992,1399-10-15
695,ضخود2013,اختيارخ خودرو-7000-1400/02/08,32,863,77283000,91,90,86,-5,-5.49,90,-1,-1.1,86,99,1399-10-15
696,شرنگي,شيميايي رنگين,32,42400,5653785600,129461,133344,133344,3883,3.0,130527,1066,0.82,133344,133344,1399-10-15
697,وسيستا,شركت س استان سيستان وبلوچستان,31,809931,615547560,790,760,760,-30,-3.8,790,0,0.0,760,760,1399-10-15
698,اخزا818,اسنادخزانه-م18بودجه98-010614,31,106829,79505070540,744654,739006,744001,-653,-0.09,744227,-427,-0.06,739006,750001,1399-10-15
699,نگين,ص.س. زمين و ساختمان نگين شهرري,27,18945,915658480,48740,47540,47540,-1200,-2.46,48330,-410,-0.84,47530,48990,1399-10-15
700,تسه9805,امتياز تسهيلات مسكن مرداد98,27,152,94490800,592048,621650,621650,29602,5.0,621650,29602,5.0,621650,621650,1399-10-15
701,ضشنا2002,اختيارخ شپنا-12000-1400/02/27,27,401,1196542000,3118,2980,2260,-858,-27.52,2984,-134,-4.3,2260,3090,1399-10-15
702,فماك,ماداكتو استيل كرد,27,616369,14786692310,24000,23990,23990,-10,-0.04,23990,-10,-0.04,23990,23990,1399-10-15
703,ضفلا1155,اختيارخ فولاد-14000-1399/11/28,26,485,506553000,1022,1100,1040,18,1.76,1044,22,2.15,910,1100,1399-10-15
704,زعف0008پ16,زعفران0008نگين بيرجند(پ),25,11340,1395356645,121014,122500,123697,2683,2.22,123047,2033,1.68,122100,123800,1399-10-15
705,ضسپا1104,اختيارخ خساپا-3000-1399/11/26,24,487,59207000,106,139,100,-6,-5.66,122,16,15.09,95,139,1399-10-15
706,اخزا813,اسنادخزانه-م13بودجه98-010219,23,83683,65814899478,786287,785411,786008,-279,-0.04,786479,192,0.02,785411,787001,1399-10-15
707,اوصتا,صندوق انديشه ورزان صباتامين -د,23,139856,2454168865,17538,17540,17550,12,0.07,17548,10,0.06,17540,17550,1399-10-15
708,اخزا812,اسنادخزانه-م12بودجه98-001111,23,118589,98610551372,831172,824504,833000,1828,0.22,831532,360,0.04,824504,833000,1399-10-15
709,هبركت912,اختيارف ت بركت-22100-99/12/17,21,212564,212564,1,1,1,0,0.0,1,0,0.0,1,1,1399-10-15
710,ضسپا1105,اختيارخ خساپا-3500-1399/11/26,21,772,52723000,45,33,115,70,155.56,68,23,51.11,33,115,1399-10-15
711,تسه9804,امتياز تسهيلات مسكن تير98,20,304,195266816,615680,646464,600000,-15680,-2.55,642325,26645,4.33,600000,646464,1399-10-15
712,اخزا908,اسنادخزانه-م8بودجه99-020606,20,62506,37825712213,604044,604000,605000,956,0.16,605153,1109,0.18,602001,606400,1399-10-15
713,ضشنا1036,اختيارخ شپنا-16000-1399/10/23,20,758,5839000,50,6,5,-45,-90.0,8,-42,-84.0,1,35,1399-10-15
714,وسكرد,شركت س استان كردستان,19,210891,158168250,780,750,750,-30,-3.85,780,0,0.0,750,750,1399-10-15
715,اخزا909,اسنادخزانه-م9بودجه99-020316,19,162159,102273699950,1000000,630700,630701,-369299,-36.93,630700,-369300,-36.93,630700,630701,1399-10-15
716,اخزا820,اسنادخزانه-م20بودجه98-020806,19,10248,6024050287,588729,587000,588501,-228,-0.04,587827,-902,-0.15,585300,588770,1399-10-15
717,ضجار1014,اختيارخ وتجارت-3000-1399/10/21,19,1184,342540000,418,290,220,-198,-47.37,289,-129,-30.86,220,290,1399-10-15
718,اخزا821,اسنادخزانه-م21بودجه98-020906,19,3863,2237780450,577001,575260,579995,2994,0.52,579286,2285,0.4,575260,579995,1399-10-15
719,ضملي1153,اختيارخ فملي-20280-1399/11/05,18,887,6140808,13,5,6,-7,-53.85,4,-9,-69.23,1,6,1399-10-15
720,ضشنا2001,اختيارخ شپنا-10000-1400/02/27,18,412,1553846000,3916,3660,3980,64,1.63,3771,-145,-3.7,3660,3980,1399-10-15
721,گنجين,صندوق س. گنجينه يكم آويد-د,18,379226,4529102926,11950,11969,11948,-2,-0.02,11943,-7,-0.06,11942,11969,1399-10-15
722,اخزا806,اسنادخزانه-م6بودجه98-000519,18,19853,17864228611,895411,897001,902999,7588,0.85,899825,4414,0.49,897001,902999,1399-10-15
723,اخزا704,اسنادخزانه-م4بودجه97-991022,17,7880,7839661440,993020,994000,993999,979,0.1,994881,1861,0.19,993111,995000,1399-10-15
724,ضملي1152,اختيارخ فملي-18252-1399/11/05,17,371,16452396,87,41,18,-69,-79.31,22,-65,-74.71,17,50,1399-10-15
725,اخزا905,اسنادخزانه-م5بودجه99-020218,15,53400,34420969537,639369,655963,644000,4631,0.72,644587,5218,0.82,642999,655963,1399-10-15
726,زر2,صندوق س.پشتوانه سكه طلاي زر,15,1500000,1500000,47194,1,1,-47193,-100.0,1,-47193,-100.0,1,1,1399-10-15
727,تملي807,تسهيلات مسكن ب. ملي-مهر98,15,159,103023105,675455,641683,670000,-5455,-0.81,647944,-27511,-4.07,641683,675455,1399-10-15
728,اخزا907,اسنادخزانه-م7بودجه99-020704,12,131846,78024108119,591583,588001,593990,2407,0.41,591782,199,0.03,588000,593990,1399-10-15
729,اراد43,مرابحه عام دولت4-ش.خ 0205,12,300000,280350000000,930000,934500,934500,4500,0.48,934500,4500,0.48,934500,934500,1399-10-15
730,ضجار1018,اختيارخ وتجارت-5000-1399/10/21,12,1170,1170000,4,1,1,-3,-75.0,1,-3,-75.0,1,1,1399-10-15
731,ضسپا1100,اختيارخ خساپا-1600-1399/11/26,12,750,584175000,724,760,800,76,10.5,779,55,7.6,760,800,1399-10-15
732,ضسپا1106,اختيارخ خساپا-4000-1399/11/26,12,461,12300000,24,180,26,2,8.33,27,3,12.5,25,180,1399-10-15
733,ضخوز2012,اختيارخ فخوز-10000-1400/02/15,12,313,2086900000,1,7000,6500,6499,649900.0,6667,6666,666600.0,6500,7000,1399-10-15
734,اراد62,مرابحه عام دولت62-ش.خ0309,12,295000,295000000000,1000000,1000000,1000000,0,0.0,1000000,0,0.0,1000000,1000000,1399-10-15
735,زعف0008پ15,زعفران0008پوشالمعمول طلاسرخ(پ),12,1251,108746732,86091,88888,84001,-2090,-2.43,86928,837,0.97,82024,90658,1399-10-15
736,كابگن,توليدي و صنعتي آبگينه‌,11,28081,142511075,5025,5075,5075,50,1.0,5026,1,0.02,5075,5075,1399-10-15
737,ضجار1017,اختيارخ وتجارت-4500-1399/10/21,11,1075,3225000,15,3,3,-12,-80.0,3,-12,-80.0,3,3,1399-10-15
738,زعف0008پ12,زعفران0008پوشالمعمول سحرخيز(پ),11,1204,102424040,86588,83100,85500,-1088,-1.26,85070,-1518,-1.75,83100,86200,1399-10-15
739,رطب0002پ01,رطب مضافتي0002افشارتعاون بم(پ),11,313,61158710,204677,194510,194500,-10177,-4.97,195395,-9282,-4.53,194500,200000,1399-10-15
740,ضفلا1157,اختيارخ فولاد-18000-1399/11/28,11,116,15564000,146,233,133,-13,-8.9,134,-12,-8.22,133,233,1399-10-15
741,اخزا811,اسنادخزانه-م11بودجه98-001013,11,9976,8405843728,842295,841000,844000,1705,0.2,842607,312,0.04,840001,844000,1399-10-15
742,ونچر,ص.ج.فيروزه10%تاديه,11,11000,1431010000,130101,130101,130000,-101,-0.08,130092,-9,-0.01,130000,130101,1399-10-15
743,ضخوز1014,اختيارخ فخوز-12191-1399/10/16,11,58,361651500,2067,2202,2500,433,20.95,2375,308,14.9,2202,2500,1399-10-15
744,فيروزه2,صندوق شاخص30 شركت فيروزه- سهام,10,100000,100000,163500,1,1,-163499,-100.0,1,-163499,-100.0,1,1,1399-10-15
745,اخزا816,اسنادخزانه-م16بودجه98-010503,10,18081,13725731221,759431,758381,770000,10569,1.39,759125,-306,-0.04,758381,770000,1399-10-15
746,اخزا718,اسنادخزانه-م18بودجه97-000525,10,64882,58328916781,899237,899000,899000,-237,-0.03,899000,-237,-0.03,898999,899000,1399-10-15
747,ضمخا7070,اختيارخ اخابر-20000-1400/07/28,10,55,174700000,660,3000,3200,2540,384.85,3176,2516,381.21,3000,3200,1399-10-15
748,ضملت1128,اختيارخ وبملت-6000-1399/11/28,10,277,108615000,473,300,400,-73,-15.43,392,-81,-17.12,300,490,1399-10-15
749,ياقوت2,صندوق س ياقوت آگاه-ثابت,10,85391185,85391185,11714,1,1,-11713,-99.99,1,-11713,-99.99,1,1,1399-10-15
750,وملل2,اعتباري ملل,10,126262353,2213379048090,16697,17530,17530,833,4.99,17530,833,4.99,17530,17530,1399-10-15
751,ضترا1117,اختيارخ شتران-10000-1399/11/14,9,58,83355000,1100,1014,1500,400,36.36,1437,337,30.64,1014,1630,1399-10-15
752,كرونا2,تامين مالي جمعي صرفا اهداي سود,9,1518,15180000,10000,10000,10000,0,0.0,10000,0,0.0,10000,10000,1399-10-15
753,ضترا1118,اختيارخ شتران-12000-1399/11/14,8,120,95350000,887,800,850,-37,-4.17,795,-92,-10.37,703,850,1399-10-15
754,هصيكو402,اختيارف ت تاصيكو13500-00/02/20,8,34788,101789688,2299,2926,2926,627,27.27,2926,627,27.27,2926,2926,1399-10-15
755,وسفارس,شركت س استان فارس,8,109554,107362920,1030,980,980,-50,-4.85,1030,0,0.0,980,980,1399-10-15
756,داريك,صندوق س.اعتماد داريك-د,8,17981,187699678,10438,10445,10438,0,0.0,10439,1,0.01,10438,10445,1399-10-15
757,صبا1401,اجاره مهندسي صبا نفت14010225,8,6845,5760597795,801107,881217,881217,80110,10.0,841577,40470,5.05,841162,881217,1399-10-15
758,اراد50,مرابحه عام دولت5-ش.خ0302,8,198000,198000050000,1000001,1000000,1000001,0,0.0,1000000,-1,0.0,1000000,1000001,1399-10-15
759,اخزا807,اسنادخزانه-م7بودجه98-000719,8,102387,89128081791,871972,870201,870500,-1472,-0.17,870502,-1470,-0.17,870201,915500,1399-10-15
760,دقاضيح,ح . داروسازي شهيد قاضي,8,1145,54544365,49110,47637,47637,-1473,-3.0,47637,-1473,-3.0,47637,47637,1399-10-15
761,وسخوز,شركت س استان خوزستان,7,120963,112495590,970,930,930,-40,-4.12,970,0,0.0,930,930,1399-10-15
762,زعف0008پ18,زعفران0008نگين بهرامن(پ),7,1096,135117704,122190,122340,123800,1610,1.32,123283,1093,0.89,122340,123999,1399-10-15
763,شستا991,اجاره تامين اجتماعي-امين991226,7,93,92980195,1000000,990000,1000000,0,0.0,999787,-213,-0.02,990000,1008000,1399-10-15
764,وسلرستا,شركت س استان لرستان,7,59000,50740000,900,860,860,-40,-4.44,900,0,0.0,860,860,1399-10-15
765,وسرضوي,س.سهام عدالت استان خراسان رضوي,7,44268,43382640,1030,980,980,-50,-4.85,1030,0,0.0,980,980,1399-10-15
766,پست0008پ09,پسته بادامي30-28مه ولات0008(پ),6,230,312607984,1355000,1359999,1370000,15000,1.11,1359165,4165,0.31,1302001,1370000,1399-10-15
767,ضمخا7066,اختيارخ اخابر-12000-1400/07/28,6,26,171461000,3974,6000,6999,3025,76.12,6595,2621,65.95,5500,6999,1399-10-15
768,ضجار2003,اختيارخ وتجارت-3000-1400/02/22,6,138,117300000,768,850,850,82,10.68,850,82,10.68,850,850,1399-10-15
769,اخزا804,اسنادخزانه-م4بودجه98-000421,6,4164,3791771524,911990,912010,910000,-1990,-0.22,910608,-1382,-0.15,910000,925000,1399-10-15
770,پست0008پ04,پسته فندقي32-30سبزدانه0008(پ),6,111,157202202,1402591,1439876,1436495,33904,2.42,1416236,13645,0.97,1361050,1439876,1399-10-15
771,ضصاد1104,اختيارخ وبصادر-4500-1399/11/12,6,236,11245000,99,50,70,-29,-29.29,48,-51,-51.52,31,70,1399-10-15
772,ضشنا1044,اختيارخ شپنا-10000-1399/10/23,6,74,168383000,2036,2002,2310,274,13.46,2275,239,11.74,2002,2500,1399-10-15
773,خعمرا,توسعه و عمران شهرستان نائين,6,4542,100973202,21584,22231,22231,647,3.0,21587,3,0.01,22231,22231,1399-10-15
774,وسهمدا,شركت س استان همدان,6,34454,29285900,890,850,850,-40,-4.49,890,0,0.0,850,850,1399-10-15
775,ضپنا2004,اختيارخ رمپنا-18000-1400/02/12,6,132,528003000,3942,4000,4000,58,1.47,4000,58,1.47,4000,4001,1399-10-15
776,اخزا716,اسنادخزانه-م16بودجه97-000407,6,58189,53500896000,915095,924000,919002,3907,0.43,919433,4338,0.47,919001,924000,1399-10-15
777,ضپاس2004,اختيارخ وپارس-4000-1400/02/29,5,215,161900000,1,800,800,799,79900.0,753,752,75200.0,699,800,1399-10-15
778,ضپار1116,اختيارخ خپارس-6000-1399/11/19,5,60,112330000,1700,1750,2000,300,17.65,1872,172,10.12,1750,2000,1399-10-15
779,وسخراج,شركت س استان خراسان جنوبي,5,16450,34709500,2220,2110,2110,-110,-4.95,2220,0,0.0,2110,2110,1399-10-15
780,ضچاد2001,اختيارخ كچاد-14000-1400/02/05,5,51,510001000,10000,10001,10000,0,0.0,10000,0,0.0,10000,10001,1399-10-15
781,ضخوز1015,اختيارخ فخوز-13715-1399/10/16,5,6,13521375,300,1200,500,200,66.67,858,558,186.0,500,1200,1399-10-15
782,وسكرمان,س.سهام عدالت استان كرمان,5,32700,32046000,1030,980,980,-50,-4.85,1030,0,0.0,980,980,1399-10-15
783,اخزا713,اسنادخزانه-م13بودجه97-000518,5,76198,68502005012,898991,899000,899502,511,0.06,899000,9,0.0,899000,899502,1399-10-15
784,ضگل1142,اختيارخ كگل-16000-1399/11/21,5,74,349490000,3001,5000,4000,999,33.29,4723,1722,57.38,4000,5090,1399-10-15
785,غگز,گز سكه,5,240000,5520000000,23000,23000,23000,0,0.0,23000,0,0.0,23000,23000,1399-10-15
786,هترول911,اختيارف ت پترول-14730-99/11/15,5,9130,34438360,3664,3772,3772,108,2.95,3772,108,2.95,3772,3772,1399-10-15
787,ضگل1141,اختيارخ كگل-14000-1399/11/21,4,56,387988000,7899,6999,6010,-1889,-23.91,6928,-971,-12.29,6010,6999,1399-10-15
788,تملي708,تسهيلات مسكن ب. ملي-آبان97,4,36,21987900,581691,610775,610775,29084,5.0,610775,29084,5.0,610775,610775,1399-10-15
789,هفارس912,اختيارف ت فارس-14576-99/12/13,4,5293,10623051,2010,2007,2007,-3,-0.15,2007,-3,-0.15,2007,2007,1399-10-15
790,اخزا721,اسنادخزانه-م21بودجه97-000728,4,2278,1982135050,863667,867000,869990,6323,0.73,870121,6454,0.75,866000,871000,1399-10-15
791,شسم,توليد سموم‌ علف‌ كش,4,1156,105127796,87444,90941,90941,3497,4.0,87479,35,0.04,90941,90941,1399-10-15
792,تملي801,تسهيلات مسكن ب. ملي-فروردين98,4,39,21162387,559213,535253,531253,-27960,-5.0,542625,-16588,-2.97,531253,587173,1399-10-15
793,ضمخا7069,اختيارخ اخابر-18000-1400/07/28,4,4,16500000,4186,4000,4500,314,7.5,4125,-61,-1.46,4000,4500,1399-10-15
794,ضفار1123,اختيارخ فارس-13826-1399/11/07,4,38,14674000,160,175,200,40,25.0,193,33,20.63,175,214,1399-10-15
795,وسزنجان,شركت س استان زنجان,4,20425,27573750,1420,1350,1350,-70,-4.93,1420,0,0.0,1350,1350,1399-10-15
796,اخزا720,اسنادخزانه-م20بودجه97-000324,4,6115,5645179461,922998,923000,925001,2003,0.22,923169,171,0.02,922999,925001,1399-10-15
797,ضپيك1021,اختيارخ تاپيكو-16000-99/10/16,4,7,7000,10,1,1,-9,-90.0,1,-9,-90.0,1,1,1399-10-15
798,وسمازن,س.سهام عدالت استان مازندران,4,25400,23876000,980,940,940,-40,-4.08,980,0,0.0,940,940,1399-10-15
799,ضفار1125,اختيارخ فارس-17826-1399/11/07,4,16,1718000,46,73,50,4,8.7,54,8,17.39,50,73,1399-10-15
800,ضغدر1118,اختيارخ وغدير-9000-1399/11/26,4,12,38455000,4000,3350,3001,-999,-24.98,3205,-795,-19.88,3001,3350,1399-10-15
801,شستا003,اجاره تامين اجتماعي-سپهر000523,4,42,41680000,990000,990000,1000000,10000,1.01,992381,2381,0.24,990000,1000000,1399-10-15
802,ضپاس2001,اختيارخ وپارس-2500-1400/02/29,3,11,20900000,1650,1900,1900,250,15.15,1900,250,15.15,1900,1900,1399-10-15
803,ضملت1126,اختيارخ وبملت-4500-1399/11/28,3,31,31890000,907,1050,990,83,9.15,1029,122,13.45,990,1050,1399-10-15
804,ضصاد1106,اختيارخ وبصادر-6000-1399/11/12,3,45,480000,21,16,10,-11,-52.38,11,-10,-47.62,10,16,1399-10-15
805,زعف0008پ09,زعفران0008نگين نوين(پ),3,250,30715000,122120,122600,124100,1980,1.62,122860,740,0.61,122500,124100,1399-10-15
806,ضپاس2003,اختيارخ وپارس-3500-1400/02/29,3,160,160000000,1000,1000,1000,0,0.0,1000,0,0.0,1000,1000,1399-10-15
807,ضصاد1107,اختيارخ وبصادر-7000-1399/11/12,3,72,898000,12,99,10,-2,-16.67,12,0,0.0,10,99,1399-10-15
808,زير0003پ04,زيره سبز0003شركت مينوبذر(پ),3,63,29222220,468020,465000,465046,-2974,-0.64,463845,-4175,-0.89,462052,465046,1399-10-15
809,ضخوز1013,اختيارخ فخوز-10667-1399/10/16,3,13,129885000,3040,3880,3800,760,25.0,3806,766,25.2,3800,3880,1399-10-15
810,سنفت101,سلف موازي استاندارد سنفت101,3,155600,200058965600,1236583,1285726,1285726,49143,3.97,1285726,49143,3.97,1285726,1285726,1399-10-15
811,هاباد912,اختيارف ت آبادا-30100-99/12/12,3,624,7273344,12296,11656,11656,-640,-5.2,11656,-640,-5.2,11656,11656,1399-10-15
812,ضفار1122,اختيارخ فارس-11826-1399/11/07,3,22,57200000,1138,1300,1300,162,14.24,1300,162,14.24,1300,1300,1399-10-15
813,وسكرشا,س.سهام عدالت استان كرمانشاه,3,22872,27446400,1260,1200,1200,-60,-4.76,1260,0,0.0,1200,1200,1399-10-15
814,ضملي1148,اختيارخ فملي-10140-1399/11/05,3,12,95247600,3678,4000,4000,322,8.75,4025,347,9.43,4000,4300,1399-10-15
815,وسگيلا,شركت س استان گيلان,3,56885,44939150,830,790,790,-40,-4.82,830,0,0.0,790,790,1399-10-15
816,وسقم,شركت س استان قم,3,29867,40021780,1410,1340,1340,-70,-4.96,1410,0,0.0,1340,1340,1399-10-15
817,ضملي1151,اختيارخ فملي-16224-1399/11/05,2,2,2857428,776,699,750,-26,-3.35,724,-52,-6.7,699,750,1399-10-15
818,ضملت1129,اختيارخ وبملت-7000-1399/11/28,2,2,514000,192,257,257,65,33.85,257,65,33.85,257,257,1399-10-15
819,افران2,صندوق س افرا نماد پايدار-ثابت,2,200000,200000,12391,1,1,-12390,-99.99,1,-12390,-99.99,1,1,1399-10-15
820,تملي701,تسهيلات مسكن ب. ملي-فروردين97,2,22,15988082,692125,726731,726731,34606,5.0,726731,34606,5.0,726731,726731,1399-10-15
821,اخزا805,اسنادخزانه-م5بودجه98-000422,2,16569,15061242336,907500,909000,909024,1524,0.17,909001,1501,0.17,909000,909024,1399-10-15
822,صمعاد4122,صكوك اجاره معادن412-6ماهه21%,2,320000,310400000000,980100,970000,970000,-10100,-1.03,970000,-10100,-1.03,970000,970000,1399-10-15
823,سپرمي,پرميت‌,2,1283,10970933,8384,8551,8551,167,1.99,8384,0,0.0,8551,8551,1399-10-15
824,زير0003پ01,زيره سبز0003كيميابذر(پ),2,60,30599950,486370,510000,509999,23629,4.86,509999,23629,4.86,509999,510000,1399-10-15
825,ضغدر1126,اختيارخ وغدير-6000-1399/11/26,2,6,32037000,6000,4279,6400,400,6.67,5339,-661,-11.02,4279,6400,1399-10-15
826,ضبدر1160,اختيارخ شبندر-18000-1399/11/19,2,11,84800000,7200,7650,8300,1100,15.28,7709,509,7.07,7650,8300,1399-10-15
827,ضفلا1154,اختيارخ فولاد-12000-1399/11/28,2,20,32140000,1462,1607,1607,145,9.92,1607,145,9.92,1607,1607,1399-10-15
828,پست0008پ08,پسته فندقي32-30مه ولات0008(پ),2,100,136050000,1370129,1360000,1361000,-9129,-0.67,1360500,-9629,-0.7,1360000,1361000,1399-10-15
829,ضشنا1045,اختيارخ شپنا-12000-1399/10/23,2,23,29420000,2657,1279,1280,-1377,-51.83,1279,-1378,-51.86,1279,1280,1399-10-15
830,سنفت005,سلف موازي استاندارد سنفت005,2,394340,410823017660,1013578,1041799,1041799,28221,2.78,1041799,28221,2.78,1041799,1041799,1399-10-15
831,تابان02,اجاره تابان لوتوس14021206,1,3000,2820000000,970000,940000,940000,-30000,-3.09,940000,-30000,-3.09,940000,940000,1399-10-15
832,فبستم,صنايع ‌بسته‌بندي‌ مشهد,1,5175,4222800,793,816,816,23,2.9,793,0,0.0,816,816,1399-10-15
833,ضمخا2001,اختيارخ اخابر-10000-1400/02/29,1,1,5800000,1,5800,5800,5799,579900.0,5800,5799,579900.0,5800,5800,1399-10-15
834,وسگلستا,شركت س استان گلستان,1,12511,14762980,1240,1180,1180,-60,-4.84,1240,0,0.0,1180,1180,1399-10-15
835,دمعيار2,صندوق س. توازن معيار-د,1,400000,400000,10070,1,1,-10069,-99.99,1,-10069,-99.99,1,1,1399-10-15
836,فنوال2,نورد آلومينيوم‌,1,14748451,389506590910,25160,26410,26410,1250,4.97,26410,1250,4.97,26410,26410,1399-10-15
837,وساربيل,شركت س استان اردبيل,1,5000,6100000,1280,1220,1220,-60,-4.69,1280,0,0.0,1220,1220,1399-10-15
838,وغدير4,سرمايه‌گذاري‌غدير(هلدينگ‌,1,7900000,92825000000,11520,11750,11750,230,2.0,11750,230,2.0,11750,11750,1399-10-15
839,اراد582,مرابحه عام دولت5-ش.خ 0110,1,16,15106080,944060,944130,944130,70,0.01,944130,70,0.01,944130,944130,1399-10-15
840,كمنگنز4,معادن‌منگنزايران‌,1,850000,109318500000,126840,128610,128610,1770,1.4,128610,1770,1.4,128610,128610,1399-10-15
841,دعبيد4,لابراتوارداروسازي‌  دكترعبيدي‌,1,2600000,77194000000,30460,29690,29690,-770,-2.53,29690,-770,-2.53,29690,29690,1399-10-15
842,ضملت1125,اختيارخ وبملت-4000-1399/11/28,1,5,7500000,1250,1500,1500,250,20.0,1500,250,20.0,1500,1500,1399-10-15
843,تيپيكو2,سرمايه گذاري دارويي تامين,1,4000000,220080000000,55030,55020,55020,-10,-0.02,55020,-10,-0.02,55020,55020,1399-10-15
844,ضمخا1024,اختيارخ اخابر-14000-1399/10/30,1,5,3750000,501,750,750,249,49.7,750,249,49.7,750,750,1399-10-15
845,پا ر 54,بار پايه روز 54,1,3000,1140000,719,380,380,-339,-47.15,380,-339,-47.15,380,380,1399-10-15
846,ضگل1149,اختيارخ كگل-10000-1399/11/21,1,1,8900000,9643,8900,8900,-743,-7.71,8900,-743,-7.71,8900,8900,1399-10-15
847,پا ر 55,بار پايه روز 55,1,3000,1140000,719,380,380,-339,-47.15,380,-339,-47.15,380,380,1399-10-15
848,اراد55,مرابحه عام دولت5-ش.خ 0209,1,1500,1390050000,926640,926700,926700,60,0.01,926700,60,0.01,926700,926700,1399-10-15
849,ضفلا1158,اختيارخ فولاد-20000-1399/11/28,1,1,5000,90,5,5,-85,-94.44,5,-85,-94.44,5,5,1399-10-15
850,شلرد02,كود شيميايي اوره لردگان,1,5,4965000,992000,993000,993000,1000,0.1,993000,1000,0.1,993000,993000,1399-10-15
851,ضپيك2009,اختيارخ تاپيكو-10000-00/02/19,1,4,23800000,5730,5950,5950,220,3.84,5950,220,3.84,5950,5950,1399-10-15
852,سرو2,صندوق س سروسودمند مدبران-سهام,1,100000,100000,70640,1,1,-70639,-100.0,1,-70639,-100.0,1,1,1399-10-15
853,اشاد10,مشاركت دولتي10-شرايط خاص001226,1,100,95000000,959000,950000,950000,-9000,-0.94,950000,-9000,-0.94,950000,950000,1399-10-15
854,اخزا723,اسنادخزانه-م23بودجه97-000824,1,10,8581000,860657,858100,858100,-2557,-0.3,858100,-2557,-0.3,858100,858100,1399-10-15
855,پا ر 56,بار پايه روز 56,1,3000,1140000,717,380,380,-337,-47.0,380,-337,-47.0,380,380,1399-10-15
856,وسبوشهر,شركت س استان بوشهر,1,4457,5348400,1260,1200,1200,-60,-4.76,1260,0,0.0,1200,1200,1399-10-15
857,كطبس4,ذغال‌سنگ‌ نگين‌ ط‌بس‌,1,1500000,117360000000,74570,78240,78240,3670,4.92,78240,3670,4.92,78240,78240,1399-10-15
858,اخزا7132,اسنادخزانه-م13بودجه97-000518,1,268196,241108204000,898991,899000,899000,9,0.0,899000,9,0.0,899000,899000,1399-10-15
859,ضغدر1120,اختيارخ وغدير-12000-1399/11/26,1,20,26000000,2040,1300,1300,-740,-36.27,1300,-740,-36.27,1300,1300,1399-10-15
860,سميعا002,سلف موازي استاندارد سميعا002,1,40000,49645000000,1249374,1241125,1241125,-8249,-0.66,1241125,-8249,-0.66,1241125,1241125,1399-10-15
861,اخزا810,اسنادخزانه-م10بودجه98-001006,1,5218,4403992000,843518,844000,844000,482,0.06,844000,482,0.06,844000,844000,1399-10-15
862,پا ر 53,بار پايه روز 53,1,3000,1140000,719,380,380,-339,-47.15,380,-339,-47.15,380,380,1399-10-15
863,صخود0012,ص مرابحه خودرو0012- 3ماهه 18%,1,20,20200000,1010000,1010000,1010000,0,0.0,1010000,0,0.0,1010000,1010000,1399-10-15
864,كپارس4,كاشي‌ پارس‌,1,1800000,347922000000,185850,193290,193290,7440,4.0,193290,7440,4.0,193290,193290,1399-10-15
865,ضملي1149,اختيارخ فملي-12168-1399/11/05,1,5,19720000,1717,2000,2000,283,16.48,2000,283,16.48,2000,2000,1399-10-15
866,ساذري,آذريت‌,1,1000,5987000,5813,5987,5987,174,2.99,5813,0,0.0,5987,5987,1399-10-15
867,اخزا7162,اسنادخزانه-م16بودجه97-000407,1,228904,210477228000,915095,919500,919500,4405,0.48,919500,4405,0.48,919500,919500,1399-10-15
868,ضبدر1149,اختيارخ شبندر-28000-1399/11/19,1,10,46500000,1505,4650,4650,3145,208.97,4650,3145,208.97,4650,4650,1399-10-15
869,وصندوق2,سرمايه‌گذاري‌صندوق‌بازنشستگي‌,1,6400000,95424000000,14910,14910,14910,0,0.0,14910,0,0.0,14910,14910,1399-10-15
870,ضترا1126,اختيارخ شتران-7000-1399/11/14,1,2,7200000,3500,3600,3600,100,2.86,3600,100,2.86,3600,3600,1399-10-15
871,اراد504,مرابحه عام دولت5-ش.خ0302,1,500000,500000000000,1000001,1000000,1000000,-1,0.0,1000000,-1,0.0,1000000,1000000,1399-10-15
872,ضخوز2013,اختيارخ فخوز-12000-1400/02/15,1,2,11000000,6200,5500,5500,-700,-11.29,5500,-700,-11.29,5500,5500,1399-10-15
873,مبين2,مبين انرژي خليج فارس,1,5850699,94254760890,16110,16110,16110,0,0.0,16110,0,0.0,16110,16110,1399-10-15
874,صايپا412,صكوك مرابحه سايپا412-3ماهه 16%,1,100,94050000,930000,940500,940500,10500,1.13,940500,10500,1.13,940500,940500,1399-10-15
875,پا ر 57,بار پايه روز 57,1,3000,1140000,717,380,380,-337,-47.0,380,-337,-47.0,380,380,1399-10-15
876,اراد60,مرابحه عام دولتي6-ش.خ0210,1,18000,16649280000,924890,924960,924960,70,0.01,924960,70,0.01,924960,924960,1399-10-15
877,ضترا1127,اختيارخ شتران-8000-1399/11/14,1,10,25000000,2425,2500,2500,75,3.09,2500,75,3.09,2500,2500,1399-10-15
