,نماد,نام,تعداد,حجم,ارزش,دیروز,اولین,آخرین معامله - مقدار,آخرین معامله - تغییر,آخرین معامله - درصد,قیمت پایانی - مقدار,قیمت پایانی - تغییر,قیمت پایانی - درصد,کمترین,بیشترین,تاریخ
0,وپويا,سرمايه گذاري پويا,221148,149165392,1712875262674,11269,10706,11394,125,1.11,11483,214,1.9,10706,11832,1399-7-20
1,پيزد,مجتمع صنايع لاستيك يزد,216137,13179821,1392576810079,106527,101201,101201,-5326,-5.0,105660,-867,-0.81,101201,111853,1399-7-20
2,بپيوند,برق و انرژي پيوندگستر پارس,115014,30389513,757607196825,25145,25080,23888,-1257,-5.0,24930,-215,-0.86,23888,26402,1399-7-20
3,دارا يكم,صندوق واسطه گري مالي يكم-سهام,112002,46518713,10984343025160,225020,234110,226200,1180,0.52,236130,11110,4.94,225020,244980,1399-7-20
4,وسپهر,سرمايه گذاري مالي سپهرصادرات,111632,209997116,3384833475566,15368,16136,16131,763,4.96,16118,750,4.88,15410,16136,1399-7-20
5,بگيلان,توسعه مسير برق گيلان,88486,14945319,470890977934,31773,31185,30190,-1583,-4.98,31508,-265,-0.83,30185,33361,1399-7-20
6,شتران,پالايش نفت تهران,68482,329141300,5471859328180,13090,16100,16310,3220,24.6,16620,3530,26.97,16100,16900,1399-7-20
7,فولاد,فولاد مباركه اصفهان,66811,397335925,7242205025340,17490,17600,18030,540,3.09,18230,740,4.23,17560,18360,1399-7-20
8,آبادا,توليد نيروي برق آبادان,62469,12663673,307561183870,23900,23950,23150,-750,-3.14,24290,390,1.63,23010,25080,1399-7-20
9,ثبهساز,بهساز كاشانه تهران,57776,213724071,824344782570,3760,3800,3730,-30,-0.8,3860,100,2.66,3700,3940,1399-7-20
10,گدنا,تهيه توزيع غذاي دنا آفرين فدك,57461,737459,10275016247,13270,13933,13933,663,5.0,13399,129,0.97,13933,13933,1399-7-20
11,وبملت,بانك ملت,55804,1187895834,7693894081170,5860,6620,6400,540,9.22,6480,620,10.58,6290,6780,1399-7-20
12,فملي,ملي‌ صنايع‌ مس‌ ايران‌,52175,199402046,5821840048750,27950,28100,28750,800,2.86,29200,1250,4.47,28100,29340,1399-7-20
13,غزر,صنعتي زر ماكارون,52063,5892406,354452008650,58070,60000,58170,100,0.17,60150,2080,3.58,58070,60970,1399-7-20
14,سيتا,سرمايه گذاري سيمان تامين,51111,68403584,1561339688840,22100,23070,21880,-220,-1.0,22830,730,3.3,21420,23200,1399-7-20
15,دي,بانك دي,49955,99006469,5231962436715,52194,53500,52201,7,0.01,52845,651,1.25,49590,54790,1399-7-20
16,زملارد,كشاورزي و دامپروري ملارد شير,49763,6195826,293355964981,45393,47662,46925,1532,3.37,47347,1954,4.3,43124,47662,1399-7-20
17,شاروم,پتروشيمي اروميه,46596,864940,14194530340,15630,16411,16411,781,5.0,15838,208,1.33,16411,16411,1399-7-20
18,پترول,گروه پتروشيمي س. ايرانيان,41951,205015494,3537329402710,16580,16600,16950,370,2.23,17250,670,4.04,16600,17400,1399-7-20
19,ثاميد,توسعه و عمران اميد,41641,155867869,466536090100,2860,3000,3000,140,4.9,2990,130,4.55,2880,3000,1399-7-20
20,خودرو,ايران‌ خودرو,40056,1648794992,5896269602980,3410,3580,3580,170,4.99,3580,170,4.99,3420,3580,1399-7-20
21,وتجارت,بانك تجارت,33542,1278103372,4567219531490,3420,3590,3490,70,2.05,3570,150,4.39,3450,3590,1399-7-20
22,آريا,پليمر آريا ساسول,33288,5916816,1073060804097,176123,175340,176600,477,0.27,181358,5235,2.97,175340,184929,1399-7-20
23,وبصادر,بانك صادرات ايران,33062,785789972,3675840649670,4490,4710,4570,80,1.78,4680,190,4.23,4510,4710,1399-7-20
24,وپارس,بانك‌پارسيان‌,32806,676413548,3134178960050,4520,4740,4400,-120,-2.65,4630,110,2.43,4350,4740,1399-7-20
25,رافزا,رايان هم افزا,32573,254774,8314804264,31082,32636,32636,1554,5.0,31327,245,0.79,32636,32636,1399-7-20
26,ذوب,سهامي ذوب آهن  اصفهان,29730,296786167,1938786422785,6277,6510,6330,53,0.84,6533,256,4.08,6300,6590,1399-7-20
27,خساپا,سايپا,28533,861186726,2536409006580,2820,2960,2960,140,4.96,2950,130,4.61,2820,2960,1399-7-20
28,ولپارس,ليزينگ پارسيان,28490,2976842,13187410060,4220,4430,4430,210,4.98,4260,40,0.95,4430,4430,1399-7-20
29,شگويا,پتروشيمي تندگويان,25231,94161239,1567866683414,16080,16011,16180,100,0.62,16651,571,3.55,15822,16884,1399-7-20
30,شبندر,پالايش نفت بندرعباس,24042,66175933,2673202576210,38680,40610,39400,720,1.86,40400,1720,4.45,39000,40610,1399-7-20
31,ثشاهد,سرمايه‌ گذاري‌ شاهد,23402,82247312,3181921924330,37940,36050,36500,-1440,-3.8,38690,750,1.98,36050,39830,1399-7-20
32,خگستر,گسترش‌سرمايه‌گذاري‌ايران‌خودرو,22012,322825645,1736968711840,5160,5410,5410,250,4.84,5380,220,4.26,5160,5410,1399-7-20
33,صباح,ح . سرمايه گذاري صبا تامين,21561,87874557,713777009526,8126,8000,7900,-226,-2.78,8123,-3,-0.04,7880,8400,1399-7-20
34,صبا,سرمايه گذاري صبا تامين,20949,56297050,638211511887,11204,11400,10902,-302,-2.7,11336,132,1.18,10804,11750,1399-7-20
35,چكاپا,گروه صنايع كاغذ پارس,19766,167457939,1530103541800,8820,9000,8840,20,0.23,9140,320,3.63,8730,9260,1399-7-20
36,ونيرو,سرمايه‌گذاري‌نيرو,19735,230153086,1306492503170,5770,5490,5650,-120,-2.08,5680,-90,-1.56,5490,6020,1399-7-20
37,خصدرا,صنعتي‌ دريايي‌ ايران‌,18637,241816437,1542984999119,6559,6363,6363,-196,-2.99,6381,-178,-2.71,6363,6480,1399-7-20
38,كاما,باما,17748,11569769,2237319664390,170030,190000,190980,20950,12.32,193380,23350,13.73,184010,199500,1399-7-20
39,وغدير,سرمايه‌گذاري‌غدير(هلدينگ‌,16413,101313044,1647939505440,15560,15830,15900,340,2.19,16270,710,4.56,15800,16330,1399-7-20
40,ثعمرا,عمران و توسعه شاهد,16011,85817238,2052417541982,24084,22880,22880,-1204,-5.0,23916,-168,-0.7,22880,25288,1399-7-20
41,فارس,صنايع پتروشيمي خليج فارس,15418,41311114,1279259296080,29860,30160,30500,640,2.14,30970,1110,3.72,30100,31350,1399-7-20
42,وخارزم,سرمايه گذاري خوارزمي,15315,76326726,1023138105960,12910,13160,12950,40,0.31,13400,490,3.8,12920,13550,1399-7-20
43,تاپيكو,س. نفت و گاز و پتروشيمي تأمين,14846,53728883,1141183444560,20460,20400,20600,140,0.68,21240,780,3.81,20290,21480,1399-7-20
44,حكشتي,كشتيراني جمهوري اسلامي ايران,14757,19884317,941683954630,46050,49000,46550,500,1.09,47360,1310,2.84,46550,49000,1399-7-20
45,ساوه,سيمان ساوه,13487,4189996,301135727568,72378,71160,68910,-3468,-4.79,71870,-508,-0.7,68760,75000,1399-7-20
46,سمگا,گروه سرمايه گذاري ميراث فرهنگي,13321,68326561,1603187257192,23054,23706,24206,1152,5.0,23464,410,1.78,22310,24206,1399-7-20
47,وتوصا,گروه س توسعه صنعتي ايران,13044,83849106,1172071167280,13410,14080,13490,80,0.6,13980,570,4.25,13010,14080,1399-7-20
48,شپلي,پلي اكريل ايران,11801,145485834,1021217371267,7131,6918,6918,-213,-2.99,7019,-112,-1.57,6918,7296,1399-7-20
49,قاسم,قاسم ايران,11706,59326026,894317755714,15787,14998,14998,-789,-5.0,15075,-712,-4.51,14998,15580,1399-7-20
50,غنوش,نوش‌ مازندران‌,11349,13601349,1091204619500,81580,85650,77510,-4070,-4.99,80230,-1350,-1.65,77510,85650,1399-7-20
51,غگيلا,شيرپاستوريزه پگاه گيلان,11203,237162,3965822964,15926,16722,16722,796,5.0,15986,60,0.38,16722,16722,1399-7-20
52,تبرك,گروه كارخانجات صنعتي تبرك,10642,38722109,1150884701040,29293,28210,28650,-643,-2.2,29722,429,1.46,27839,30757,1399-7-20
53,وتوس,توسعه‌شهري‌توس‌گستر,9714,28243240,1033136450510,36260,38070,34450,-1810,-4.99,36580,320,0.88,34450,38070,1399-7-20
54,وساپا,سرمايه‌گذاري‌ سايپا,9633,73005069,845924136550,11200,11750,11180,-20,-0.18,11590,390,3.48,10850,11760,1399-7-20
55,ثنوسا,نوسازي‌وساختمان‌تهران‌,9103,58975866,671512359050,11480,11500,11000,-480,-4.18,11390,-90,-0.78,10910,12000,1399-7-20
56,اخابر,مخابرات ايران,9055,223631256,4204008327860,17910,18800,18800,890,4.97,18800,890,4.97,18310,18800,1399-7-20
57,خپارس,پارس‌ خودرو,8666,85456132,808344751560,9120,9570,9360,240,2.63,9460,340,3.73,9030,9570,1399-7-20
58,پترولح,ح . گروه پتروشيمي س. ايرانيان,8499,41447321,636179989980,14460,14550,14930,470,3.25,15350,890,6.15,14460,15800,1399-7-20
59,مدير,ص.س.مديريت ثروت ص.بازنشستگي-س,8415,37606226,498055038934,13076,13000,12910,-166,-1.27,13244,168,1.28,12900,13690,1399-7-20
60,زدشت,كشت و صنعت دشت خرم دره,8005,20017888,845953693696,42476,40353,40390,-2086,-4.91,42260,-216,-0.51,40353,44580,1399-7-20
61,شصدفح,ح . صنعتي دوده فام,7906,3841669,70289536010,18244,18400,18112,-132,-0.72,18297,53,0.29,17901,18780,1399-7-20
62,بزاگرس,نيروگاه زاگرس كوثر,7891,55508681,828860475943,15583,14804,14840,-743,-4.77,14932,-651,-4.18,14804,15350,1399-7-20
63,كمند,صندوق س. با درآمد ثابت كمند,7307,336804006,3375298920310,10030,10040,10010,-20,-0.2,10020,-10,-0.1,10010,10040,1399-7-20
64,وبانك,سرمايه گذاري گروه توسعه ملي,6943,27716520,363516751070,12700,12900,13000,300,2.36,13120,420,3.31,12700,13330,1399-7-20
65,فخوز,فولاد  خوزستان,6856,37346487,1514199589030,38730,38600,39900,1170,3.02,40540,1810,4.67,38600,40660,1399-7-20
66,ثپرديس,سرمايه گذاري مسكن پرديس,6597,42336445,550605279661,13514,12839,12839,-675,-4.99,13005,-509,-3.77,12839,13490,1399-7-20
67,فروي,ذوب روي اصفهان,6276,5344900,366117192587,65677,68960,66600,923,1.41,68498,2821,4.3,65800,68960,1399-7-20
68,ونفت,سرمايه‌گذاري‌ صنعت‌ نفت‌,6090,18209714,295977177700,16290,16890,15650,-640,-3.93,16250,-40,-0.25,15510,16980,1399-7-20
69,كگل,معدني و صنعتي گل گهر,5972,16628747,367790183980,21530,21990,21300,-230,-1.07,22120,590,2.74,21000,22540,1399-7-20
70,خمحركه,نيرو محركه‌,5936,38383723,336743006850,8490,8910,8560,70,0.82,8770,280,3.3,8200,8910,1399-7-20
71,خبهمن,گروه‌بهمن‌,5830,26237817,715748015510,26200,27510,26860,660,2.52,27280,1080,4.12,25500,27510,1399-7-20
72,كچاد,معدني‌وصنعتي‌چادرملو,5667,24099736,485419214110,19350,19850,19550,200,1.03,20140,790,4.08,19350,20310,1399-7-20
73,ونوين,بانك‌اقتصادنوين‌,5622,121559732,641733848150,4960,5460,5190,230,4.64,5280,320,6.45,5190,5460,1399-7-20
74,زكوثر,سرمايه گذاري كشاورزي كوثر,5208,10802567,279806190610,25100,26200,24700,-400,-1.59,25900,800,3.19,24040,26350,1399-7-20
75,آگاس,صندوق س.هستي بخش آگاه-س,5085,7263534,557601132614,74383,74550,75491,1108,1.49,76767,2384,3.21,74550,77490,1399-7-20
76,واعتبار,سرمايه گذاري اعتبار ايران,4944,48358602,346357754590,7410,7040,7090,-320,-4.32,7160,-250,-3.37,7040,7640,1399-7-20
77,خريخت,صنايع‌ريخته‌گري‌ايران‌,4896,48138744,275526275570,5520,5790,5510,-10,-0.18,5720,200,3.62,5460,5790,1399-7-20
78,خكاوه,سايپا ديزل,4866,53318215,343195835082,6332,6521,6330,-2,-0.03,6437,105,1.66,6143,6521,1399-7-20
79,ثفارس,عمران‌وتوسعه‌فارس‌,4825,36159775,344649249390,9160,9300,9340,180,1.97,9530,370,4.04,9100,9610,1399-7-20
80,فاراك,ماشين‌ سازي‌ اراك‌,4770,36769595,362862776620,9440,9910,9600,160,1.69,9870,430,4.56,9550,9910,1399-7-20
81,دماوند,توليد نيروي برق دماوند,4673,6777598,526522984164,74200,76010,76750,2550,3.44,77686,3486,4.7,76010,77910,1399-7-20
82,شصدف,صنعتي دوده فام,4666,303853,6676258116,20926,21972,21972,1046,5.0,21058,132,0.63,21972,21972,1399-7-20
83,بترانس,ايران‌ ترانسفو,4505,10611384,425067472330,38220,40130,39100,880,2.3,40060,1840,4.81,39000,40130,1399-7-20
84,ومهان,گروه توسعه مالي مهر آيندگان,4505,21489072,409500168561,18535,18251,18910,375,2.02,19056,521,2.81,18251,19430,1399-7-20
85,ثتران,سرمايه گذاري مسكن تهران,4459,43592545,288278213377,6739,6403,6403,-336,-4.99,6613,-126,-1.87,6403,6990,1399-7-20
86,خچرخش,چرخشگر,4429,18131675,369757299220,21330,20270,20270,-1060,-4.97,20390,-940,-4.41,20270,21330,1399-7-20
87,وصنعت,سرمايه گذاري توسعه صنعت وتجارت,4425,21202545,204615940770,9430,9590,9400,-30,-0.32,9650,220,2.33,9330,9880,1399-7-20
88,كاوه,فولاد كاوه جنوب كيش,4404,60671574,1417585436220,22310,22330,23000,690,3.09,23360,1050,4.71,22330,23420,1399-7-20
89,آسيا,بيمه آسيا,4343,7935634,245451547210,31080,31720,29610,-1470,-4.73,30930,-150,-0.48,29540,32550,1399-7-20
90,ارزش,صندوق س ارزش آفرين بيدار-سهام,4342,35050250,422211909840,11820,11920,11800,-20,-0.17,12050,230,1.95,11800,12190,1399-7-20
91,ارفع,شركت آهن و فولاد ارفع,4310,16984045,291225763288,16529,16201,16730,201,1.22,17147,618,3.74,16201,17355,1399-7-20
92,فرابورس,فرابورس ايران,4290,6711872,449493393730,63971,67169,65905,1934,3.02,66970,2999,4.69,65533,67169,1399-7-20
93,شبريز,پالايش نفت تبريز,4131,35681615,1231213100490,32870,34510,34510,1640,4.99,34510,1640,4.99,33700,34510,1399-7-20
94,بپاس,بيمه پاسارگاد,4109,8205031,562849805021,68371,68400,69560,1189,1.74,68598,227,0.33,67200,69980,1399-7-20
95,خاذين,سايپاآذين‌,4067,33344925,264151724630,7620,8000,7800,180,2.36,7920,300,3.94,7600,8000,1399-7-20
96,غپاك,لبنيات‌ پاك‌,3856,18668773,282839261720,15480,14710,14710,-770,-4.97,15150,-330,-2.13,14710,15850,1399-7-20
97,وملل,اعتباري ملل,3829,27540131,433896383325,15404,15700,15500,96,0.62,15755,351,2.28,15405,16090,1399-7-20
98,طلا,صندوق س.پشتوانه طلاي لوتوس,3806,1628416,195469858318,114850,121001,118000,3150,2.74,120037,5187,4.52,117240,122880,1399-7-20
99,وليز,ليزينگ‌ايران‌,3780,29788353,289099984530,9280,9520,9610,330,3.56,9710,430,4.63,9360,9740,1399-7-20
100,سيمرغ,سيمرغ,3714,8780185,192989728100,22350,22000,21290,-1060,-4.74,21980,-370,-1.66,21240,22770,1399-7-20
101,ولساپا,ليزينگ رايان‌ سايپا,3572,53243452,236425684840,4260,4470,4380,120,2.82,4440,180,4.23,4270,4470,1399-7-20
102,ونيكي,سرمايه‌گذاري‌ ملي‌ايران‌,3561,5950176,219325434130,35670,37000,36010,340,0.95,36860,1190,3.34,36000,37450,1399-7-20
103,بجهرم,توسعه مولد نيروگاهي جهرم,3535,39137935,175178440964,4267,4480,4400,133,3.12,4476,209,4.9,4360,4480,1399-7-20
104,وخاور,بانك خاورميانه,3295,18612275,221206465480,12040,11540,11500,-540,-4.49,11880,-160,-1.33,11500,12220,1399-7-20
105,ختوقا,قطعات‌ اتومبيل‌ ايران‌,3260,43023563,188855107990,4200,4410,4360,160,3.81,4390,190,4.52,4220,4410,1399-7-20
106,زاگرس,پتروشيمي زاگرس,3231,2398636,429979617813,172180,175000,174000,1820,1.06,179260,7080,4.11,172180,180789,1399-7-20
107,وايران,ليزينگ ايرانيان,3222,16307319,168455788580,10180,10200,9810,-370,-3.63,10330,150,1.47,9800,10680,1399-7-20
108,شسپا,نفت سپاهان,3214,9981450,243715000310,23460,23860,24000,540,2.3,24420,960,4.09,23700,24630,1399-7-20
109,فسازان,غلتك سازان سپاهان,3191,12500016,462839226600,38070,36170,37190,-880,-2.31,37030,-1040,-2.73,36170,38690,1399-7-20
110,هرمز,فولاد هرمزگان جنوب,3161,20628367,286188703999,13376,13200,13500,124,0.93,13874,498,3.72,13200,14044,1399-7-20
111,پارسان,گسترش نفت و گاز پارسيان,3158,31589143,855600412570,25820,26000,27100,1280,4.96,27090,1270,4.92,25890,27110,1399-7-20
112,فجام,جام‌دارو,3142,2507220,145931675620,59130,56180,57500,-1630,-2.76,58200,-930,-1.57,56180,62000,1399-7-20
113,رمپنا,گروه مپنا (سهامي عام),3133,27798514,642982154300,22070,23170,22700,630,2.85,23130,1060,4.8,22500,23170,1399-7-20
114,وثوق,سرمايه گذاري وثوق امين,3105,8697999,136945104762,15871,15078,15700,-171,-1.08,15744,-127,-0.8,15078,16552,1399-7-20
115,پلاسك,پلاسكوكار,3044,19123370,174229129310,9500,9030,9030,-470,-4.95,9110,-390,-4.11,9030,9470,1399-7-20
116,سپاها,سيمان‌سپاهان‌,3009,11621388,124337944250,10380,10620,10220,-160,-1.54,10700,320,3.08,10010,10890,1399-7-20
117,ورنا,سرمايه‌گذاري‌ رنا(هلدينگ‌,2842,29844727,338205463530,10870,11410,11270,400,3.68,11330,460,4.23,10860,11410,1399-7-20
118,وبيمهح,ح . سرمايه‌ گذاري‌ صنعت‌ بيمه‌,2798,58822546,112987295370,1910,1890,1860,-50,-2.62,1920,10,0.52,1830,2000,1399-7-20
119,قشرين,قند شيرين خراسان,2754,9253706,169394117466,18566,18010,18010,-556,-2.99,18306,-260,-1.4,18010,19090,1399-7-20
120,نوري,پتروشيمي نوري,2739,1589467,277518077470,169950,170810,171440,1490,0.88,174600,4650,2.74,170810,177770,1399-7-20
121,سرو,صندوق س سروسودمند مدبران-سهام,2701,3277874,226596465640,67160,68300,67910,750,1.12,69130,1970,2.93,67620,70080,1399-7-20
122,ختراك,ريخته‌گري‌ تراكتورسازي‌ ايران‌,2681,8281703,172461367240,21670,20590,20850,-820,-3.78,20820,-850,-3.92,20590,21760,1399-7-20
123,اپرداز,آتيه داده پرداز,2643,9526591,304881919384,33113,31510,31458,-1655,-5.0,32003,-1110,-3.35,31458,33370,1399-7-20
124,زنجان,صنايع كشاورزي وكود زنجان,2594,26263906,177576553410,6922,6715,6715,-207,-2.99,6761,-161,-2.33,6715,6979,1399-7-20
125,زر,صندوق س.پشتوانه سكه طلاي زر,2591,3811385,255450370525,64339,67500,65998,1659,2.58,67023,2684,4.17,65800,68980,1399-7-20
126,خمهر,مهركام‌پارس‌,2552,19014149,158229543860,8020,8420,8000,-20,-0.25,8320,300,3.74,7700,8420,1399-7-20
127,غگلستا,شير پاستوريزه پگاه گلستان,2551,9668819,151527495718,15778,14990,16210,432,2.74,15672,-106,-0.67,14990,16566,1399-7-20
128,شغدير,پتروشيمي غدير,2525,4114422,213905474192,50397,50397,50090,-307,-0.61,51989,1592,3.16,48700,52916,1399-7-20
129,قرن,پديده شيمي قرن,2523,1441189,81487359180,56230,57350,54770,-1460,-2.6,56540,310,0.55,54000,58500,1399-7-20
130,فولاژ,فولاد آلياژي ايران,2463,4821109,128824224230,27070,26000,25720,-1350,-4.99,26720,-350,-1.29,25720,28200,1399-7-20
131,ديران,ايران‌دارو,2461,5152067,116031939190,21930,22000,22970,1040,4.74,22520,590,2.69,21500,23000,1399-7-20
132,كوير,توليدي فولاد سپيد فراب كوير,2447,9085720,149072340330,15750,16470,16020,270,1.71,16410,660,4.19,15700,16530,1399-7-20
133,تاصيكو,سرمايه گذاري صدرتامين,2446,11396625,138484771250,11720,11300,11950,230,1.96,12150,430,3.67,11300,12300,1399-7-20
134,همراه,شركت ارتباطات سيار ايران,2431,11916211,501362672010,40110,42110,41800,1690,4.21,42070,1960,4.89,41040,42110,1399-7-20
135,پاسا,ايران‌ياساتايرورابر,2430,8835964,196360564930,21490,21200,21700,210,0.98,22220,730,3.4,21200,22560,1399-7-20
136,پاكشو,گروه صنعتي پاكشو,2399,3010208,212845498960,73080,69460,69690,-3390,-4.64,70710,-2370,-3.24,69460,73080,1399-7-20
137,مرقام,ايران‌ارقام‌,2392,10109805,290517209870,27830,28000,28730,900,3.23,28740,910,3.27,26800,29220,1399-7-20
138,آپ,آسان پرداخت پرشين,2370,6583263,136005146560,20500,20800,20000,-500,-2.44,20660,160,0.78,19990,21000,1399-7-20
139,ولغدر,ليزينگ‌خودروغدير,2341,8556232,148109577130,16850,17690,16700,-150,-0.89,17310,460,2.73,16500,17690,1399-7-20
140,تماوند,تامين سرمايه دماوند,2333,37649629,558233350590,14589,14152,15026,437,3.0,14827,238,1.63,14152,15026,1399-7-20
141,ثشرقح,ح. سرمايه گذاري مسكن شمال شرق,2328,22379188,90076136470,3960,4040,3800,-160,-4.04,4020,60,1.52,3770,4230,1399-7-20
142,وسپه,سرمايه‌گذاري‌ سپه‌,2263,11242457,185695265430,15810,15990,16500,690,4.36,16520,710,4.49,15990,16600,1399-7-20
143,فزرين,زرين معدن آسيا,2257,5850963,138679561480,22806,23500,23946,1140,5.0,23702,896,3.93,22807,23946,1399-7-20
144,شپترو,پتروشيمي آبادان,2219,32752787,186349877819,5543,5709,5600,57,1.03,5690,147,2.65,5500,5709,1399-7-20
145,خپويش,سازه‌ پويش‌,2201,2598887,106448919420,45070,42200,40420,-4650,-10.32,40960,-4110,-9.12,40090,44310,1399-7-20
146,وبيمه,سرمايه‌ گذاري‌ صنعت‌ بيمه‌,2200,17808367,57855220560,3190,3210,3140,-50,-1.57,3250,60,1.88,3080,3310,1399-7-20
147,وسبحان,سرمايه گذاري سبحان,2199,14271682,144912264226,10070,10140,9800,-270,-2.68,10154,84,0.83,9800,10380,1399-7-20
148,حفارس,حمل و نقل بين المللي خليج فارس,2192,29430904,156394831260,5080,5200,5280,200,3.94,5310,230,4.53,5190,5330,1399-7-20
149,وسكاب,س.ص.بازنشستگي كاركنان بانكها,2188,19186617,140294865580,7240,7250,7100,-140,-1.93,7310,70,0.97,7100,7480,1399-7-20
150,وسينا,بانك سينا,2152,33924472,458668675310,12930,13570,13000,70,0.54,13520,590,4.56,12960,13570,1399-7-20
151,كالا,بورس كالاي ايران,2148,4750678,219217528340,44220,46430,44210,-10,-0.02,46140,1920,4.34,44200,46430,1399-7-20
152,افق,فروشگاههاي زنجيره اي افق كوروش,2137,2369268,177231517930,74900,72300,73280,-1620,-2.16,74800,-100,-0.13,72300,77250,1399-7-20
153,خفنر,فنرسازي‌خاور,2113,9194332,188851677110,20180,19180,20600,420,2.08,20540,360,1.78,19180,21180,1399-7-20
154,لبوتان,گروه‌صنعتي‌بوتان‌,2112,2179083,171808744580,82120,78020,78510,-3610,-4.4,78840,-3280,-3.99,78020,85000,1399-7-20
155,تيپيكو,سرمايه گذاري دارويي تامين,2099,4515465,282778643390,60790,60000,60100,-690,-1.14,62620,1830,3.01,58500,63820,1399-7-20
156,آوا,صندوق س.سهام آواي معيار-س,2089,12008843,119968853006,9777,9859,9822,45,0.46,9990,213,2.18,9803,10170,1399-7-20
157,سكرد,سيمان كردستان,2077,7082671,77370434960,11090,11200,10540,-550,-4.96,10920,-170,-1.53,10540,11400,1399-7-20
158,غشهد,شهد ايران ‌,2041,7882071,60224770890,7590,7940,7400,-190,-2.5,7640,50,0.66,7330,7940,1399-7-20
159,شكلر,نيروكلر,2025,4112233,209984639160,48730,51000,51000,2270,4.66,51060,2330,4.78,50000,51160,1399-7-20
160,وتوكاح,ح . ‌توكافولاد(هلدينگ‌,2017,10983111,119231993090,10437,10240,10541,104,1.0,10856,419,4.01,10240,11180,1399-7-20
161,كاذر,فرآورده‌هاي‌نسوزآذر,2007,2507519,93408040040,37580,39180,36390,-1190,-3.17,37250,-330,-0.88,35710,39400,1399-7-20
162,اعتماد,صندوق س.اعتماد آفرين پارسيان-د,1993,60348680,1977641430040,32744,32770,32774,30,0.09,32770,26,0.08,32770,32775,1399-7-20
163,تنوين,تامين سرمايه نوين,1988,40322562,470022040080,11110,11660,11640,530,4.77,11660,550,4.95,11500,11660,1399-7-20
164,غالبر,لبنيات‌ كالبر,1971,5545573,73449713100,13460,13100,12790,-670,-4.98,13240,-220,-1.63,12790,13990,1399-7-20
165,وساخت,سرمايه‌ گذاري‌ ساختمان‌ايران‌,1967,5634306,275508707470,46640,48490,48970,2330,5.0,48900,2260,4.85,47000,48970,1399-7-20
166,عيار,صندوق س. پشتوانه طلاي مفيد,1967,2158556,87779598637,38691,41490,39800,1109,2.87,40666,1975,5.1,39250,41490,1399-7-20
167,خوساز,محورسازان‌ايران‌خودرو,1950,9440322,91130568000,9290,9680,9140,-150,-1.61,9650,360,3.88,9010,9750,1399-7-20
168,وتوكا,سرمايه‌گذاري‌توكافولاد(هلدينگ,1945,18464371,255706962310,13350,13360,13480,130,0.97,13850,500,3.75,13050,14010,1399-7-20
169,چكارن,كارتن‌ ايران‌,1924,22802704,102804731520,4300,4510,4510,210,4.88,4510,210,4.88,4470,4510,1399-7-20
170,كيميا,معدني كيمياي زنجان گستران,1915,3510922,102430735906,29131,30500,28000,-1131,-3.88,29175,44,0.15,27880,30500,1399-7-20
171,غشاذر,پگاه‌آذربايجان‌غربي‌,1902,3304167,70738112640,21660,21500,20590,-1070,-4.94,21410,-250,-1.15,20580,22730,1399-7-20
172,امين يكم,صندوق درآمد ثابت امين يكم فردا,1899,58598206,607555631850,10380,10380,10370,-10,-0.1,10370,-10,-0.1,10360,10390,1399-7-20
173,گكوثر,هتل پارسيان كوثر اصفهان,1897,1696575,303769726715,171963,180561,173000,1037,0.6,179049,7086,4.12,172500,180561,1399-7-20
174,ثنور,سرمايه گذاري كوه نور,1881,18840842,145548871292,8078,7675,7675,-403,-4.99,7725,-353,-4.37,7675,7980,1399-7-20
175,دكوثر,داروسازي‌ كوثر,1877,6733268,178740326530,25400,26670,25490,90,0.35,26550,1150,4.53,24200,26670,1399-7-20
176,شاراك,پتروشيمي شازند,1876,9035594,223840982430,24120,24350,24800,680,2.82,24770,650,2.69,23750,25320,1399-7-20
177,پارسيان,بيمه پارسيان,1867,10901348,154516248870,14400,14400,13700,-700,-4.86,14170,-230,-1.6,13680,15000,1399-7-20
178,ثمسكن,سرمايه‌گذاري‌ مسكن‌,1856,21112937,161462623470,7330,7690,7440,110,1.5,7650,320,4.37,7300,7690,1399-7-20
179,تسه9906,امتياز تسهيلات مسكن شهريور99,1844,29461,27524150232,943371,990539,896203,-47168,-5.0,934257,-9114,-0.97,896203,990539,1399-7-20
180,سباقر,سيمان باقران,1843,6750377,135817654183,20486,19873,19872,-614,-3.0,20120,-366,-1.79,19872,20611,1399-7-20
181,خكرمان,گروه اقتصادي كرمان خودرو,1841,20975174,131377226303,6107,6290,6138,31,0.51,6263,156,2.55,6060,6290,1399-7-20
182,وصندوق,سرمايه‌گذاري‌صندوق‌بازنشستگي‌,1822,26718837,483963586640,17300,17250,17990,690,3.99,18110,810,4.68,17200,18160,1399-7-20
183,زبينا,كشاورزي و دامپروري بينالود,1802,3041713,147909659813,46574,48500,47890,1316,2.83,48627,2053,4.41,46070,48902,1399-7-20
184,شكربن,كربن‌ ايران‌,1789,4375165,371242138320,81660,83290,85100,3440,4.21,84850,3190,3.91,82500,85740,1399-7-20
185,سيلام,سيمان‌ ايلام‌,1784,7412360,80082772710,11270,10710,10710,-560,-4.97,10800,-470,-4.17,10710,11500,1399-7-20
186,آبين,كشت و صنعت آبشيرين,1782,10892494,45463032856,4125,4002,4200,75,1.82,4174,49,1.19,4002,4248,1399-7-20
187,سرچشمه,سرمايه گذاري مس سرچشمه,1782,9967925,101617411816,9958,10000,10012,54,0.54,10194,236,2.37,9960,10399,1399-7-20
188,وبوعلي,سرمايه‌گذاري‌بوعلي‌,1780,10323851,100913246930,9670,9800,9420,-250,-2.59,9770,100,1.03,9310,9940,1399-7-20
189,وگردش,بانك گردشگري,1763,31631980,586637612316,19113,18540,18800,-313,-1.64,18546,-567,-2.97,18540,19000,1399-7-20
190,سخوز,سيمان خوزستان,1721,4508378,111657027550,24440,25550,24540,100,0.41,24770,330,1.35,23230,25550,1399-7-20
191,بموتو,موتوژن‌,1710,2098665,110741046030,53990,52310,52000,-1990,-3.69,52770,-1220,-2.26,51300,56480,1399-7-20
192,وبهمن,سرمايه‌گذاري‌بهمن‌,1689,10146385,162920423960,15460,15340,15550,90,0.58,16060,600,3.88,15220,16230,1399-7-20
193,شلعابح,ح . لعابيران‌,1684,9815653,57314714080,5820,5910,5450,-370,-6.36,5840,20,0.34,5450,6100,1399-7-20
194,پتاير,ايران‌ تاير,1680,1926577,207930708490,102990,108130,100300,-2690,-2.61,107930,4940,4.8,99000,108130,1399-7-20
195,خاهن,آهنگري‌ تراكتورسازي‌ ايران‌,1679,4883074,143616364340,28310,29670,28350,40,0.14,29410,1100,3.89,28000,29720,1399-7-20
196,اميد,تامين سرمايه اميد,1674,10810920,172633082210,15250,16010,15550,300,1.97,15970,720,4.72,15280,16010,1399-7-20
197,كرازي,كارخانجات‌توليدي‌شيشه‌رازي‌,1656,7236906,127169288470,16800,17100,17080,280,1.67,17570,770,4.58,17010,17640,1399-7-20
198,شبهرن,نفت‌ بهران‌,1654,2012312,146268062100,69290,72750,71370,2080,3.0,72690,3400,4.91,70000,72750,1399-7-20
199,اتكام,شركت بيمه اتكايي امين,1651,10119310,91964011638,8867,8999,9200,333,3.76,9088,221,2.49,8870,9270,1399-7-20
200,خشرق,الكتريك‌ خودرو شرق‌,1650,5585572,119496102690,20550,21570,20930,380,1.85,21390,840,4.09,20060,21570,1399-7-20
201,دعبيد,لابراتوارداروسازي‌  دكترعبيدي‌,1648,1553623,55448029770,36200,36200,35000,-1200,-3.31,35760,-440,-1.22,34390,36850,1399-7-20
202,كلوند,كاشي‌ الوند,1624,3691795,91552744820,25560,26000,24330,-1230,-4.81,24800,-760,-2.97,24290,26100,1399-7-20
203,دتوزيع,توزيع دارو پخش,1615,1403786,73142058451,52100,50620,50650,-1450,-2.78,52103,3,0.01,49650,53880,1399-7-20
204,ثشرق,سرمايه گذاري مسكن شمال شرق,1599,16694401,113489286250,6530,6580,6620,90,1.38,6800,270,4.13,6510,6850,1399-7-20
205,تملت,تامين سرمايه بانك ملت,1594,6623943,85183906980,12250,12860,12860,610,4.98,12860,610,4.98,12860,12860,1399-7-20
206,ساربيل,سيمان آرتا اردبيل,1588,1874221,124864874900,56340,65000,67920,11580,20.55,66620,10280,18.25,61750,68250,1399-7-20
207,وهور,مديريت انرژي اميد  تابان هور,1573,4498633,178416028197,39307,39990,39000,-307,-0.78,39660,353,0.9,38350,40390,1399-7-20
208,كگهر,سنگ آهن گهرزمين,1557,2407277,109218261827,45176,43300,43800,-1376,-3.05,45354,178,0.39,43300,47000,1399-7-20
209,بركت,گروه دارويي بركت,1553,18368772,333760587240,17310,18170,18170,860,4.97,18170,860,4.97,18170,18170,1399-7-20
210,بزاگرسح,ح . نيروگاه زاگرس كوثر,1544,17256719,153940206551,8569,8450,8997,428,4.99,8921,352,4.11,8370,8997,1399-7-20
211,غويتا,ويتانا,1540,2497857,160104875026,66956,63609,63609,-3347,-5.0,64097,-2859,-4.27,63609,66533,1399-7-20
212,واميد,گروه مديريت سرمايه گذاري اميد,1525,5601984,239459835880,42580,41500,42990,410,0.96,42750,170,0.4,41500,43360,1399-7-20
213,دفارا,داروسازي‌ فارابي‌,1484,1456947,118206715070,77820,80700,80000,2180,2.8,81130,3310,4.25,78900,81710,1399-7-20
214,ساراب,سيمان‌ داراب‌,1480,4861788,65098950520,13500,13820,12920,-580,-4.3,13390,-110,-0.81,12870,13900,1399-7-20
215,تسه9904,امتياز تسهيلات مسكن تير99,1457,27881,25377973067,898767,943705,900000,1233,0.14,910225,11458,1.27,863000,943705,1399-7-20
216,تاپكيشح,ح.تجارت الكترونيك پارسيان كيش,1452,4657691,39683338251,8369,8500,8500,131,1.57,8520,151,1.8,8200,8787,1399-7-20
217,كنور,توسعه معدني و صنعتي صبانور,1444,2644686,118564714270,43740,43520,44400,660,1.51,44830,1090,2.49,43500,45750,1399-7-20
218,مارون,پتروشيمي مارون,1433,1187679,171616353626,145990,140100,143700,-2290,-1.57,144497,-1493,-1.02,140100,149110,1399-7-20
219,شپديس,پتروشيمي پرديس,1432,2272133,251687550550,105790,107990,108200,2410,2.28,110770,4980,4.71,105800,111070,1399-7-20
220,كوثر,بيمه كوثر,1428,5044467,76353810028,15392,14800,14623,-769,-5.0,15136,-256,-1.66,14623,15910,1399-7-20
221,فلوله,لوله‌وماشين‌سازي‌ايران‌,1415,6429628,162465550990,24080,25280,25280,1200,4.98,25270,1190,4.94,24740,25280,1399-7-20
222,تكشا,گسترش‌صنايع‌وخدمات‌كشاورزي‌,1401,1759787,151107508690,90100,85600,85600,-4500,-4.99,85870,-4230,-4.69,85600,89500,1399-7-20
223,اعتلا,شركت سرمايه گذاري اعتلاء البرز,1395,4482718,49582154803,10784,10500,10710,-74,-0.69,11061,277,2.57,10400,11300,1399-7-20
224,تكمبا,كمباين‌ سازي‌ ايران‌,1387,9028069,102986813180,11010,11560,11100,90,0.82,11410,400,3.63,10460,11560,1399-7-20
225,وگستر,گسترش سرمايه گذاري ايرانيان,1383,3625631,74915985935,19778,20170,20766,988,5.0,20663,885,4.47,20168,20766,1399-7-20
226,غگرجي,بيسكويت‌  گرجي‌,1371,2329053,75807765420,31770,32490,31500,-270,-0.85,32550,780,2.46,31190,33330,1399-7-20
227,بورس,بورس اوراق بهادار تهران,1370,2636194,153014081350,55300,58050,58060,2760,4.99,58040,2740,4.95,56400,58060,1399-7-20
228,اطلس,صندوق س.توسعه اندوخته آينده-س,1364,466834,96648566196,201128,206000,205311,4183,2.08,207030,5902,2.93,204010,209800,1399-7-20
229,ثباغ,شهر سازي و خانه سازي باغميشه,1345,6563004,172301923291,25022,26240,26273,1251,5.0,26254,1232,4.92,26000,26273,1399-7-20
230,قلرست,قند لرستان‌,1341,3977202,97250079570,25020,23770,23770,-1250,-5.0,24450,-570,-2.28,23770,26220,1399-7-20
231,جم پيلن,پلي پروپيلن جم - جم پيلن,1334,1209913,113907667850,94150,92100,92000,-2150,-2.28,94150,0,0.0,91000,97820,1399-7-20
232,قشكر,شكرشاهرود,1331,1446076,62222394780,42760,41020,42000,-760,-1.78,43030,270,0.63,41000,44890,1399-7-20
233,تايرا,تراكتورسازي‌ايران‌,1331,9187576,226529577680,22300,25000,24130,1830,8.21,24660,2360,10.58,23810,26250,1399-7-20
234,تسه9905,امتياز تسهيلات مسكن مرداد99,1319,34708,31618769361,941606,980000,894526,-47080,-5.0,910994,-30612,-3.25,894526,980000,1399-7-20
235,وملل تبعي9912,اختيارف.تبعي ملل 991220,1308,13384698,669234900,100,50,50,-50,-50.0,50,-50,-50.0,50,50,1399-7-20
236,كگازح,ح . شيشه‌ و گاز,1308,4070769,70189852250,16970,17100,16670,-300,-1.77,17240,270,1.59,16320,17770,1399-7-20
237,ارفعح,ح.شركت آهن و فولاد ارفع,1307,5218667,76799626699,14100,13760,14600,500,3.55,14716,616,4.37,13760,14805,1399-7-20
238,وآوا,سرمايه گذاري آوا نوين,1301,6248822,82203899128,12551,13178,12800,249,1.98,13155,604,4.81,12780,13178,1399-7-20
239,كشرق,صنعتي و معدني شمال شرق شاهرود,1299,1293538,84932169866,66929,66930,63583,-3346,-5.0,65659,-1270,-1.9,63583,68870,1399-7-20
240,شخارك,پتروشيمي‌ خارك‌,1299,2470037,114107769080,45170,45000,45590,420,0.93,46200,1030,2.28,44030,46980,1399-7-20
241,دشيمي,شيمي‌ داروئي‌ داروپخش‌,1295,3460104,240884682950,66320,69630,69630,3310,4.99,69620,3300,4.98,67100,69630,1399-7-20
242,رنيك,جنرال مكانيك,1287,3674512,96302280791,25141,25890,26000,859,3.42,26208,1067,4.24,25100,26398,1399-7-20
243,چدن,توليدي چدن سازان,1283,4268116,118259557520,26590,27000,27600,1010,3.8,27710,1120,4.21,25800,27910,1399-7-20
244,سخزر,سيمان‌ خزر,1262,2434608,67563614050,29060,28400,27610,-1450,-4.99,27750,-1310,-4.51,27610,29060,1399-7-20
245,كطبس,ذغال‌سنگ‌ نگين‌ ط‌بس‌,1259,3761901,186699750520,52100,49500,49500,-2600,-4.99,49630,-2470,-4.74,49500,53800,1399-7-20
246,فجر,فولاد اميركبيركاشان,1243,2940065,166662518930,55920,54000,55800,-120,-0.21,56690,770,1.38,54000,58600,1399-7-20
247,وبرق,س.کارکنان صنعت برق زنجان وقزوي,1228,810939,175166646108,210074,216376,209900,-174,-0.08,216005,5931,2.82,203820,216376,1399-7-20
248,فسرب,ملي‌ سرب‌وروي‌ ايران‌,1219,942012,148663133640,150540,158060,147600,-2940,-1.95,157810,7270,4.83,144000,158060,1399-7-20
249,وسين,بيمه سينا,1212,9969494,239277889577,24716,23975,23975,-741,-3.0,24001,-715,-2.89,23975,24780,1399-7-20
250,دانا,بيمه دانا,1196,10213328,79545212110,7440,7760,7610,170,2.28,7790,350,4.7,7350,7810,1399-7-20
251,بميلا,توسعه بازرگاني آهن وفولادميلاد,1180,4974791,173351309696,36540,34713,34713,-1827,-5.0,34846,-1694,-4.64,34713,35502,1399-7-20
252,ميدكو,هلدينگ صنايع  معدني خاورميانه,1162,6475117,144776680216,21529,21610,22490,961,4.46,22359,830,3.86,21610,22599,1399-7-20
253,شپارسح,ح . بين‌ المللي‌محصولات پارس‌,1161,4137835,52006463197,11721,12200,12150,429,3.66,12569,848,7.23,12140,12810,1399-7-20
254,پارسيانح,ح.بيمه پارسيان,1151,5317054,67005462620,13300,12940,12200,-1100,-8.27,12600,-700,-5.26,12050,13260,1399-7-20
255,ثپرديسح,ح.سرمايه گذاري مسكن پرديس,1147,4201304,36744125053,8394,8590,8520,126,1.5,8746,352,4.19,8010,8813,1399-7-20
256,دتوليد,داروسازي توليد دارو,1147,2856340,121102665510,40510,42535,42329,1819,4.49,42398,1888,4.66,41000,42535,1399-7-20
257,شفن,پتروشيمي فناوران,1146,459370,131012198600,286580,276000,278500,-8080,-2.82,285200,-1380,-0.48,276000,299000,1399-7-20
258,ولتجار,واسپاري تجارت وسرمايه ايرانيان,1132,8518001,57084267025,6757,6555,6630,-127,-1.88,6702,-55,-0.81,6555,6959,1399-7-20
259,كرماشا,صنايع پتروشيمي كرمانشاه,1118,2908052,131611826070,43580,44550,44500,920,2.11,45260,1680,3.85,42510,45750,1399-7-20
260,وهنر,گروه توسعه هنر ايران,1115,7824530,39177743932,4908,5055,4900,-8,-0.16,5007,99,2.02,4830,5055,1399-7-20
261,قصفها,قنداصفهان‌,1113,280191,52345377320,184410,189000,181900,-2510,-1.36,186820,2410,1.31,180110,193000,1399-7-20
262,كاردان,صندوق س تجارت شاخصي كاردان,1104,549943,108535950060,190390,192990,195800,5410,2.84,197360,6970,3.66,190010,200440,1399-7-20
263,قشير,قند شيروان قوچان و بجنورد,1095,3834774,100522396776,25001,26251,26090,1089,4.36,26213,1212,4.85,25000,26251,1399-7-20
264,پرديس,سرمايه گذاري پرديس,1093,7173497,60751785070,8130,8500,8270,140,1.72,8470,340,4.18,8150,8530,1399-7-20
265,فايرا,آلومينيوم‌ايران‌,1069,3367958,64121861270,18270,18300,18770,500,2.74,19040,770,4.21,18000,19180,1399-7-20
266,جم,پتروشيمي جم,1067,1620260,79203673550,47330,46000,48410,1080,2.28,48530,1200,2.54,46000,49510,1399-7-20
267,نوين,بيمه نوين,1063,12769975,78814891784,5880,6174,6170,290,4.93,6172,292,4.97,6000,6174,1399-7-20
268,كفرآور,فرآورده هاي سيمان شرق,1051,4968520,102423285207,20558,19942,21174,616,3.0,20614,56,0.27,19942,21174,1399-7-20
269,ثترانح,ح سرمايه گذاري مسكن تهران,1048,9537535,39341998213,3963,4027,4015,52,1.31,4125,162,4.09,3870,4161,1399-7-20
270,آ س پ,آ.س.پ,1041,4668567,67930543437,13928,13900,14600,672,4.82,14551,623,4.47,13900,14624,1399-7-20
271,نطرين,عطرين نخ قم,1040,4345359,74371930620,16326,17142,16030,-296,-1.81,17115,789,4.83,15700,17142,1399-7-20
272,شوينده,مديريت صنعت شوينده ت.ص.بهشهر,1039,1470798,69472777140,45460,46600,45490,30,0.07,47230,1770,3.89,43190,47730,1399-7-20
273,وتوسم,سرمايه‌گذاري‌توسعه‌ملي‌,1038,6014597,83168030280,13240,13600,13650,410,3.1,13830,590,4.46,13410,13900,1399-7-20
274,سپ,پرداخت الكترونيك سامان كيش,1036,1409653,33268654300,23030,23900,23040,10,0.04,23400,370,1.61,23040,23900,1399-7-20
275,سشمال,سيمان‌ شمال‌,1033,3082267,34642876220,11120,11670,10630,-490,-4.41,11200,80,0.72,10600,11670,1399-7-20
276,زشريف,كشت وصنعت شريف آباد,1031,1603687,41785406135,25934,25111,25501,-433,-1.67,26037,103,0.4,25111,26690,1399-7-20
277,سامان,بانك سامان,1029,44528619,469610581761,8218,10530,10215,1997,24.3,10546,2328,28.33,10215,10845,1399-7-20
278,سشرق,سيمان‌ شرق‌,1026,6036704,51141452720,8080,8480,8480,400,4.95,8450,370,4.58,8270,8480,1399-7-20
279,مبين,مبين انرژي خليج فارس,1025,7155465,201920300330,27010,27250,27440,430,1.59,28220,1210,4.48,27000,28360,1399-7-20
280,داوه,داروسازي آوه سينا,1020,1751836,32731360189,17868,18690,18630,762,4.26,18374,506,2.83,18020,18761,1399-7-20
281,بفجر,فجر انرژي خليج فارس,1007,4604650,158686129630,32970,34200,33990,1020,3.09,34460,1490,4.52,33900,34610,1399-7-20
282,غفارس,شير پاستوريزه پگاه فارس,1003,4379304,44937016353,9783,10250,10266,483,4.94,10194,411,4.2,10080,10272,1399-7-20
283,سپاس2,صندوق س. پاداش سهامداري توسعه1,1000,100000000,100000000,10030,1,1,-10029,-99.99,1,-10029,-99.99,1,1,1399-7-20
284,ركيش,كارت اعتباري ايران كيش,999,8092036,128971460450,15240,16000,15340,100,0.66,15940,700,4.59,15240,16000,1399-7-20
285,گشان,توسعه بين المللي پديده شانديز,997,170445,39914639655,238958,234179,234179,-4779,-2.0,235053,-3905,-1.63,234179,234179,1399-7-20
286,كاريس,صندوق س.سپهر كاريزما-س,997,757117,169700328936,214397,215000,223000,8603,4.01,224140,9743,4.54,215000,228000,1399-7-20
287,كپشير,پشم‌شيشه‌ايران‌,986,2098329,38535499350,17650,18530,17690,40,0.23,18170,520,2.95,16770,18530,1399-7-20
288,خزر,فنرسازي‌زر,973,6420785,58350899000,8670,9100,9010,340,3.92,9090,420,4.84,8700,9100,1399-7-20
289,خفولا,خدمات فني فولاد يزد,971,2467066,71203286186,29036,29907,28165,-871,-3.0,28862,-174,-0.6,28165,29907,1399-7-20
290,شيراز,پتروشيمي‌شيراز,970,1714947,107723365990,60260,60020,61800,1540,2.56,62810,2550,4.23,60020,63270,1399-7-20
291,غمينو,شركت صنايع غذايي مينو شرق,951,2608956,39446121440,14429,15150,15150,721,5.0,14939,510,3.53,14910,15150,1399-7-20
292,قنيشا,قند  نيشابور,951,1153586,111826200900,101980,96890,96890,-5090,-4.99,96940,-5040,-4.94,96890,100000,1399-7-20
293,غگل,گلوكوزان‌,947,9725881,54659451220,5360,5620,5620,260,4.85,5620,260,4.85,5620,5620,1399-7-20
294,آتيمس,صندوق س.آرمان آتيه درخشان مس-س,944,307317,70096506974,222097,223200,225555,3458,1.56,228092,5995,2.7,223121,230500,1399-7-20
295,شپارس,بين‌ المللي‌ محصولات‌  پارس‌,944,4943022,78501151370,15150,15900,15680,530,3.5,15880,730,4.82,15600,15900,1399-7-20
296,لوتوس,تامين سرمايه لوتوس پارسيان,943,3769353,61345755630,15600,16080,16270,670,4.29,16270,670,4.29,15750,16380,1399-7-20
297,بنيرو,نيروترانس‌,930,751727,46404863090,60810,57810,60000,-810,-1.33,61690,880,1.45,57810,63850,1399-7-20
298,ولصنم,ليزينگ‌صنعت‌ومعدن‌,927,5239759,50551770290,9200,9660,9500,300,3.26,9620,420,4.57,9400,9660,1399-7-20
299,كلر,كلر پارس,925,817218,55479295584,64656,67888,67888,3232,5.0,67888,3232,5.0,67888,67888,1399-7-20
300,ولشرق,ليزينگ ايران و شرق,913,11732682,97288111975,7970,8035,7960,-10,-0.13,8292,322,4.04,7625,8368,1399-7-20
301,تسه9902,امتياز تسهيلات مسكن ارديبهشت99,912,14004,12841765804,923037,969188,900000,-23037,-2.5,917007,-6030,-0.65,880111,969188,1399-7-20
302,قثابت,قند ثابت‌ خراسان‌,907,1482829,138731474260,89110,93560,93540,4430,4.97,93560,4450,4.99,93540,93560,1399-7-20
303,لسرما,سرما آفرين‌,905,1516979,34554211410,23510,22450,22340,-1170,-4.98,22990,-520,-2.21,22340,23990,1399-7-20
304,سغرب,سيمان‌غرب‌,901,1708179,35558164280,21150,21000,20110,-1040,-4.92,20910,-240,-1.13,20100,21780,1399-7-20
305,دالبر,البرزدارو,901,2033175,43840338870,20660,21150,21630,970,4.7,21410,750,3.63,20800,21690,1399-7-20
306,وزمين,بانك ايران زمين,901,25616978,374648303250,15234,14625,14625,-609,-4.0,14625,-609,-4.0,14625,14625,1399-7-20
307,ياقوت,صندوق س ياقوت آگاه-ثابت,900,40590679,451384350890,11120,11130,11120,0,0.0,11120,0,0.0,11120,11140,1399-7-20
308,شلعاب,لعابيران‌,899,1726292,14845425060,8600,8500,8310,-290,-3.37,8600,0,0.0,8240,8850,1399-7-20
309,كمينا,شيشه سازي مينا,895,2816018,87296682426,31791,30838,30838,-953,-3.0,31000,-791,-2.49,30838,32499,1399-7-20
310,غبشهر,صنعتي‌ بهشهر,893,4427386,116587269290,25140,26390,26390,1250,4.97,26330,1190,4.73,25600,26390,1399-7-20
311,پارتا,مجتمع‌صنعتي‌آرتاويل‌تاير,892,1809665,105313007430,59898,58102,58102,-1796,-3.0,58195,-1703,-2.84,58102,59838,1399-7-20
312,زشگزا,شير و گوشت زاگرس شهركرد,884,488844,48750852240,99662,98950,96499,-3163,-3.17,99725,63,0.06,94679,103000,1399-7-20
313,فيروزه,صندوق شاخص30 شركت فيروزه- سهام,882,418815,83477299010,194620,194600,196000,1380,0.71,199320,4700,2.41,194600,202000,1399-7-20
314,كي بي سي,شركت كي بي سي,876,1233951,44836104691,36927,38600,35200,-1727,-4.68,36402,-525,-1.42,35081,38750,1399-7-20
315,ضخود1044,اختيارخ خودرو-4000-1399/10/07,873,31300,12737926000,280,370,370,90,32.14,407,127,45.36,320,460,1399-7-20
316,شاملاح,ح . معدني‌ املاح‌  ايران‌,871,660286,42704295540,66300,66200,64000,-2300,-3.47,64680,-1620,-2.44,59670,71500,1399-7-20
317,پارس,پتروشيمي پارس,867,799575,129762240460,159330,165500,160720,1390,0.87,162290,2960,1.86,157000,165500,1399-7-20
318,كهمدا,شيشه‌ همدان‌,867,2527600,67616350140,25490,26760,26500,1010,3.96,26750,1260,4.94,26120,26760,1399-7-20
319,فسپا,گروه‌صنعتي‌سپاهان‌,864,1751274,83615542290,46060,45000,47000,940,2.04,47750,1690,3.67,45000,48360,1399-7-20
320,زماهان,مجتمع توليد گوشت مرغ ماهان,864,1508724,38774532718,25820,26190,25380,-440,-1.7,25730,-90,-0.35,24529,26800,1399-7-20
321,شبصير,توليدات پتروشيمي قائد بصير,840,649893,88777039516,136410,137000,132100,-4310,-3.16,136603,193,0.14,130590,139978,1399-7-20
322,ساينا,صنايع بهداشتي ساينا,832,348901,79463820345,218216,207502,229123,10907,5.0,227755,9539,4.37,207502,229126,1399-7-20
323,كهرام,توليدي گرانيت بهسرام,831,2094220,116901508849,56608,54910,55001,-1607,-2.84,55821,-787,-1.39,54910,58000,1399-7-20
324,غشهداب,كشت و صنعت شهداب ناب خراسان,831,8881393,49877903088,5349,5616,5616,267,4.99,5595,246,4.6,5616,5616,1399-7-20
325,دبالك,مواد اوليه دارويي البرز بالك,825,3310369,56735493662,16384,17090,16600,216,1.32,17139,755,4.61,16600,17203,1399-7-20
326,غچين,كشت‌ و صنعت‌ چين‌ چين,825,636987,29523203360,46780,47500,44670,-2110,-4.51,46520,-260,-0.56,44550,47500,1399-7-20
327,هجرت,پخش هجرت,818,567139,36189564031,63118,62530,61401,-1717,-2.72,63592,474,0.75,61400,66270,1399-7-20
328,وملي,گروه‌ صنعتي‌ ملي‌ (هلدينگ‌,815,144196,64073492600,467730,444350,444350,-23380,-5.0,444350,-23380,-5.0,444350,444350,1399-7-20
329,ميهن,بيمه ميهن,814,10565481,59133096609,5352,5619,5540,188,3.51,5597,245,4.58,5360,5619,1399-7-20
330,سصفها,سيمان‌اصفهان‌,809,767994,86383061550,107260,111900,112620,5360,5.0,112480,5220,4.87,107260,112620,1399-7-20
331,شپاكسا,پاكسان‌,804,2651636,80016166010,28820,30100,28990,170,0.59,30180,1360,4.72,28500,30260,1399-7-20
332,رتاپ,تجارت الكترونيك  پارسيان,801,4940514,34879365970,6730,7060,7060,330,4.9,6940,210,3.12,7040,7060,1399-7-20
333,پارند,صندوق س. پارند پايدار سپهر,801,21982372,261415175700,11830,11830,11900,70,0.59,11890,60,0.51,11830,11920,1399-7-20
334,وسخراش,شركت س استان خراسان شمالي,796,12728611,17942222640,1420,1470,1380,-40,-2.82,1420,0,0.0,1370,1470,1399-7-20
335,شاوان,پالايش نفت لاوان,795,998844,116247409381,111017,116567,114610,3593,3.24,116382,5365,4.83,111750,116567,1399-7-20
336,غدام,خوراك‌  دام‌ پارس‌,785,939110,155433041170,157790,161670,165600,7810,4.95,165510,7720,4.89,160670,165670,1399-7-20
337,كساوه,صنايع‌ كاشي‌ و سراميك‌ سينا,785,1606014,75013548840,43490,47000,47200,3710,8.53,46710,3220,7.4,44800,48000,1399-7-20
338,گوهر,صندوق سكه طلاي كيان,784,518428,41089950380,76577,80000,78250,1673,2.18,79259,2682,3.5,78000,80606,1399-7-20
339,دسبحاح,ح .گروه دارويي سبحان,770,1145911,20356841590,16590,18000,17800,1210,7.29,17760,1170,7.05,16660,18000,1399-7-20
340,حتايد,تايدواترخاورميانه,767,5795069,106072186690,17580,17800,18090,510,2.9,18300,720,4.1,17620,18450,1399-7-20
341,زكشت,كشاورزي مكانيزه اصفهان كشت,767,1580435,50540983967,30569,32000,31500,931,3.05,31971,1402,4.59,31020,32097,1399-7-20
342,تاپكيش,تجارت الكترونيك پارسيان كيش,764,2786001,32365468024,11074,11627,11627,553,4.99,11403,329,2.97,11288,11627,1399-7-20
343,شدوص,دوده‌ صنعتي‌ پارس‌,764,1746381,34350957160,20060,20060,19320,-740,-3.69,19780,-280,-1.4,19060,20760,1399-7-20
344,دتمادح,ح . توليدمواداوليه‌داروپخش‌,763,672061,31455447780,46300,47000,46550,250,0.54,46800,500,1.08,46400,47880,1399-7-20
345,واتي,سرمايه‌ گذاري‌ آتيه‌ دماوند,759,8793812,127817156560,13890,14480,14200,310,2.23,14530,640,4.61,14010,14580,1399-7-20
346,وسقم,شركت س استان قم,749,8560350,12284957180,1390,1440,1440,50,3.6,1400,10,0.72,1340,1450,1399-7-20
347,وسناح,ح. سرمايه گذاري نيروگاهي ايران,746,2178761,27567142639,12504,12130,12726,222,1.78,12653,149,1.19,12129,12879,1399-7-20
348,سرود,سيمان‌شاهرود,745,2300319,38494189300,16090,16870,16000,-90,-0.56,16560,470,2.92,15620,16890,1399-7-20
349,دامين,داروسازي‌ امين‌,740,1950489,28173341810,13860,14280,14400,540,3.9,14170,310,2.24,14210,14550,1399-7-20
350,گوهران,سرمايه گذاري توسعه گوهران اميد,739,2950592,28576434044,9464,9544,9630,166,1.75,9588,124,1.31,9541,9780,1399-7-20
351,تسه9903,امتياز تسهيلات مسكن خرداد99,737,6189,5695555870,931335,977901,900111,-31224,-3.35,920271,-11064,-1.19,885000,977901,1399-7-20
352,تسه9810,امتياز تسهيلات مسكن دي98,728,13166,12111772795,921107,967162,890001,-31106,-3.38,919928,-1179,-0.13,876000,967162,1399-7-20
353,رتكو,كنترل‌خوردگي‌تكين‌كو,724,2845731,50560123860,18560,18620,17690,-870,-4.69,17770,-790,-4.26,17690,18620,1399-7-20
354,حآسا,آسيا سير ارس,722,3481383,42815095083,11785,12373,12374,589,5.0,12206,421,3.57,11941,12374,1399-7-20
355,فپنتا,سپنتا,721,106074,33444170210,324170,307970,310070,-14100,-4.35,317780,-6390,-1.97,307970,332000,1399-7-20
356,دسبحا,گروه دارويي سبحان,719,1829190,34502171670,18520,18900,18210,-310,-1.67,18750,230,1.24,17600,19400,1399-7-20
357,بكام,كارخانجات توليدي شهيد قندي,711,9013921,52821577060,5590,5860,5860,270,4.83,5860,270,4.83,5860,5860,1399-7-20
358,حپارسا,توسعه حمل و نقل ريلي پارسيان,706,1516514,51359127453,32706,33880,33640,934,2.86,33867,1161,3.55,32510,34341,1399-7-20
359,پكرمان,گروه‌ صنعتي‌ بارز,702,5524928,146567524430,25280,26380,26500,1220,4.83,26530,1250,4.94,25610,26540,1399-7-20
360,آساس,صندوق س.آسمان آرماني سهام-س,694,424781,72800883756,168065,169450,168920,855,0.51,171385,3320,1.98,168805,172976,1399-7-20
361,شنفت,نفت‌ پارس‌,693,2044576,118177606510,55260,56490,58020,2760,4.99,57800,2540,4.6,55300,58020,1399-7-20
362,خاور,ايران خودرو ديزل,685,8682441,59605507998,7125,6900,6693,-432,-6.06,6865,-260,-3.65,6693,6900,1399-7-20
363,شگل,گلتاش‌,676,1660647,48606977490,28300,29190,28680,380,1.34,29200,900,3.18,28010,29710,1399-7-20
364,سخاش,سيمان‌خاش‌,673,283822,21526014560,76850,73800,74120,-2730,-3.55,76410,-440,-0.57,73800,78000,1399-7-20
365,دسبحان,سبحان دارو,672,1446048,27633977280,18200,19110,19110,910,5.0,18640,440,2.42,19110,19110,1399-7-20
366,داسوه,داروسازي‌ اسوه‌,672,946440,27967616210,30280,31300,28770,-1510,-4.99,29860,-420,-1.39,28770,31300,1399-7-20
367,سبهان,سيمان‌ بهبهان‌,671,350960,22128252390,63390,64000,60900,-2490,-3.93,63240,-150,-0.24,60840,65000,1399-7-20
368,ولبهمن,شركت بهمن ليزينگ,658,17245333,170762315690,9431,9902,9902,471,4.99,9902,471,4.99,9800,9902,1399-7-20
369,ومعلم,بيمه معلم,656,4095915,26312359865,6129,6435,6374,245,4.0,6275,146,2.38,6250,6435,1399-7-20
370,ملت,بيمه ملت,654,4984892,69215451770,13230,13890,13890,660,4.99,13890,660,4.99,13500,13890,1399-7-20
371,فخاس,فولاد خراسان,652,984617,37170152420,37800,36300,36800,-1000,-2.65,37780,-20,-0.05,36300,39500,1399-7-20
372,وآفري,بيمه كارآفرين,652,5769430,98289734594,17533,17008,17008,-525,-2.99,17036,-497,-2.83,17008,17533,1399-7-20
373,خلنت,لنت‌ ترمزايران‌,651,396897,38766595290,96320,97000,95500,-820,-0.85,97370,1050,1.09,92000,101130,1399-7-20
374,وبشهر,توسعه‌ صنايع‌ بهشهر(هلدينگ,647,6320296,124381407120,18750,19680,19600,850,4.53,19680,930,4.96,19230,19680,1399-7-20
375,دكپسول,توليد ژلاتين كپسول ايران,642,650682,24778768818,37851,38500,37600,-251,-0.66,37965,114,0.3,36701,39365,1399-7-20
376,خراسان,پتروشيمي خراسان,634,933941,84678629840,87610,90800,90450,2840,3.24,90670,3060,3.49,88240,91990,1399-7-20
377,قزوين,كارخانجات‌ قند قزوين‌,634,1035678,35857774520,33720,33650,33800,80,0.24,34380,660,1.96,33650,35290,1399-7-20
378,افق ملت,صندوق س در سهام افق ملت,630,267154,39999988880,145660,149900,149000,3340,2.29,149730,4070,2.79,145000,151500,1399-7-20
379,زگلدشت,كشت و دام گلدشت نمونه اصفهان,630,441283,16603181566,37456,36400,37220,-236,-0.63,37513,57,0.15,36400,38940,1399-7-20
380,كرمان,س. توسعه و عمران استان كرمان,628,1118765,93576860895,79660,83643,83643,3983,5.0,83643,3983,5.0,83643,83643,1399-7-20
381,كمنگنز,معادن‌منگنزايران‌,625,1429430,154933144690,103480,105990,108000,4520,4.37,108390,4910,4.74,103480,108650,1399-7-20
382,خديزل,بهمن  ديزل,625,2004616,97781659088,48106,48497,49050,944,1.96,48778,672,1.4,46003,49990,1399-7-20
383,ولملت,واسپاري ملت,623,2332089,23993148910,10140,9770,10000,-140,-1.38,10210,70,0.69,9770,10590,1399-7-20
384,فاما,صنعتي‌ آما,622,1284827,29289878430,21870,22960,21800,-70,-0.32,22380,510,2.33,20780,22960,1399-7-20
385,سمازن,سيمان‌مازندران‌,614,3757903,37428713880,9490,9960,9960,470,4.95,9810,320,3.37,9960,9960,1399-7-20
386,دفرا,فرآورده‌هاي‌ تزريقي‌ ايران‌,604,956869,25545523950,26480,27300,26140,-340,-1.28,26590,110,0.42,26020,27400,1399-7-20
387,دارا,صندوق س. دارا الگوريتم-د,602,20347106,204617591214,10039,10032,10068,29,0.29,10056,17,0.17,10031,10075,1399-7-20
388,فباهنر,مس‌ شهيدباهنر,601,1134031,65013390930,54650,57360,57380,2730,5.0,57330,2680,4.9,56000,57380,1399-7-20
389,تسه9901,امتياز تسهيلات مسكن فروردين99,592,7322,6684715873,940213,940000,900000,-40213,-4.28,912963,-27250,-2.9,893203,987223,1399-7-20
390,خرينگ,رينگ‌سازي‌مشهد,592,1741996,47807290980,26170,27470,27470,1300,4.97,27310,1140,4.36,26000,27470,1399-7-20
391,فرآور,فرآوري‌موادمعدني‌ايران‌,589,2824478,67807481680,22870,24010,24010,1140,4.98,24010,1140,4.98,23120,24010,1399-7-20
392,غشصفا,شيرپاستوريزه‌پگاه‌اصفهان‌,577,1262625,41193448950,31140,32690,32690,1550,4.98,32270,1130,3.63,31850,32690,1399-7-20
393,ولانا,شركت ليزينگ آريا دانا,565,1767334,37225785652,21665,21016,21016,-649,-3.0,21063,-602,-2.78,21016,21633,1399-7-20
394,غپآذر,شير پگاه آذربايجان شرقي,561,397758,21532287900,56291,53477,53477,-2814,-5.0,55322,-969,-1.72,53477,55700,1399-7-20
395,شراز,پالايش نفت شيراز,555,887845,102547880753,110146,114000,115652,5506,5.0,115502,5356,4.86,110000,115653,1399-7-20
396,كپشيرح,ح . پشم‌شيشه‌ايران‌,554,2434322,33941346392,2420,15000,13520,11100,458.68,13943,11523,476.16,13500,15001,1399-7-20
397,ثاخت,بين‌المللي‌توسعه‌ساختمان,551,7636225,35355721750,4410,4630,4630,220,4.99,4550,140,3.17,4630,4630,1399-7-20
398,ثاصفا,شركت‌ ساختمان‌ اصفهان‌,547,1147932,33425889997,29948,29050,29050,-898,-3.0,29118,-830,-2.77,29050,29500,1399-7-20
399,قچار,فراوردههاي غذايي وقند چهارمحال,541,282849,58612162679,200396,203990,210000,9604,4.79,207221,6825,3.41,195200,210415,1399-7-20
400,تسه9812,امتياز تسهيلات مسكن اسفند98,539,5775,5287112095,931402,977972,896000,-35402,-3.8,915517,-15885,-1.71,884832,977972,1399-7-20
401,پكوير,كوير تاير,537,3863360,57718598400,14230,14940,14940,710,4.99,14940,710,4.99,14940,14940,1399-7-20
402,واحيا,م .صنايع و معادن احياء سپاهان,536,880475,180129173293,199194,194100,202600,3406,1.71,204582,5388,2.7,194100,205169,1399-7-20
403,حسينا,توسعه خدمات دريايي وبندري سينا,535,1801852,111036466543,59141,61000,62098,2957,5.0,61624,2483,4.2,56184,62098,1399-7-20
404,سكرما,سيمان‌ كرمان‌,530,2747146,44089833710,15390,16150,15900,510,3.31,15930,540,3.51,15400,16150,1399-7-20
405,دكيمي,كيميدارو,523,1182630,28140850910,23750,22720,23990,240,1.01,23780,30,0.13,22720,24650,1399-7-20
406,وكادو,تكادو,519,4409366,84743931170,18661,19220,19220,559,3.0,19219,558,2.99,18980,19220,1399-7-20
407,بالبر,كابل‌ البرز,519,1068368,26697510800,25340,26400,24300,-1040,-4.1,25150,-190,-0.75,24130,26400,1399-7-20
408,اعتلاح,ح سرمايه گذاري اعتلاء البرز,514,1630705,12814079194,7531,7260,7700,169,2.24,7858,327,4.34,7260,7907,1399-7-20
409,دابور,داروسازي‌ ابوريحان‌,509,1319112,61474788700,44400,46620,46620,2220,5.0,46600,2200,4.95,45150,46620,1399-7-20
410,ماديرا,صنايع ماشين هاي اداري ايران,505,2692977,104115876774,36821,38662,38662,1841,5.0,38662,1841,5.0,38662,38662,1399-7-20
411,كپارس,كاشي‌ پارس‌,494,873285,82425216140,89900,94390,94390,4490,4.99,94390,4490,4.99,94200,94390,1399-7-20
412,مفاخر,توسعه فناوري اطلاعات خوارزمي,491,2415410,127150914748,50555,50555,52999,2444,4.83,52642,2087,4.13,50555,53082,1399-7-20
413,حاريا,كشتيراني آريا,489,2525602,82725157218,33764,32752,32752,-1012,-3.0,32755,-1009,-2.99,32752,33000,1399-7-20
414,غسالم,سالمين‌,488,3872659,19247115230,4740,4970,4970,230,4.85,4820,80,1.69,4970,4970,1399-7-20
415,شيران,س. صنايع‌شيميايي‌ايران,474,2764317,93931491660,32370,33980,33980,1610,4.97,33750,1380,4.26,33980,33980,1399-7-20
416,تسه9811,امتياز تسهيلات مسكن بهمن98,474,5985,5506253923,927542,920522,910000,-17542,-1.89,920009,-7533,-0.81,882000,947999,1399-7-20
417,كروي,توسعه‌ معادن‌ روي‌ ايران‌,472,3857939,134989285610,33330,34990,34990,1660,4.98,34990,1660,4.98,34990,34990,1399-7-20
418,سدور,سيمان‌ دورود,464,4425267,38321595110,8250,8660,8660,410,4.97,8540,290,3.52,8460,8660,1399-7-20
419,شفا,سرمايه گذاري شفادارو,458,1377141,97470095330,67560,69970,70000,2440,3.61,70780,3220,4.77,67580,70930,1399-7-20
420,وآيند,بانك  آينده,458,10119009,291872695596,28279,28844,28844,565,2.0,28844,565,2.0,28844,28844,1399-7-20
421,سهرمز,سيمان‌هرمزگان‌,453,873157,15090143330,17160,17500,16820,-340,-1.98,17200,40,0.23,16500,17940,1399-7-20
422,دسينا,داروسازي‌ سينا,453,621882,17824710370,27500,28500,28100,600,2.18,27900,400,1.45,27600,28870,1399-7-20
423,تسه9711,امتياز تسهيلات مسكن بهمن 97,449,5281,4887522112,911784,957373,880456,-31328,-3.44,925492,13708,1.5,867000,957373,1399-7-20
424,دروز,داروسازي‌ روزدارو,449,750746,13871239130,19280,18320,18320,-960,-4.98,19050,-230,-1.19,18320,19000,1399-7-20
425,پسهند,صنايع‌ لاستيكي‌  سهند,448,481178,25658885740,54460,52500,51750,-2710,-4.98,53870,-590,-1.08,51740,56480,1399-7-20
426,كيان,صندوق س. با درآمد ثابت كيان,448,12024404,306559188020,25470,25490,25500,30,0.12,25490,20,0.08,25480,25510,1399-7-20
427,بسويچ,پارس‌سويچ‌,445,535644,22942216350,44930,42690,42690,-2240,-4.99,43920,-1010,-2.25,42690,44490,1399-7-20
428,كاسپينح,ح .داروسازي كاسپين تامين,444,921546,23107488105,23994,25192,24720,726,3.03,25075,1081,4.51,24500,25193,1399-7-20
429,كدماح,ح . معدني‌ دماوند,439,525596,67612669440,116950,128640,128640,11690,10.0,128640,11690,10.0,128640,128640,1399-7-20
430,دپارس,پارس‌ دارو,436,1576185,171132874650,103460,106900,108630,5170,5.0,108570,5110,4.94,101000,108630,1399-7-20
431,وشهر,بانك شهر,431,6232478,55001618350,9192,8825,8825,-367,-3.99,8825,-367,-3.99,8825,8825,1399-7-20
432,غپونه,نوش پونه مشهد,431,1090793,18371077582,16451,16940,16400,-51,-0.31,16799,348,2.12,16300,16944,1399-7-20
433,زفكا,كشت و دامداري فكا,431,943494,39873602782,40331,42347,41720,1389,3.44,41770,1439,3.57,41410,42347,1399-7-20
434,تسه9803,امتياز تسهيلات مسكن خرداد98,429,3686,3359939383,905028,950000,893010,-12018,-1.33,911541,6513,0.72,859778,950279,1399-7-20
435,واحصا,احياء صنايع خراسان,429,1626406,29328640186,17627,17100,18100,473,2.68,18033,406,2.3,17099,18155,1399-7-20
436,حريل,ريل پردازسير,426,13879047,57945021225,3977,4175,4175,198,4.98,4175,198,4.98,4175,4175,1399-7-20
437,كخاكح,ح . صنايع‌خاك‌چيني‌ايران‌,424,587917,27046394030,45210,45190,44630,-580,-1.28,46000,790,1.75,44020,47680,1399-7-20
438,سقاين,سيمان‌ قائن‌,423,888301,37509879640,42870,41530,42000,-870,-2.03,42380,-490,-1.14,41350,43500,1399-7-20
439,تسه9712,امتياز تسهيلات مسكن اسفند97,423,3529,3294871848,892778,937416,880000,-12778,-1.43,933656,40878,4.58,850005,937416,1399-7-20
440,بخاور,بيمه زندگي خاورميانه,423,5882431,45590693468,7384,7753,7700,316,4.28,7694,310,4.2,7550,7753,1399-7-20
441,غپينو,پارس‌ مينو,421,4145581,28770332140,6610,6940,6940,330,4.99,6790,180,2.72,6940,6940,1399-7-20
442,ثالوند,سرمايه گذاري مسكن الوند,414,3483197,46189654005,12682,12300,13316,634,5.0,13210,528,4.16,12300,13316,1399-7-20
443,كحافظ,كاشي‌ وسراميك‌ حافظ‌,414,1736877,40243440090,22070,23170,23170,1100,4.98,22880,810,3.67,23170,23170,1399-7-20
444,تسه9801,امتياز تسهيلات مسكن فروردين98,410,3837,3524444760,918313,930228,899990,-18323,-2.0,918542,229,0.02,872400,964228,1399-7-20
445,ونيروح,ح . سرمايه‌گذاري‌نيرو,410,15984406,64525611530,4300,4730,4730,430,10.0,4040,-260,-6.05,4000,4730,1399-7-20
446,شتوكا,توكا رنگ فولاد سپاهان,403,418265,12487705495,28775,30040,29300,525,1.82,29036,261,0.91,28775,30200,1399-7-20
447,تسه9709,امتياز تسهيلات مسكن آذر97,402,5280,4822850492,916332,962148,878122,-38210,-4.17,913419,-2913,-0.32,871300,962148,1399-7-20
448,شاملا,معدني‌ املاح‌  ايران‌,402,274851,19674775670,73840,75970,70160,-3680,-4.98,72920,-920,-1.25,70160,75970,1399-7-20
449,شلرد,كود شيميايي اوره لردگان,400,3886461,38417666985,9598,9885,9885,287,2.99,9885,287,2.99,9885,9885,1399-7-20
450,تسه9708,امتياز تسهيلات مسكن آبان97,399,5562,5095799410,914877,926010,877022,-37855,-4.14,916181,1304,0.14,870000,956000,1399-7-20
451,زعف9908پ10,زعفران9908نگين طلاي سرخ(پ),398,411559,41638749096,96556,99600,101383,4827,5.0,101173,4617,4.78,99000,101383,1399-7-20
452,تسه9802,امتياز تسهيلات مسكن ارديبهشت98,396,3679,3376639430,916526,918900,890000,-26526,-2.89,917814,1288,0.14,870700,962352,1399-7-20
453,تسه9710,امتياز تسهيلات مسكن دي 97,396,3899,3599872642,930638,930010,885000,-45638,-4.9,923281,-7357,-0.79,884107,950000,1399-7-20
454,سفار,سيمان‌فارس‌,396,120108,11644921520,97400,100960,93800,-3600,-3.7,97290,-110,-0.11,93000,100960,1399-7-20
455,دزهراوي,داروسازي‌زهراوي‌,391,2325028,26900573960,11020,11570,11570,550,4.99,11300,280,2.54,11570,11570,1399-7-20
456,وصنا,گروه‌صنايع‌بهشهرايران‌,390,5577213,61962836430,10590,11110,11110,520,4.91,11110,520,4.91,11110,11110,1399-7-20
457,تسه9809,امتياز تسهيلات مسكن آذر98,388,4352,3980762334,924828,912222,878800,-46028,-4.98,914697,-10131,-1.1,878587,950000,1399-7-20
458,كتوكا,توليدي و خدمات صنايع نسوز توكا,387,368171,50277063589,143746,136559,136559,-7187,-5.0,136559,-7187,-5.0,136559,136559,1399-7-20
459,لابسا,آبسال‌,386,938669,30314932180,30790,32320,32280,1490,4.84,31650,860,2.79,29310,32320,1399-7-20
460,زمگسا,كشاورزي‌ ودامپروي‌ مگسال‌,386,1741119,49010767040,26820,28130,28160,1340,5.0,28060,1240,4.62,27140,28160,1399-7-20
461,بمپنا,توليد برق عسلويه  مپنا,386,105818,9476595457,90309,87200,89239,-1070,-1.18,90165,-144,-0.16,87200,93000,1399-7-20
462,كخاك,صنايع‌خاك‌چيني‌ايران‌,381,162215,8452693140,52190,50210,51000,-1190,-2.28,52180,-10,-0.02,50210,53500,1399-7-20
463,وارس,سرمايه گذاري ارس صبا,376,617320,62216857650,103756,100644,100644,-3112,-3.0,100785,-2971,-2.86,100644,103750,1399-7-20
464,ددام,داروسازي زاگرس فارمد پارس,375,1511062,21638275840,13640,14320,14320,680,4.99,13910,270,1.98,14300,14320,1399-7-20
465,لپارس,پارس‌ الكتريك‌,375,50557,17701522410,368550,350130,350130,-18420,-5.0,361640,-6910,-1.87,350130,350130,1399-7-20
466,زپارس,ملي كشت و صنعت و دامپروري پارس,371,284400,19941216820,69570,70000,68500,-1070,-1.54,69790,220,0.32,68060,72790,1399-7-20
467,زقيام,كشت و دام قيام اصفهان,369,1406140,40005226568,27097,28451,28451,1354,5.0,28146,1049,3.87,28350,28451,1399-7-20
468,ثنورح,ح . سرمايه گذاري كوه نور,368,11992203,60904561598,4817,5106,5106,289,6.0,5079,262,5.44,5000,5106,1399-7-20
469,كپرور,فرآوري زغال سنگ پروده طبس,361,681620,30606066333,42769,44907,44900,2131,4.98,43955,1186,2.77,43620,44907,1399-7-20
470,كفرا,فراورده‌ هاي‌ نسوزايران‌,358,672134,30272915360,42900,45040,45040,2140,4.99,44120,1220,2.84,45040,45040,1399-7-20
471,غمهرا,توليدي‌مهرام‌,352,170909,18387755710,109750,104270,105000,-4750,-4.33,108940,-810,-0.74,104270,113990,1399-7-20
472,سكه9912پ04,سكه تمام بهارتحويل1روزه صادرات,349,280800,436400560900,1480133,1554139,1554139,74006,5.0,1554133,74000,5.0,1550000,1554139,1399-7-20
473,گپارس,امور رفاهي كارگزاران پارس,348,277256,30941693109,114758,111400,111320,-3438,-3.0,111600,-3158,-2.75,111316,117589,1399-7-20
474,پكويرح,ح. كوير تاير,343,6234085,78128659400,12180,12200,12500,320,2.63,12530,350,2.87,12200,13400,1399-7-20
475,آريان,سرمايه گذاري پارس آريان,339,14575259,220261314008,14672,15112,15112,440,3.0,15112,440,3.0,15112,15112,1399-7-20
476,بهپاك,صنعتي بهپاك,332,1352156,48021820340,33824,35515,35515,1691,5.0,35297,1473,4.35,35515,35515,1399-7-20
477,تسه9808,امتياز تسهيلات مسكن آبان98,331,4707,4289976202,929525,912000,898195,-31330,-3.37,911403,-18122,-1.95,883049,976001,1399-7-20
478,شجم,صنايع پتروشيمي تخت جمشيد,331,3359753,28801893278,8325,8574,8573,248,2.98,8573,248,2.98,8400,8574,1399-7-20
479,ودي,بيمه  دي,328,11889831,254299705428,20370,21388,21388,1018,5.0,21388,1018,5.0,21388,21388,1399-7-20
480,حخزر,كشتيراني درياي خزر,325,759494,18244142532,23115,24270,23110,-5,-0.02,23430,315,1.36,23110,24270,1399-7-20
481,كگلح,ح . معدني و صنعتي گل گهر,320,15128031,310141424520,20250,20250,20500,250,1.23,20500,250,1.23,20250,21280,1399-7-20
482,سبجنو,سيمان‌ بجنورد,319,667649,21884635240,32790,33190,32880,90,0.27,32790,0,0.0,32110,33190,1399-7-20
483,سصوفي,سيمان‌ صوفيان‌,319,1540977,22621542360,13990,14680,14680,690,4.93,14280,290,2.07,14680,14680,1399-7-20
484,ضصاد8024,اختيارخ وبصادر-5500-1399/08/11,318,15545,2733166000,142,195,135,-7,-4.93,176,34,23.94,130,200,1399-7-20
485,قهكمت,قندهكمتان‌,316,1322857,61161198960,44220,45900,46430,2210,5.0,46230,2010,4.55,44370,46430,1399-7-20
486,هصيكو402,اختيارف ت تاصيكو13500-00/02/20,315,1049379,1021045767,689,973,973,284,41.22,973,284,41.22,973,973,1399-7-20
487,ستران,سيمان‌ تهران‌,310,624517,21408442760,32650,34280,34280,1630,4.99,33310,660,2.02,34280,34280,1399-7-20
488,انرژي3,سايراشخاص بورس انرژي,307,180357,68625838500,362390,380500,380500,18110,5.0,376000,13610,3.76,380500,380500,1399-7-20
489,سكه0012پ01,سكه تمام بهارتحويلي 1روزه رفاه,304,220400,342387597800,1480133,1554139,1554139,74006,5.0,1553483,73350,4.96,1541000,1554139,1399-7-20
490,ثقزوي,شركت عمران و سازندگي قزوين,302,469388,12915680208,28366,27516,27516,-850,-3.0,27808,-558,-1.97,27516,27516,1399-7-20
491,سكارون,سيمان كارون,301,493502,52027715684,102555,105631,104250,1695,1.65,105426,2871,2.8,102500,105631,1399-7-20
492,بكاب,صنايع‌جوشكاب‌يزد,299,166463,25046022980,143300,150460,150460,7160,5.0,146680,3380,2.36,150460,150460,1399-7-20
493,خكار,ايركا پارت صنعت,297,615541,21568556640,36880,35040,35040,-1840,-4.99,36040,-840,-2.28,35040,35040,1399-7-20
494,افرا,افرانت,294,1581188,102941663552,68530,65104,65104,-3426,-5.0,65104,-3426,-5.0,65104,65104,1399-7-20
495,وآرين,شركت توسعه اقتصادي آرين,291,3046160,14971493460,4772,4915,4915,143,3.0,4875,103,2.16,4885,4915,1399-7-20
496,كبافق,معادن‌ بافق‌,290,485729,15101314610,29610,31090,31090,1480,5.0,30030,420,1.42,31090,31090,1399-7-20
497,وپترو,سرمايه‌گذاري صنايع پتروشيمي‌,289,2511586,43952755000,16670,17500,17500,830,4.98,17340,670,4.02,17500,17500,1399-7-20
498,ضجار7022,اختيارخ وتجارت-2800-1399/07/22,288,9315,6818818000,491,745,500,9,1.83,732,241,49.08,450,800,1399-7-20
499,بساما,بيمه سامان,288,1526051,36529280447,22805,23945,23945,1140,5.0,23563,758,3.32,23120,23945,1399-7-20
500,وتعاون,بيمه  تعاون,287,2191260,13013049615,5880,5720,6056,176,2.99,5918,38,0.65,5720,6056,1399-7-20
501,ما,بيمه  ما,287,4188432,25046823360,5700,5980,5980,280,4.91,5830,130,2.28,5980,5980,1399-7-20
502,دارو,كارخانجات‌داروپخش‌,286,448971,27099888560,57490,60360,60350,2860,4.97,58900,1410,2.45,60350,60360,1399-7-20
503,صايند,صندوق س. گنجينه آينده روشن-د,283,9194840,91929778740,9990,9946,9967,-23,-0.23,9998,8,0.08,9931,10010,1399-7-20
504,قشهد,شهد,274,526628,15779821450,31380,29820,29820,-1560,-4.97,30910,-470,-1.5,29820,31900,1399-7-20
505,سنوين,سرمايه گذاري اقتصاد نوين,274,1489768,17612844855,11885,12116,11648,-237,-1.99,11823,-62,-0.52,11648,12122,1399-7-20
506,دسانكو,داروسازي سبحان انكولوژي,269,1577191,27715977443,16737,17573,17573,836,4.99,17166,429,2.56,17573,17573,1399-7-20
507,سكه0011پ02,سكه تمام بهارتحويلي 1روزه ملت,268,192900,299790883400,1480132,1554139,1554139,74007,5.0,1554126,73994,5.0,1541490,1554139,1399-7-20
508,پرداخت,به پرداخت ملت,265,376366,16400665010,41610,43590,43690,2080,5.0,42220,610,1.47,42060,43690,1399-7-20
509,والبر,سرمايه‌ گذاري‌ البرز(هلدينگ‌,261,1606859,30482115230,18070,18970,18970,900,4.98,18580,510,2.82,18970,18970,1399-7-20
510,فروس,فروسيليس‌ ايران‌,261,1080136,25080757920,22120,23220,23220,1100,4.97,22640,520,2.35,23220,23220,1399-7-20
511,كاسپين,داروسازي كاسپين تامين,261,735031,20441699189,26509,27833,27834,1325,5.0,27006,497,1.87,26540,27834,1399-7-20
512,ضجار1015,اختيارخ وتجارت-3500-1399/10/21,260,9163,5322454000,634,1098,610,-24,-3.79,581,-53,-8.36,500,1098,1399-7-20
513,كسرا,سراميك‌هاي‌صنعتي‌اردكان‌,260,716496,15383169120,20450,21470,21470,1020,4.99,20740,290,1.42,21470,21470,1399-7-20
514,سفارس,سيمان فارس و خوزستان,256,1932536,33471523520,16500,17320,17320,820,4.97,17020,520,3.15,17320,17320,1399-7-20
515,كمرجان,بازرگاني و توليدي مرجان كار,252,408310,20431424090,47657,50039,50039,2382,5.0,48569,912,1.91,50039,50039,1399-7-20
516,بذر,صندوق س بذر اميد آفرين-سهام,251,156108,18920319310,117190,121000,121030,3840,3.28,121200,4010,3.42,118120,122900,1399-7-20
517,كترام,توليدي‌ كاشي‌ تكسرام‌,249,714291,14335820370,19120,20070,20070,950,4.97,19380,260,1.36,20070,20070,1399-7-20
518,ضجار1014,اختيارخ وتجارت-3000-1399/10/21,243,11459,11068408000,866,1150,971,105,12.12,966,100,11.55,900,1150,1399-7-20
519,فنفت,صنايع تجهيزات نفت,239,4513609,67071596974,14466,14899,14899,433,2.99,14860,394,2.72,14500,14899,1399-7-20
520,توريل,توکاريل,237,1889369,44122434257,22241,23353,23353,1112,5.0,23135,894,4.02,23353,23353,1399-7-20
521,سنير,سيمان‌ سفيد ني‌ريز,231,391140,32069568600,86300,81990,81990,-4310,-4.99,83390,-2910,-3.37,81990,81990,1399-7-20
522,سفارود,كارخانه فارسيت درود,230,1794758,13860916034,7572,7723,7723,151,1.99,7723,151,1.99,7723,7723,1399-7-20
523,وآذر,سرمايه‌گذاري‌توسعه‌آذربايجان‌,230,394945,61299413450,147820,155210,155210,7390,5.0,155210,7390,5.0,155210,155210,1399-7-20
524,تسه9806,امتياز تسهيلات مسكن شهريور98,229,3793,3474504597,925303,971568,880000,-45303,-4.9,916031,-9272,-1.0,879038,971568,1399-7-20
525,بنو,بيمه تجارت نو,229,2956398,98394838236,31698,33282,33282,1584,5.0,33282,1584,5.0,33282,33282,1399-7-20
526,وسرمد,بيمه  سرمد,225,2092499,13609613496,6315,6504,6504,189,2.99,6437,122,1.93,6504,6504,1399-7-20
527,تسه9807,امتياز تسهيلات مسكن مهر98,223,2109,1918474341,921447,936122,895000,-26447,-2.87,909661,-11786,-1.28,875375,950000,1399-7-20
528,غاذر,كشت‌وصنعت‌پياذر,219,314922,24315127620,81270,77210,77210,-4060,-5.0,79150,-2120,-2.61,77210,77210,1399-7-20
529,پخش,پخش البرز,218,1220615,40301045455,31445,33017,33017,1572,5.0,32631,1186,3.77,33017,33017,1399-7-20
530,وثنو,سرمايه گذاري ساختماني نوين,217,1168981,19619008123,17302,16783,16783,-519,-3.0,16783,-519,-3.0,16783,16783,1399-7-20
531,نمرينو,ايران‌ مرينوس‌,212,179478,10742005630,58950,59990,60000,1050,1.78,59140,190,0.32,56010,61000,1399-7-20
532,سپاس,صندوق س. پاداش سهامداري توسعه1,211,5516260,55272196170,10030,10040,10020,-10,-0.1,10020,-10,-0.1,10010,10040,1399-7-20
533,فنوال,نورد آلومينيوم‌,201,294441,10167047730,36340,34530,34530,-1810,-4.98,35950,-390,-1.07,34530,34530,1399-7-20
534,لكما,كارخانجات‌مخابراتي‌ايران‌,199,887583,9894775284,11492,11148,11148,-344,-2.99,11315,-177,-1.54,11148,11148,1399-7-20
535,درهآور,دارويي ره آورد تامين,199,340385,10256140435,28697,30131,30131,1434,5.0,28974,277,0.97,30131,30131,1399-7-20
536,ولراز,ليزينگ رازي,193,767713,17680430390,24242,23030,23030,-1212,-5.0,23114,-1128,-4.65,23030,23030,1399-7-20
537,مداران,داده‌پردازي‌ايران‌,191,1013849,29672137490,27900,28500,29290,1390,4.98,28680,780,2.8,28500,29290,1399-7-20
538,رانفور,خدمات‌انفورماتيك‌,190,1108903,33422336420,28710,30140,30140,1430,4.98,29180,470,1.64,30140,30140,1399-7-20
539,شرانل,نفت ايرانول,188,555712,17906152064,30688,32222,32222,1534,5.0,31190,502,1.64,32222,32222,1399-7-20
540,ريشمك,توليد و صادرات ريشمك,188,1517132,59946436716,37632,39513,39513,1881,5.0,39513,1881,5.0,39513,39513,1399-7-20
541,ثجوان,تامين مسكن جوانان,188,2035517,16792979550,7858,8250,8250,392,4.99,8159,301,3.83,8200,8250,1399-7-20
542,غمارگ,مارگارين‌,187,374627,9796496050,24910,26150,26150,1240,4.98,25130,220,0.88,26150,26150,1399-7-20
543,سيستم,همكاران سيستم,180,621544,18970981950,29080,30530,30530,1450,4.99,29580,500,1.72,30430,30530,1399-7-20
544,آكورد,صندوق س. آرمان آتي كوثر-د,180,3912203,112845213349,28832,28845,28845,13,0.05,28844,12,0.04,28811,28860,1399-7-20
545,دلر,داروسازي‌ اكسير,177,326016,35979125760,105110,110360,110360,5250,4.99,108630,3520,3.35,110360,110360,1399-7-20
546,وپست,پست بانك ايران,171,2141020,25071344200,11160,11710,11710,550,4.93,11410,250,2.24,11710,11710,1399-7-20
547,هشير911,اختيارف ت شيراز-73480-99/11/27,170,82132,693111948,7764,8439,8439,675,8.69,8439,675,8.69,8439,8439,1399-7-20
548,شكبير,پتروشيمي اميركبير,169,279464,16268294392,59941,58206,58143,-1798,-3.0,59606,-335,-0.56,58143,59990,1399-7-20
549,ضجار7024,اختيارخ وتجارت-3200-1399/07/22,164,6310,2215661000,201,320,202,1,0.5,351,150,74.63,200,410,1399-7-20
550,پلوله,گازلوله‌,161,1164093,22311006438,19359,19166,19166,-193,-1.0,19166,-193,-1.0,19166,19166,1399-7-20
551,دتماد,توليدمواداوليه‌داروپخش‌,159,903326,45500530620,47980,50370,50370,2390,4.98,49980,2000,4.17,50370,50370,1399-7-20
552,ساروم,سيمان‌اروميه‌,159,977806,26860330820,26170,27470,27470,1300,4.97,26830,660,2.52,27470,27470,1399-7-20
553,شفارس,صنايع‌ شيميايي‌ فارس‌,159,1120155,49589261850,42170,44270,44270,2100,4.98,44060,1890,4.48,44270,44270,1399-7-20
554,شزنگ,تجهيزنيروي‌زنگان‌,156,202006,19366346832,93192,95977,95987,2795,3.0,95644,2452,2.63,94100,95987,1399-7-20
555,فولاي,صنايع فولاد آلياژي يزد,154,121625,6071763250,52549,49922,49922,-2627,-5.0,52212,-337,-0.64,49922,49922,1399-7-20
556,حتوكا,حمل‌ونقل‌توكا,153,1542976,25875707520,15980,16770,16770,790,4.94,16370,390,2.44,16770,16770,1399-7-20
557,اوان,مبين وان كيش,152,2138911,97530063778,43427,45598,45598,2171,5.0,45598,2171,5.0,45598,45598,1399-7-20
558,امين يكم2,صندوق درآمد ثابت امين يكم فردا,151,15100000,15100000,10380,1,1,-10379,-99.99,1,-10379,-99.99,1,1,1399-7-20
559,اخزا815,اسنادخزانه-م15بودجه98-010406,150,237948,174559541801,732943,733177,734100,1157,0.16,733604,661,0.09,733177,735000,1399-7-20
560,سيدكو,سرمايه گذاري توسعه صنايع سيمان,149,2826985,22022213150,7420,7790,7790,370,4.99,7570,150,2.02,7790,7790,1399-7-20
561,ضجار7026,اختيارخ وتجارت-3600-1399/07/22,149,8035,655077000,40,70,42,2,5.0,82,42,105.0,41,105,1399-7-20
562,ثرود,سرمايه‌گذاري مسكن زاينده رود,146,1971428,24272221536,12960,12312,12312,-648,-5.0,12629,-331,-2.55,12312,12312,1399-7-20
563,صنوين,صندوق سرمايه‌گذاري صنوين-مختلط,140,29174,3257567320,110010,110000,110540,530,0.48,111660,1650,1.5,110000,112000,1399-7-20
564,كيسون,شركت كيسون,140,279217,5744331341,21209,20573,20573,-636,-3.0,21121,-88,-0.41,20573,20573,1399-7-20
565,گنجين,صندوق س. گنجينه يكم آويد-د,139,4993443,57110456002,11422,11454,11440,18,0.16,11437,15,0.13,10450,11455,1399-7-20
566,كگاز,شيشه‌ و گاز,139,243047,5889028810,25500,24230,24230,-1270,-4.98,25340,-160,-0.63,24230,24230,1399-7-20
567,كقزوي,شيشه‌ قزوين‌,137,450978,4590054084,10492,10178,10178,-314,-2.99,10418,-74,-0.71,10178,10178,1399-7-20
568,تسه9804,امتياز تسهيلات مسكن تير98,137,1664,1537205275,899496,944470,880200,-19296,-2.15,923801,24305,2.7,854560,944470,1399-7-20
569,كساپا,سايپاشيشه‌,133,199792,3943894080,20770,19740,19740,-1030,-4.96,20680,-90,-0.43,19740,19740,1399-7-20
570,شپاس,نفت پاسارگاد,132,4647248,110669563872,22680,23814,23814,1134,5.0,23814,1134,5.0,23814,23814,1399-7-20
571,فوكا,فولاد كاويان,132,554170,11247988490,21365,20297,20297,-1068,-5.0,21117,-248,-1.16,20297,20297,1399-7-20
572,ثغرب,شركت سرمايه گذاري مسكن شمالغرب,130,1838547,24469222023,14009,13309,13309,-700,-5.0,13648,-361,-2.58,13309,13309,1399-7-20
573,خنصير,مهندسي‌نصيرماشين‌,127,417909,20347989210,51250,48690,48690,-2560,-5.0,50150,-1100,-2.15,48690,48690,1399-7-20
574,وسخراج,شركت س استان خراسان جنوبي,126,1881512,4064065920,2270,2160,2160,-110,-4.85,2260,-10,-0.44,2160,2160,1399-7-20
575,سجام,مجتمع سيمان غرب آسيا,125,1057959,12421496619,12104,11741,11741,-363,-3.0,11871,-233,-1.92,11741,11741,1399-7-20
576,سهگمت,سيمان‌هگمتان‌,124,2228224,44118835200,18860,19800,19800,940,4.98,19650,790,4.19,19800,19800,1399-7-20
577,ضجار7023,اختيارخ وتجارت-3000-1399/07/22,123,5862,3237137000,339,499,400,61,17.99,552,213,62.83,399,600,1399-7-20
578,تسه9805,امتياز تسهيلات مسكن مرداد98,123,1068,992074979,910449,955971,889000,-21449,-2.36,928909,18460,2.03,870000,955971,1399-7-20
579,الماس,صندوق س.امين تدبيرگران فردا-س,122,57391,7228063085,122742,122750,124900,2158,1.76,125944,3202,2.61,122750,127100,1399-7-20
580,وجامي,سرمايه گذاري جامي,122,568829,7378849788,12355,12972,12972,617,4.99,12570,215,1.74,12972,12972,1399-7-20
581,اخزا818,اسنادخزانه-م18بودجه98-010614,122,233068,164190268000,703024,701000,704999,1975,0.28,704474,1450,0.21,701000,708000,1399-7-20
582,سكه0112پ03,سكه تمام بهارتحويلي1روزه سامان,121,45000,69936255000,1480133,1554139,1554139,74006,5.0,1554139,74006,5.0,1554139,1554139,1399-7-20
583,اخزا817,اسنادخزانه-م17بودجه98-010512,121,221791,158924408286,716685,713010,717001,316,0.04,716550,-135,-0.02,713000,717210,1399-7-20
584,خموتور,موتورسازان‌تراكتورسازي‌ايران‌,119,282669,3719924040,13850,13160,13160,-690,-4.98,13800,-50,-0.36,13160,13160,1399-7-20
585,بالاس,مهندسي ساختمان تاسيسات راه آهن,116,108366,5101979646,49558,47081,47081,-2477,-5.0,49292,-266,-0.54,47081,47081,1399-7-20
586,غگلپا,شير پاستوريزه پگاه گلپايگان,115,62207,4476477927,75748,71961,71961,-3787,-5.0,75390,-358,-0.47,71961,71961,1399-7-20
587,كسعدي,كاشي‌ سعدي‌,115,373477,22281637820,62800,59660,59660,-3140,-5.0,61330,-1470,-2.34,59660,59660,1399-7-20
588,ضخود1042,اختيارخ خودرو-3000-1399/10/07,115,1981,2001786000,916,1100,980,64,6.99,1010,94,10.26,861,1100,1399-7-20
589,وتوشه,سرمايه‌ گذاري‌ پارس‌ توشه‌,114,1267388,28744359840,21600,22680,22680,1080,5.0,22180,580,2.69,22680,22680,1399-7-20
590,وسنا,سرمايه گذاري نيروگاهي ايران,114,1685530,32232390190,20129,19123,19123,-1006,-5.0,19123,-1006,-5.0,19123,19123,1399-7-20
591,فيروزا,صندوق بادرآمد ثابت فيروزه آسيا,112,642804,13624142300,21100,21100,21200,100,0.47,21190,90,0.43,21100,21340,1399-7-20
592,شفارا,پتروشيمي فارابي,112,618714,3240823932,5399,5238,5238,-161,-2.98,5372,-27,-0.5,5238,5238,1399-7-20
593,دمعيار,صندوق س. توازن معيار-د,112,3253375,32660496347,10036,10058,10050,14,0.14,10039,3,0.03,10030,10059,1399-7-20
594,اخزا808,اسنادخزانه-م8بودجه98-000817,112,78181,65432334909,838413,838410,836926,-1487,-0.18,836934,-1479,-0.18,835209,839000,1399-7-20
595,چكاوه,صنايع‌كاغذسازي‌كاوه‌,111,54814,2024281020,38870,36930,36930,-1940,-4.99,38790,-80,-0.21,36930,36930,1399-7-20
596,سدبير,س. تدبيرگران فارس وخوزستان,109,310318,9665164428,29663,31146,31146,1483,5.0,29934,271,0.91,31146,31146,1399-7-20
597,ديرانح,ح . ‌ايران‌دارو,108,187314,3934352520,19540,21490,21000,1460,7.47,21000,1460,7.47,21000,21490,1399-7-20
598,ذوب تبعي9912,اختيارف.تبعي ذوب991224,108,480000,240000000,700,500,500,-200,-28.57,500,-200,-28.57,500,500,1399-7-20
599,ضجار7025,اختيارخ وتجارت-3400-1399/07/22,107,3725,754473000,119,200,104,-15,-12.61,203,84,70.59,103,235,1399-7-20
600,حپترو,حمل و نقل پتروشيمي( سهامي عام,105,246378,7452934500,31840,30250,30250,-1590,-4.99,31590,-250,-0.79,30250,30250,1399-7-20
601,وحكمت,بيمه حكمت صبا,104,728729,4211324891,5957,5779,5779,-178,-2.99,5918,-39,-0.65,5779,5779,1399-7-20
602,چفيبر,فيبر ايران‌,100,521351,5536747620,11170,10620,10620,-550,-4.92,11110,-60,-0.54,10620,10620,1399-7-20
603,ضپيك7030,اختيارخ تاپيكو-17370-99/07/20,95,698,1968353000,2033,2221,2650,617,30.35,2820,787,38.71,2000,3200,1399-7-20
604,خكمك,كمك‌فنرايندامين‌,95,283579,15321773370,56870,54030,54030,-2840,-4.99,55950,-920,-1.62,54030,54030,1399-7-20
605,ضخود1041,اختيارخ خودرو-2500-1399/10/07,91,2595,3317590000,1258,1489,1290,32,2.54,1278,20,1.59,1102,1489,1399-7-20
606,سمتاز,سيمان ممتازان كرمان,91,121772,2645740244,21095,21727,21727,632,3.0,21176,81,0.38,21727,21727,1399-7-20
607,كيان2,صندوق س. با درآمد ثابت كيان,90,9000000,9000000,25470,1,1,-25469,-100.0,1,-25469,-100.0,1,1,1399-7-20
608,سخند,صندوق س.سپهرخبرگان نفت-د,87,500970,5019721310,10016,10026,10022,6,0.06,10020,4,0.04,10007,10028,1399-7-20
609,فسا,پتروشيمي فسا,86,483190,1431208780,3053,2962,2962,-91,-2.98,3046,-7,-0.23,2962,2962,1399-7-20
610,غدشت,دشت‌ مرغاب‌,86,51484,14320274600,292780,278150,278150,-14630,-5.0,288340,-4440,-1.52,278150,278150,1399-7-20
611,فبيرا,بسته‌ بندي‌ ايران‌,85,1261307,6291399316,5142,4988,4988,-154,-2.99,5092,-50,-0.97,4988,4988,1399-7-20
612,تپولا,مهندسي مرآت پولاد,83,989846,21712272010,20891,21935,21935,1044,5.0,21935,1044,5.0,21935,21935,1399-7-20
613,اخزا814,اسنادخزانه-م14بودجه98-010318,81,211624,157987300590,746210,746523,746531,321,0.04,746547,337,0.05,746523,747000,1399-7-20
614,داراب,پتروشيمي داراب,80,429743,1335641244,3204,3108,3108,-96,-3.0,3197,-7,-0.22,3108,3108,1399-7-20
615,ثزاگرس,سرمايه گذاري توسعه عمران زاگرس,79,346287,9905885922,27773,28606,28606,833,3.0,28163,390,1.4,28606,28606,1399-7-20
616,كدما,معدني‌ دماوند,79,100541,16276582490,154190,161890,161890,7700,4.99,156580,2390,1.55,161890,161890,1399-7-20
617,چافست,افست‌,77,116656,2975894560,26850,25510,25510,-1340,-4.99,26770,-80,-0.3,25510,25510,1399-7-20
618,وپخش,داروپخش‌ (هلدينگ‌,76,104620,13702081400,124740,130970,130970,6230,4.99,126340,1600,1.28,130970,130970,1399-7-20
619,كابگن,توليدي و صنعتي آبگينه‌,76,1024314,4714912342,4558,4603,4603,45,0.99,4600,42,0.92,4602,4603,1399-7-20
620,ضخود1048,اختيارخ خودرو-7000-1399/10/07,75,3413,450846000,130,146,121,-9,-6.92,132,2,1.54,120,148,1399-7-20
621,قپيرا,فرآورده‌هاي‌غدايي‌وقندپيرانشهر,75,113712,9460814700,79240,83200,83100,3860,4.87,79950,710,0.9,83100,83200,1399-7-20
622,اخزا816,اسنادخزانه-م16بودجه98-010503,75,185450,133989815559,721107,721306,722611,1504,0.21,722512,1405,0.19,721305,723550,1399-7-20
623,تكنار,مجتمع معادن مس تكنار,74,69383,6405716092,89635,92324,92324,2689,3.0,90432,797,0.89,92324,92324,1399-7-20
624,دقاضي,داروسازي شهيد قاضي,72,36123,3440074285,93797,96440,93500,-297,-0.32,94040,243,0.26,93000,96610,1399-7-20
625,غبهنوش,بهنوش‌ ايران‌,72,298836,18829656360,60010,63010,63010,3000,5.0,61060,1050,1.75,63010,63010,1399-7-20
626,حبندر,دريايي و کشتيراني خط دريابندر,71,82746,1909694934,23792,23079,23079,-713,-3.0,23722,-70,-0.29,23079,23079,1399-7-20
627,اخزا811,اسنادخزانه-م11بودجه98-001013,71,127855,104221611902,816033,815210,815000,-1033,-0.13,815155,-878,-0.11,813200,816033,1399-7-20
628,وسكرشا,س.سهام عدالت استان كرمانشاه,70,1760683,2394528880,1300,1360,1360,60,4.62,1300,0,0.0,1360,1360,1399-7-20
629,فلات,گروه صنايع معادن فلات ايرانيان,70,568055,7626138375,13034,13425,13425,391,3.0,13178,144,1.1,13425,13425,1399-7-20
630,آساميد,صندوق س.مشترك آسمان اميد -د,70,2223725,24073196545,10816,10825,10825,9,0.08,10826,10,0.09,10820,10835,1399-7-20
631,ضخود1045,اختيارخ خودرو-4500-1399/10/07,69,1456,459188000,225,360,268,43,19.11,315,90,40.0,268,360,1399-7-20
632,جهرم,پتروشيمي جهرم,69,316554,1034815026,3370,3269,3269,-101,-3.0,3365,-5,-0.15,3269,3269,1399-7-20
633,تصميم,صندوق س با درآمد ثابت تصميم,68,530737,7801087970,14670,14670,14690,20,0.14,14700,30,0.2,14670,14720,1399-7-20
634,اخزا809,اسنادخزانه-م9بودجه98-000923,67,102949,84597430609,818844,818222,821010,2166,0.26,821741,2897,0.35,818222,824000,1399-7-20
635,شستا992,اجاره تامين اجتماعي-سپهر991226,66,10334,10343061343,1001001,1101101,1000000,-1001,-0.1,1000877,-124,-0.01,996000,1101101,1399-7-20
636,وسيلام,شركت س استان ايلام,66,3058203,3914499840,1220,1280,1280,60,4.92,1220,0,0.0,1280,1280,1399-7-20
637,تپمپي,پمپ‌ سازي‌ ايران‌,65,110650,4721435500,44910,42670,42670,-2240,-4.99,44680,-230,-0.51,42670,42670,1399-7-20
638,ضملي1152,اختيارخ فملي-18252-1399/11/05,65,1453,4701580000,2226,3000,3000,774,34.77,3236,1010,45.37,3000,3390,1399-7-20
639,ضملي1153,اختيارخ فملي-20280-1399/11/05,65,2441,5356831000,1743,2000,2100,357,20.48,2195,452,25.93,2000,2450,1399-7-20
640,شصفها,پتروشيمي‌ اصفهان‌,65,35718,3341561772,91720,93554,93554,1834,2.0,92266,546,0.6,93554,93554,1399-7-20
641,هاباد912,اختيارف ت آبادا-30100-99/12/12,65,22275,76514625,3027,3435,3435,408,13.48,3435,408,13.48,3435,3435,1399-7-20
642,وشمال,س. چشم انداز توسعه شمال,63,24872,2837870328,117627,114099,114099,-3528,-3.0,117095,-532,-0.45,114099,114099,1399-7-20
643,ضخوز7027,اختيارخ فخوز-39470-1399/07/20,63,822,101932000,32,399,20,-12,-37.5,124,92,287.5,10,400,1399-7-20
644,وسمركز,شركت س استان مركزي,61,709896,1043547120,1400,1470,1470,70,5.0,1400,0,0.0,1470,1470,1399-7-20
645,ارمغان,ص سرمايه گذاري ارمغان ايرانيان,61,1422701,14256170860,10020,10020,10030,10,0.1,10020,0,0.0,10020,10030,1399-7-20
646,ساروج,بين المللي ساروج بوشهر,58,62810,1317811807,21545,21400,20899,-646,-3.0,21507,-38,-0.18,20899,21400,1399-7-20
647,ثاباد,توريستي ورفاهي آبادگران ايران,57,185714,5725562620,32450,30830,30830,-1620,-4.99,32250,-200,-0.62,30830,30830,1399-7-20
648,هبهرن912,اختيارف ت شبهرن-74590-99/12/02,57,100000,26900000,3343,269,269,-3074,-91.95,269,-3074,-91.95,269,269,1399-7-20
649,هبركت912,اختيارف ت بركت-22100-99/12/17,57,125631,338575545,3162,2695,2695,-467,-14.77,2695,-467,-14.77,2695,2695,1399-7-20
650,خمحور,توليدمحورخودرو,57,75599,4310654980,60020,57020,57020,-3000,-5.0,59750,-270,-0.45,57020,57020,1399-7-20
651,ضخود1040,اختيارخ خودرو-2000-1399/10/07,56,1382,2516848000,1881,1920,1520,-361,-19.19,1821,-60,-3.19,1519,1930,1399-7-20
652,حسير,ريل سير كوثر,54,62857,1648047683,27598,26219,26219,-1379,-5.0,27550,-48,-0.17,26219,26219,1399-7-20
653,ورازي,بيمه رازي,54,112773,1646260254,15366,14598,14598,-768,-5.0,15299,-67,-0.44,14598,14598,1399-7-20
654,تكنو,تكنوتار,52,95333,1394721790,15400,14630,14630,-770,-5.0,15380,-20,-0.13,14630,14630,1399-7-20
655,بايكا,كارخانجات كابلسازي ‌ايران‌,51,95213,3917443672,42416,41144,41144,-1272,-3.0,42159,-257,-0.61,41144,41144,1399-7-20
656,نتوس,پشم‌ بافي‌ توس,51,66509,721489632,11183,10848,10848,-335,-3.0,11171,-12,-0.11,10848,10848,1399-7-20
657,زنگان,صنعت روي زنگان,51,12300,1897102800,162353,154236,154236,-8117,-5.0,162028,-325,-0.2,154236,154236,1399-7-20
658,تشتاد,صنايع توليدي اشتاد ايران‌,51,100100,1312411100,13516,13111,13111,-405,-3.0,13489,-27,-0.2,13111,13111,1399-7-20
659,ثروتم,صندوق س. ثروت آفرين پارسيان-س,50,9540,940817060,97924,98200,98200,276,0.28,98618,694,0.71,98200,99970,1399-7-20
660,ثنظام,س. ساختماني نظام مهندسي ايران,50,99204,4308429720,44773,43430,43430,-1343,-3.0,44473,-300,-0.67,43430,43430,1399-7-20
661,ضصاد8019,اختيارخ وبصادر-4200-1399/08/11,50,1184,680194000,435,500,500,65,14.94,574,139,31.95,500,670,1399-7-20
662,ضجار7016,اختيارخ وتجارت-1800-1399/07/22,50,1810,3182576000,1424,1700,1500,76,5.34,1758,334,23.46,1400,1850,1399-7-20
663,آسام,صندوق س.آرمان سپهر آشنا-م,49,32170,3463659970,105612,105010,107410,1798,1.7,107667,2055,1.95,105010,108998,1399-7-20
664,وحافظ,بيمه حافظ,47,96943,5570538666,60486,57462,57462,-3024,-5.0,59599,-887,-1.47,57462,57462,1399-7-20
665,كايتاح,ح.ايتالران‌,47,93189,1456390698,1000,15990,15511,14511,1451.1,15628,14628,1462.8,15511,15990,1399-7-20
666,زعف9908پ15,زعفران9908پوشالمعمول طلاسرخ(پ),47,8678,736601911,81798,86169,86169,4371,5.34,84882,3084,3.77,83500,86169,1399-7-20
667,بشهاب,لامپ‌  پارس‌ شهاب‌,46,12857,897547170,73480,69810,69810,-3670,-4.99,73410,-70,-0.1,69810,69810,1399-7-20
668,پست0008پ09,پسته بادامي30-28مه ولات0008(پ),45,364,553701280,1574889,1550000,1500000,-74889,-4.76,1521157,-53732,-3.41,1500000,1610000,1399-7-20
669,ضخود1043,اختيارخ خودرو-3500-1399/10/07,45,1506,1024901000,690,700,600,-90,-13.04,681,-9,-1.3,558,800,1399-7-20
670,هشفن911,اختيارف ت شفن-318060-99/11/26,43,18000,196902000,4657,10939,10939,6282,134.89,10939,6282,134.89,10939,10939,1399-7-20
671,دلقما,دارويي‌ لقمان‌,43,18841,629666220,35170,33420,33420,-1750,-4.98,35150,-20,-0.06,33420,33420,1399-7-20
672,اخزا806,اسنادخزانه-م6بودجه98-000519,42,40272,34969418131,865487,866000,869500,4013,0.46,868331,2844,0.33,865500,869501,1399-7-20
673,داريك,صندوق س.اعتماد داريك-د,42,669872,6720729279,10006,10050,10040,34,0.34,10033,27,0.27,10001,10050,1399-7-20
674,شكف,كف,41,167501,9822258640,57491,58640,58640,1149,2.0,58559,1068,1.86,58640,58640,1399-7-20
675,قمرو,قند مرودشت‌,41,33582,1185444600,37150,35300,35300,-1850,-4.98,37100,-50,-0.13,35300,35300,1399-7-20
676,اخزا721,اسنادخزانه-م21بودجه97-000728,40,229617,193871256359,844419,843824,843901,-518,-0.06,844324,-95,-0.01,843824,845000,1399-7-20
677,سخواف,سيمان مجد خواف,40,57315,916008330,16823,15982,15982,-841,-5.0,16782,-41,-0.24,15982,15982,1399-7-20
678,لخزر,پارس‌ خزر,40,7525,1553611500,217320,206460,206460,-10860,-5.0,216960,-360,-0.17,206460,206460,1399-7-20
679,آينده,بازرگاني آينده سازان بهشت پارس,40,96359,2133002824,22820,22136,22136,-684,-3.0,22745,-75,-0.33,22136,22136,1399-7-20
680,هكاوه911,اختيارف ت كاوه-25477-99/11/18,39,100000,162000000,777,1620,1620,843,108.49,1620,843,108.49,1620,1620,1399-7-20
681,وپسا,س. پتروشيمي ساختمان  خليج فارس,38,318346,1601917072,5187,5032,5032,-155,-2.99,5174,-13,-0.25,5032,5032,1399-7-20
682,ثامان,سامان‌ گستراصفهان‌,38,44374,954928480,22650,21520,21520,-1130,-4.99,22630,-20,-0.09,21520,21520,1399-7-20
683,هغدير912,اختيارف ت غدير-17380-99/12/16,38,187181,99767473,1,533,533,532,53200.0,533,532,53200.0,533,533,1399-7-20
684,لپيام,گسترش صنايع پيام,37,20982,650483964,31960,31002,31002,-958,-3.0,31928,-32,-0.1,31002,31002,1399-7-20
685,ضجار7018,اختيارخ وتجارت-2000-1399/07/22,37,1434,2182533000,1219,1490,1350,131,10.75,1522,303,24.86,1000,1589,1399-7-20
686,ضفار1125,اختيارخ فارس-17826-1399/11/07,37,379,1104475000,1318,3000,1900,582,44.16,2914,1596,121.09,1900,3200,1399-7-20
687,نيرو,نيرو سرمايه,36,14884,737219404,51062,49531,49531,-1531,-3.0,51004,-58,-0.11,49531,49531,1399-7-20
688,ضپيك7022,اختيارخ تاپيكو-9370-99/07/20,35,246,2619003000,9705,9300,11001,1296,13.35,10646,941,9.7,9300,11499,1399-7-20
689,ضصاد8015,اختيارخ وبصادر-3400-1399/08/11,33,429,516076000,866,1100,1030,164,18.94,1203,337,38.91,1020,1310,1399-7-20
690,سدشت,صنايع سيمان دشتستان,31,66705,2683542150,38320,40230,40230,1910,4.98,38420,100,0.26,40230,40230,1399-7-20
691,ضصاد8018,اختيارخ وبصادر-4000-1399/08/11,30,501,350976000,612,750,600,-12,-1.96,701,89,14.54,501,790,1399-7-20
692,ضچاد1017,اختيارخ كچاد-20000-1399/10/02,30,294,1160621000,3648,4000,3850,202,5.54,3948,300,8.22,3800,4300,1399-7-20
693,آكورد2,صندوق س. آرمان آتي كوثر-د,30,3000000,3000000,28832,1,1,-28831,-100.0,1,-28831,-100.0,1,1,1399-7-20
694,هترول911,اختيارف ت پترول-14730-99/11/15,30,450000,450000,1,1,1,0,0.0,1,0,0.0,1,1,1399-7-20
695,ثعتما,س. ساختماني اعتماد گستر,29,57292,1941625880,34938,33890,33890,-1048,-3.0,34831,-107,-0.31,33890,33890,1399-7-20
696,وسگلستا,شركت س استان گلستان,29,658145,855588500,1240,1300,1300,60,4.84,1240,0,0.0,1300,1300,1399-7-20
697,گوهر2,صندوق سكه طلاي كيان,29,290000,290000,76577,1,1,-76576,-100.0,1,-76576,-100.0,1,1,1399-7-20
698,فالوم,آلومتك‌,28,17293,585627445,34912,33865,33865,-1047,-3.0,34880,-32,-0.09,33865,33865,1399-7-20
699,اخزا903,اسنادخزانه-م3بودجه99-011110,28,27426,17862309507,656448,655130,651880,-4568,-0.7,651291,-5157,-0.79,648294,656448,1399-7-20
700,هرانف912,اختيارف ت رانفور32120-99/12/03,28,72419,88930532,1563,1228,1228,-335,-21.43,1228,-335,-21.43,1228,1228,1399-7-20
701,زعف9908پ14,زعفران9908پوشالمعمول نوين(پ),28,4314,370816667,82066,82071,86169,4103,5.0,85957,3891,4.74,82071,86169,1399-7-20
702,شتولي,تولي‌پرس‌,27,163528,3428691576,20556,20967,20967,411,2.0,20690,134,0.65,20967,20967,1399-7-20
703,سفاسي,شركت فارسيت اهواز,27,51534,578520684,11573,11226,11226,-347,-3.0,11563,-10,-0.09,11226,11226,1399-7-20
704,آرمان,بيمه آرمان,27,629957,3876125421,5974,6153,6153,179,3.0,6007,33,0.55,6153,6153,1399-7-20
705,ضسپا8018,اختيارخ خساپا-2400-1399/08/26,27,291,205217000,670,581,750,80,11.94,705,35,5.22,581,800,1399-7-20
706,هخود911,اختيارف ت خودرو-3680-99/11/20,26,1000000,43000000,201,43,43,-158,-78.61,43,-158,-78.61,43,43,1399-7-20
707,ضپيك7032,اختيارخ تاپيكو-19370-99/07/20,26,208,231882000,631,1500,740,109,17.27,1115,484,76.7,710,1998,1399-7-20
708,ثتوسا,س.توسعه و عمران استان اردبيل,25,8162,587386492,75753,71966,71966,-3787,-5.0,75636,-117,-0.15,71966,71966,1399-7-20
709,فافزا,فولاد افزا سپاهان,25,10539,489504933,48891,46447,46447,-2444,-5.0,48828,-63,-0.13,46447,46447,1399-7-20
710,ضغدر8043,اختيارخ وغدير-16000-1399/08/26,25,301,782931000,1729,2200,2502,773,44.71,2601,872,50.43,2200,2890,1399-7-20
711,فمراد,آلومراد,25,5318,764675220,151350,143790,143790,-7560,-5.0,151230,-120,-0.08,143790,143790,1399-7-20
712,اخزا812,اسنادخزانه-م12بودجه98-001111,23,35590,28753136962,811438,808850,807521,-3917,-0.48,807899,-3539,-0.44,807521,809000,1399-7-20
713,اخزا813,اسنادخزانه-م13بودجه98-010219,23,43080,32562847635,755599,755825,755900,301,0.04,755869,270,0.04,755825,755900,1399-7-20
714,دشيري,شيرين دارو,22,9008,1675343872,191736,185984,185984,-5752,-3.0,191239,-497,-0.26,185984,185984,1399-7-20
715,اخزا902,اسنادخزانه-م2بودجه99-011019,22,81852,53622825028,654847,655000,655000,153,0.02,655119,272,0.04,655000,659900,1399-7-20
716,اخزا807,اسنادخزانه-م7بودجه98-000719,22,77984,66102927337,847499,854000,847900,401,0.05,847647,148,0.02,846952,854000,1399-7-20
717,ضملي8077,اختيارخ فملي -29750-1399/08/06,22,213,555979000,1697,1010,1100,-597,-35.18,2610,913,53.8,1010,3001,1399-7-20
718,ضفلا8076,اختيارخ فولاد-8775-1399/08/28,22,100,968577000,9145,8500,9100,-45,-0.49,9686,541,5.92,8500,10200,1399-7-20
719,اخزا821,اسنادخزانه-م21بودجه98-020906,21,1962,1109322841,571734,560300,570000,-1734,-0.3,565404,-6330,-1.11,560202,571990,1399-7-20
720,ضمخا1026,اختيارخ اخابر-18000-1399/10/30,21,176,962660000,4929,5500,5500,571,11.58,5470,541,10.98,5210,5600,1399-7-20
721,ثاژن,سخت آژند,21,113316,1041374040,9377,9190,9190,-187,-1.99,9357,-20,-0.21,9190,9190,1399-7-20
722,سايرا,ايرانيت‌,21,22366,840239294,36947,36209,37000,53,0.14,36998,51,0.14,36209,37685,1399-7-20
723,پست9908-02,پسته فندقي32-30طلاسبززرند9908,20,1263,2153715083,1791399,1877732,1701830,-89569,-5.0,1705238,-86161,-4.81,1701830,1877732,1399-7-20
724,ضصاد8017,اختيارخ وبصادر-3800-1399/08/11,20,417,352316000,707,414,680,-27,-3.82,845,138,19.52,680,950,1399-7-20
725,ضصاد8020,اختيارخ وبصادر-4400-1399/08/11,20,285,144843000,434,451,360,-74,-17.05,508,74,17.05,314,550,1399-7-20
726,ضپيك7033,اختيارخ تاپيكو-21370-99/07/20,20,274,4445000,17,37,1,-16,-94.12,16,-1,-5.88,1,37,1399-7-20
727,شتران2,پالايش نفت تهران,20,38001775,631589500500,13090,16620,16620,3530,26.97,16620,3530,26.97,16620,16620,1399-7-20
728,فسديد,لوله‌وتجهيزات‌ سديد - ورشكسته,19,45991,5509077926,120995,119786,119786,-1209,-1.0,119786,-1209,-1.0,119786,119786,1399-7-20
729,شرنگي,شيميايي رنگين,19,8572,989174512,118964,115396,115396,-3568,-3.0,118777,-187,-0.16,115396,115396,1399-7-20
730,ضجار7036,اختيارخ وتجارت-6500-1399/07/22,19,1125,1245000,1,13,1,0,0.0,1,0,0.0,1,13,1399-7-20
731,افران,صندوق س افرا نماد پايدار-ثابت,19,177434,2101122360,11860,11840,11860,0,0.0,11840,-20,-0.17,11840,11860,1399-7-20
732,غشوكو,شوكو پارس,19,25849,1147618053,45770,44397,44397,-1373,-3.0,45689,-81,-0.18,44397,44397,1399-7-20
733,ضملي1151,اختيارخ فملي-16224-1399/11/05,18,161,860070000,6500,5500,5500,-1000,-15.38,5342,-1158,-17.82,5000,5500,1399-7-20
734,لازما,كارخانه هاي صنعتي آزمايش,18,10825,334460025,31527,30897,30897,-630,-2.0,31505,-22,-0.07,30897,30897,1399-7-20
735,فولاد2,فولاد مباركه اصفهان,18,23268031,424176205130,17490,18230,18230,740,4.23,18230,740,4.23,18230,18230,1399-7-20
736,همپنا912,اختيارف ت مپنا-23410-99/12/11,18,100000,100000,540,1,1,-539,-99.81,1,-539,-99.81,1,1,1399-7-20
737,هملت911,اختيارف ت ملت-6770-99/11/25,18,673221,673221,733,1,1,-732,-99.86,1,-732,-99.86,1,1,1399-7-20
738,ضصاد8021,اختيارخ وبصادر-4600-1399/08/11,18,345,145164000,282,470,260,-22,-7.8,421,139,49.29,260,600,1399-7-20
739,ضترا8040,اختيارخ شتران-16326-1399/08/11,17,350,1797581500,1477,3000,2400,923,62.49,3012,1535,103.93,2400,3100,1399-7-20
740,زعف9908پ13,زعفران9908پوشالمعمول روستا(پ),17,1403,120895107,80808,86169,86169,5361,6.63,86169,5361,6.63,86169,86169,1399-7-20
741,فملي2,ملي‌ صنايع‌ مس‌ ايران‌,17,16304155,476081326000,27950,29200,29200,1250,4.47,29200,1250,4.47,29200,29200,1399-7-20
742,زعف9908پ17,زعفران9908پوشالمعمول بيرجند(پ),17,1339,115240890,81972,86000,86169,4197,5.12,86065,4093,4.99,85500,86169,1399-7-20
743,ضصاد8014,اختيارخ وبصادر-3200-1399/08/11,17,244,328911000,1141,1201,1400,259,22.7,1348,207,18.14,1201,1420,1399-7-20
744,هجم911,اختيارف ت جم-38645-99/11/28,16,71374,71374,1,1,1,0,0.0,1,0,0.0,1,1,1399-7-20
745,ضفلا8085,اختيارخ فولاد-16775-1399/08/28,16,148,473825000,2114,2500,3000,886,41.91,3202,1088,51.47,2500,3400,1399-7-20
746,كصدف,كاشي صدف سرام استقلال آباده,16,114989,1998968776,16878,17384,17384,506,3.0,16926,48,0.28,17384,17384,1399-7-20
747,زعف9908پ16,زعفران9908نگين بيرجند(پ),16,3115,315729080,96665,101382,101383,4718,4.88,101358,4693,4.85,101067,101383,1399-7-20
748,ضچاد1016,اختيارخ كچاد-18000-1399/10/02,16,255,1095850000,5180,5500,4400,-780,-15.06,4297,-883,-17.05,4000,5500,1399-7-20
749,ضخوز7021,اختيارخ فخوز-27470-1399/07/20,16,81,1159430000,10003,25000,12100,2097,20.96,14314,4311,43.1,10000,25000,1399-7-20
750,شمواد,توليد مواداوليه الياف مصنوعي,16,9895,626096230,65230,63274,63274,-1956,-3.0,65167,-63,-0.1,63274,63274,1399-7-20
751,ضجار7027,اختيارخ وتجارت-3800-1399/07/22,15,543,11140000,19,30,16,-3,-15.79,21,2,10.53,15,30,1399-7-20
752,ضصاد8013,اختيارخ وبصادر-3000-1399/08/11,15,191,315837000,1307,1699,1300,-7,-0.54,1654,347,26.55,1300,1700,1399-7-20
753,پست9908-04,پسته فندقي32-30سبزدانه9908,15,692,1177957067,1773278,1701830,1720000,-53278,-3.0,1702250,-71028,-4.01,1701830,1720000,1399-7-20
754,غبهار,كشت وصنعت بهاران گلبهار خراسان,15,6769,247278339,37660,36531,36531,-1129,-3.0,37646,-14,-0.04,36531,36531,1399-7-20
755,پست9908-08,پسته فندقي32-30زرينمه ولات9908,15,239,416259614,1813924,1875000,1701830,-112094,-6.18,1741672,-72252,-3.98,1701830,1879500,1399-7-20
756,كرونا2,تامين مالي جمعي صرفا اهداي سود,15,2571,25710000,10000,10000,10000,0,0.0,10000,0,0.0,10000,10000,1399-7-20
757,هفارس912,اختيارف ت فارس-14576-99/12/13,15,602301,602301,1,1,1,0,0.0,1,0,0.0,1,1,1399-7-20
758,تابا,تابان نيرو سپاهان,14,7698,239815794,32792,31153,31153,-1639,-5.0,32771,-21,-0.06,31153,31153,1399-7-20
759,فنورد,نوردوقطعات‌ فولادي‌,14,121223,16856058150,132430,139050,139050,6620,5.0,134550,2120,1.6,139050,139050,1399-7-20
760,ضصاد1100,اختيارخ وبصادر-2500-1399/11/12,14,42,127000000,2793,3100,2900,107,3.83,3024,231,8.27,2900,3300,1399-7-20
761,اخزا810,اسنادخزانه-م10بودجه98-001006,14,50555,41384386788,818958,818573,818574,-384,-0.05,818601,-357,-0.04,818573,818799,1399-7-20
762,زعف9908پ05,زعفران9908نگين زرين(پ),14,11345,1150190135,96782,101383,101383,4601,4.75,101383,4601,4.75,101383,101383,1399-7-20
763,هصادر912,اختيارف ت صادرات-3750-99/12/23,14,1000000,1000000,1,1,1,0,0.0,1,0,0.0,1,1,1399-7-20
764,وايرا,سرمايه گذاري صنايع ايران,14,52426,465857436,9160,8886,8886,-274,-2.99,9153,-7,-0.08,8886,8886,1399-7-20
765,ضجار7010,اختيارخ وتجارت-1200-1399/07/22,14,313,688931000,2002,2100,2100,98,4.9,2201,199,9.94,2100,2499,1399-7-20
766,ضجار7021,اختيارخ وتجارت-2600-1399/07/22,14,511,461519000,675,900,700,25,3.7,903,228,33.78,700,1000,1399-7-20
767,ضصاد8012,اختيارخ وبصادر-2800-1399/08/11,14,109,197916000,1504,1850,1730,226,15.03,1816,312,20.74,1502,1900,1399-7-20
768,ضخود1046,اختيارخ خودرو-5000-1399/10/07,14,310,83393000,237,310,265,28,11.81,269,32,13.5,260,320,1399-7-20
769,ضخوز7024,اختيارخ فخوز-33470-1399/07/20,13,139,703321000,4468,5152,5302,834,18.67,5060,592,13.25,5001,5500,1399-7-20
770,ضصاد8010,اختيارخ وبصادر-2400-1399/08/11,13,207,443474000,1835,2180,1800,-35,-1.91,2142,307,16.73,1800,2420,1399-7-20
771,ثنام,س ساختماني ب نام آوران مهندسي,13,7659,161482356,21736,21084,21084,-652,-3.0,21731,-5,-0.02,21084,21084,1399-7-20
772,فنرژي,گسترش صنايع انرژي آذرآب,13,22820,243671960,10895,10678,10678,-217,-1.99,10890,-5,-0.05,10678,10678,1399-7-20
773,اخزا704,اسنادخزانه-م4بودجه97-991022,13,136677,131346582148,959921,961000,961000,1079,0.11,961000,1079,0.11,960999,961000,1399-7-20
774,هصند911,اختيارف ت صندوق-19926-99/11/29,12,14335,18793185,1271,1311,1311,40,3.15,1311,40,3.15,1311,1311,1399-7-20
775,صايند2,صندوق س. گنجينه آينده روشن-د,12,8400000,8400000,9990,1,1,-9989,-99.99,1,-9989,-99.99,1,1,1399-7-20
776,وآتوس,س.آرين توسكا قيمت اسمي 350ريال,12,5925,225102600,39166,37992,37992,-1174,-3.0,39152,-14,-0.04,37992,37992,1399-7-20
777,زعف9908پ09,زعفران9908نگين نوين(پ),11,3366,341251878,97015,101350,101383,4368,4.5,101382,4367,4.5,101350,101383,1399-7-20
778,وساربيل,شركت س استان اردبيل,11,151438,204441300,1290,1350,1350,60,4.65,1290,0,0.0,1350,1350,1399-7-20
779,ضخوز7023,اختيارخ فخوز-31470-1399/07/20,11,61,439546000,6708,7003,7500,792,11.81,7206,498,7.42,7001,7500,1399-7-20
780,زير0003پ04,زيره سبز0003شركت مينوبذر(پ),11,117,56282063,488165,481001,482000,-6165,-1.26,481043,-7122,-1.46,480769,482000,1399-7-20
781,ضسپا8015,اختيارخ خساپا-1900-1399/08/26,11,214,224473000,900,1000,1001,101,11.22,1049,149,16.56,1000,1100,1399-7-20
782,اخزا713,اسنادخزانه-م13بودجه97-000518,11,4397,3827894362,866004,872990,870002,3998,0.46,870570,4566,0.53,866033,874999,1399-7-20
783,لخانه,لوازم‌ خانگي‌ پارس‌,10,4906,279431042,58718,56957,56957,-1761,-3.0,58693,-25,-0.04,56957,56957,1399-7-20
784,فن آوا,گروه فن آوا,10,14663,207114875,14561,14125,14125,-436,-2.99,14556,-5,-0.03,14125,14125,1399-7-20
785,ضفلا8088,اختيارخ فولاد-19775-1399/08/28,10,140,292160000,1761,2100,2000,239,13.57,2087,326,18.51,2000,2508,1399-7-20
786,ضجار7017,اختيارخ وتجارت-1900-1399/07/22,10,202,309674000,1352,1506,1502,150,11.09,1533,181,13.39,1502,1730,1399-7-20
787,تملي807,تسهيلات مسكن ب. ملي-مهر98,10,160,76962560,458111,481016,481016,22905,5.0,481016,22905,5.0,481016,481016,1399-7-20
788,پلاست,كارخانجات توليدي پلاستيران,10,3654,153493578,43306,42007,42007,-1299,-3.0,43296,-10,-0.02,42007,42007,1399-7-20
789,ضپاس7016,اختيارخ وپارس-4200-1399/07/30,10,209,101545000,379,600,350,-29,-7.65,486,107,28.23,350,600,1399-7-20
790,ضملي1148,اختيارخ فملي-10140-1399/11/05,10,120,1649234000,13762,14000,13900,138,1.0,13744,-18,-0.13,13700,14290,1399-7-20
791,ضخوز7022,اختيارخ فخوز-29470-1399/07/20,10,65,644716000,8534,8600,9300,766,8.98,9919,1385,16.23,8600,10000,1399-7-20
792,زر2,صندوق س.پشتوانه سكه طلاي زر,10,1000000,1000000,64339,1,1,-64338,-100.0,1,-64338,-100.0,1,1,1399-7-20
793,سلار,شركت سيمان لارستان,10,10816,295850048,28198,27353,27353,-845,-3.0,28185,-13,-0.05,27353,27353,1399-7-20
794,اخابر2,مخابرات ايران,10,6582442,123749909600,17910,18800,18800,890,4.97,18800,890,4.97,18800,18800,1399-7-20
795,خعمرا,توسعه و عمران شهرستان نائين,10,45771,696543078,14775,15218,15218,443,3.0,14790,15,0.1,15218,15218,1399-7-20
796,ضصاد8016,اختيارخ وبصادر-3600-1399/08/11,10,137,139737000,825,901,920,95,11.52,1020,195,23.64,920,1089,1399-7-20
797,اخزا716,اسنادخزانه-م16بودجه97-000407,10,32740,29073650936,887548,888040,888700,1152,0.13,888016,468,0.05,887102,888700,1399-7-20
798,اخزا820,اسنادخزانه-م20بودجه98-020806,10,1470,846819704,576125,570201,576125,0,0.0,576068,-57,-0.01,570201,578000,1399-7-20
799,فخوز2,فولاد  خوزستان,9,5762535,233613168900,38730,40540,40540,1810,4.67,40540,1810,4.67,40540,40540,1399-7-20
800,زقيامح,ح.كشت و دام قيام اصفهان,9,29114,805939376,27261,28624,27400,139,0.51,27682,421,1.54,27400,28624,1399-7-20
801,ضمخا7032,اختيارخ اخابر-4750-1399/07/30,9,86,1129810000,11000,12000,13200,2200,20.0,13137,2137,19.43,12000,14000,1399-7-20
802,غنيلي,مجتمع توليدي نيلي صنعت كرمان,9,263200,5000800000,19003,19000,19000,-3,-0.02,19000,-3,-0.02,19000,19000,1399-7-20
803,اشاد9,مشاركت دولتي9-شرايط خاص990909,9,101300,100692257800,990001,994000,994000,3999,0.4,994001,4000,0.4,994000,994002,1399-7-20
804,ضپاس7020,اختيارخ وپارس-5000-1399/07/30,9,173,30310000,155,190,110,-45,-29.03,175,20,12.9,110,200,1399-7-20
805,هپارس912,اختيارف ت وپارس-5920-99/12/10,9,100000,75800000,1175,758,758,-417,-35.49,758,-417,-35.49,758,758,1399-7-20
806,ضفلا8087,اختيارخ فولاد-18775-1399/08/28,9,122,272957000,1427,2200,2200,773,54.17,2237,810,56.76,2200,2601,1399-7-20
807,اوصتا,صندوق انديشه ورزان صباتامين -د,9,52510,881487820,16883,16785,16797,-86,-0.51,16787,-96,-0.57,16785,16890,1399-7-20
808,فيروزه2,صندوق شاخص30 شركت فيروزه- سهام,8,80000,80000,194620,1,1,-194619,-100.0,1,-194619,-100.0,1,1,1399-7-20
809,ضجار7019,اختيارخ وتجارت-2200-1399/07/22,8,235,309734000,1138,1200,1260,122,10.72,1318,180,15.82,1112,1350,1399-7-20
810,اطلس2,صندوق س.توسعه اندوخته آينده-س,8,80000,80000,201128,1,1,-201127,-100.0,1,-201127,-100.0,1,1,1399-7-20
811,ضپاس7017,اختيارخ وپارس-4400-1399/07/30,8,158,47044000,321,599,200,-121,-37.69,298,-23,-7.17,200,599,1399-7-20
812,تملي711,تسهيلات مسكن ب. ملي-بهمن97,8,105,91754250,832239,873850,873850,41611,5.0,873850,41611,5.0,873850,873850,1399-7-20
813,هنفت912,اختيارف ت نفت-15330-99/12/04,7,100000,100000,1,1,1,0,0.0,1,0,0.0,1,1,1399-7-20
814,ضفلا8060,اختيارخ فولاد-3507-1399/08/28,7,33,781488000,14110,15000,14200,90,0.64,14727,617,4.37,14200,15100,1399-7-20
815,وپست2,پست بانك ايران,7,1183716,13861314360,11160,11710,11710,550,4.93,11710,550,4.93,11710,11710,1399-7-20
816,ضصاد8008,اختيارخ وبصادر-2000-1399/08/11,7,90,220592000,2200,2650,2201,1,0.05,2451,251,11.41,2201,2650,1399-7-20
817,ضغدر8038,اختيارخ وغدير-11000-1399/08/26,7,263,1709500000,5650,1501,6500,850,15.04,6500,850,15.04,6500,6500,1399-7-20
818,اخزا723,اسنادخزانه-م23بودجه97-000824,7,393,325509388,828221,830000,828276,55,0.01,828268,47,0.01,828156,830000,1399-7-20
819,ضترا8023,اختيارخ شتران-4886-1399/08/11,7,19,362824000,11538,11200,11200,-338,-2.93,11200,-338,-2.93,11200,11200,1399-7-20
820,گكيش,توريستي ورفاهي آبادگران كيش,7,6307,445375112,72800,70616,70616,-2184,-3.0,72750,-50,-0.07,70616,70616,1399-7-20
821,ضملي1154,اختيارخ فملي-24336-1399/11/05,7,72,174604000,2540,2950,1200,-1340,-52.76,2425,-115,-4.53,1200,2950,1399-7-20
822,ضپار8019,اختيارخ خپارس-3800-1399/08/18,7,46,279600000,4000,6000,6000,2000,50.0,6078,2078,51.95,6000,6500,1399-7-20
823,ضپاس1000,اختيارخ وپارس-2000-1399/10/30,6,44,181200000,3025,10000,3300,275,9.09,4118,1093,36.13,3300,10000,1399-7-20
824,ضفار1121,اختيارخ فارس-9826-1399/11/07,6,55,836000000,15211,15200,15200,-11,-0.07,15200,-11,-0.07,15200,15200,1399-7-20
825,ضپنا1023,اختيارخ رمپنا-21506-1399/10/09,6,70,673855000,6000,6500,6500,500,8.33,6500,500,8.33,6500,6500,1399-7-20
826,ضصاد8011,اختيارخ وبصادر-2600-1399/08/11,6,66,138215000,1839,2089,2000,161,8.75,2094,255,13.87,2000,2100,1399-7-20
827,اخزا805,اسنادخزانه-م5بودجه98-000422,6,10815,9548808346,883332,882106,883106,-226,-0.03,882923,-409,-0.05,882106,884000,1399-7-20
828,زير0003پ01,زيره سبز0003كيميابذر(پ),6,1096,558880086,506072,500000,510000,3928,0.78,509927,3855,0.76,499999,520008,1399-7-20
829,شلرد02,كود شيميايي اوره لردگان,6,590,588235500,990800,1039500,991010,210,0.02,997009,6209,0.63,991000,1039500,1399-7-20
830,اخزا804,اسنادخزانه-م4بودجه98-000421,6,3289,2908128456,882824,883552,884500,1676,0.19,884198,1374,0.16,883552,884700,1399-7-20
831,ضپاس7000,اختيارخ وپارس-1500-1399/07/30,6,49,124753000,2972,2507,2506,-466,-15.68,2546,-426,-14.33,2506,2610,1399-7-20
832,ضسپا8019,اختيارخ خساپا-2600-1399/08/26,6,134,86456000,502,622,600,98,19.52,645,143,28.49,600,700,1399-7-20
833,ضغدر8045,اختيارخ وغدير-18000-1399/08/26,5,8,15002000,1495,1501,2000,505,33.78,1875,380,25.42,1501,2000,1399-7-20
834,ضترا8022,اختيارخ شتران-4593-1399/08/11,5,18,368300460,16332,13000,11501,-4831,-29.58,12001,-4331,-26.52,11501,13000,1399-7-20
835,ضغدر8033,اختيارخ وغدير-8010-1399/08/26,5,70,644400000,8000,9200,9600,1600,20.0,9206,1206,15.08,9200,9600,1399-7-20
836,ضپاس7015,اختيارخ وپارس-4000-1399/07/30,5,87,41592000,581,450,501,-80,-13.77,478,-103,-17.73,99,588,1399-7-20
837,ضغدر8042,اختيارخ وغدير-15000-1399/08/26,5,34,98340000,2072,3100,2820,748,36.1,2892,820,39.58,2820,3100,1399-7-20
838,معيار,سرمايه گذاري معيار صنعت پارس,5,6402,187008822,29807,29211,29211,-596,-2.0,29796,-11,-0.04,29211,29211,1399-7-20
839,ضصاد8023,اختيارخ وبصادر-5000-1399/08/11,5,49,11698000,109,200,251,142,130.28,239,130,119.27,200,252,1399-7-20
840,عيار2,صندوق س. پشتوانه طلاي مفيد,4,40000,40000,38691,1,1,-38690,-100.0,1,-38690,-100.0,1,1,1399-7-20
841,ضپيك1024,اختيارخ تاپيكو-24000-99/10/16,4,4,15000000,5000,3900,3700,-1300,-26.0,3750,-1250,-25.0,3700,3900,1399-7-20
842,تملي709,تسهيلات مسكن ب. ملي-آذر97,4,48,24914976,494345,519062,519062,24717,5.0,519062,24717,5.0,519062,519062,1399-7-20
843,شسم,توليد سموم‌ علف‌ كش,4,2914,237622130,79947,81545,81545,1598,2.0,79984,37,0.05,81545,81545,1399-7-20
844,ضپنا1020,اختيارخ رمپنا-13406-1399/10/09,4,18,329152250,12500,12650,12000,-500,-4.0,12347,-153,-1.22,12000,12650,1399-7-20
845,ضجار7020,اختيارخ وتجارت-2400-1399/07/22,4,56,56410000,884,1000,1010,126,14.25,1007,123,13.91,1000,1010,1399-7-20
846,تملي704,تسهيلات مسكن ب. ملي-تير97,4,16,24855184,1479476,1553449,1553449,73973,5.0,1553449,73973,5.0,1553449,1553449,1399-7-20
847,ضفار8044,اختيارخ فارس-19826-1399/08/06,4,40,12930000,120,101,101,-19,-15.83,323,203,169.17,101,990,1399-7-20
848,ضفلا8086,اختيارخ فولاد-17775-1399/08/28,4,9,25080000,2500,2720,2800,300,12.0,2787,287,11.48,2720,3000,1399-7-20
849,ضملي8082,اختيارخ فملي-39750-1399/08/06,4,34,7624000,117,400,151,34,29.06,224,107,91.45,151,400,1399-7-20
850,ضفار8037,اختيارخ فارس-12826-1399/08/06,4,48,214500000,4500,4500,3800,-700,-15.56,4469,-31,-0.69,3800,4500,1399-7-20
851,زير0003پ02,زيره سبز0003 دانش(پ),4,118,56753380,493793,480769,481000,-12793,-2.59,480961,-12832,-2.6,480769,481000,1399-7-20
852,ضسپا8020,اختيارخ خساپا-2800-1399/08/26,4,78,45476000,511,570,622,111,21.72,583,72,14.09,570,622,1399-7-20
853,ضفلا8084,اختيارخ فولاد-15775-1399/08/28,4,44,173360000,2511,2512,3300,789,31.42,3940,1429,56.91,3300,4000,1399-7-20
854,تملي612,تسهيلات مسكن بانك ملي-اسفند96,4,16,78049312,4645793,4878082,4878082,232289,5.0,4878082,232289,5.0,4878082,4878082,1399-7-20
855,تملي803,تسهيلات مسكن ب. ملي-خرداد98,4,56,16621136,282673,296806,296806,14133,5.0,296806,14133,5.0,296806,296806,1399-7-20
856,اجاد25,اجاره دولتي آپرورش-سپهر991118,4,50000,50000000000,1000004,1000000,1000000,-4,0.0,1000000,-4,0.0,1000000,1000000,1399-7-20
857,تملي710,تسهيلات مسكن ب. ملي-دي97,3,29,19293120,633600,665280,665280,31680,5.0,665280,31680,5.0,665280,665280,1399-7-20
858,ضسپا8017,اختيارخ خساپا-2200-1399/08/26,3,51,50758000,700,995,808,108,15.43,995,295,42.14,808,1000,1399-7-20
859,ضغدر8044,اختيارخ وغدير-17000-1399/08/26,3,11,22000000,1338,2000,2000,662,49.48,2000,662,49.48,2000,2000,1399-7-20
860,ضپيك1019,اختيارخ تاپيكو-12000-99/10/16,3,21,244500000,11067,12000,11150,83,0.75,11643,576,5.2,11150,12100,1399-7-20
861,ضفلا8068,اختيارخ فولاد-4751-1399/08/28,3,15,315703464,12871,13333,13000,129,1.0,13089,218,1.69,13000,13333,1399-7-20
862,ضصاد8000,اختيارخ وبصادر-1200-1399/08/11,3,10,30380000,2968,3000,3380,412,13.88,3038,70,2.36,3000,3380,1399-7-20
863,تملي806,تسهيلات مسكن ب. ملي-شهريور98,3,54,14923278,263198,276357,276357,13159,5.0,276357,13159,5.0,276357,276357,1399-7-20
864,ضپيك7024,اختيارخ تاپيكو-11370-99/07/20,3,50,340400000,7200,7000,6800,-400,-5.56,6808,-392,-5.44,6800,7000,1399-7-20
865,تملي804,تسهيلات مسكن ب. ملي-تير98,3,65,25494300,373543,392220,392220,18677,5.0,392220,18677,5.0,392220,392220,1399-7-20
866,ضخوز1013,اختيارخ فخوز-10667-1399/10/16,3,25,450750000,14000,17850,18100,4100,29.29,18030,4030,28.79,17850,18100,1399-7-20
867,وثخوز,سرمايه گذاري و توسعه خوزستان,3,626,22820830,37582,36455,36455,-1127,-3.0,37581,-1,0.0,36455,36455,1399-7-20
868,اخزا9022,اسنادخزانه-م2بودجه99-011019,3,375000,249000000000,654847,664000,664000,9153,1.4,664000,9153,1.4,664000,664000,1399-7-20
869,صگل411,ص اجاره گل گهر 411- 3 ماهه 17%,3,1026,1025870000,1020134,1000000,995000,-25134,-2.46,999873,-20261,-1.99,995000,1000000,1399-7-20
870,ومشان,س. فني و مهندسي مشانير,3,600,34492800,59265,57488,57488,-1777,-3.0,59262,-3,-0.01,57488,57488,1399-7-20
871,ضپيك7020,اختيارخ تاپيكو-8370-1399/07/20,3,15,166620000,9999,11000,10655,656,6.56,11108,1109,11.09,10655,12500,1399-7-20
872,زعف9908پ06,زعفران 9908پوشالمعمول زرين(پ),3,900,77552100,81130,86169,86169,5039,6.21,86169,5039,6.21,86169,86169,1399-7-20
873,ضخوز7028,اختيارخ فخوز-43470-1399/07/20,3,43,11041000,3,5500,1,-2,-66.67,257,254,8466.67,1,5500,1399-7-20
874,صمسكن912,ص دين مسكن جنوب-ماهانه16درصد,3,501,56282841,118253,112341,112341,-5912,-5.0,112341,-5912,-5.0,112341,112341,1399-7-20
875,ضغدر8041,اختيارخ وغدير-14000-1399/08/26,3,13,47488000,2500,3222,3900,1400,56.0,3653,1153,46.12,3222,3900,1399-7-20
876,ضپاس7018,اختيارخ وپارس-4600-1399/07/30,3,100,20000000,96,200,200,104,108.33,200,104,108.33,200,200,1399-7-20
877,تملي802,تسهيلات مسكن ب. ملي-ارديبهشت98,3,18,17838126,943817,991007,991007,47190,5.0,991007,47190,5.0,991007,991007,1399-7-20
878,تملي701,تسهيلات مسكن ب. ملي-فروردين97,3,36,37378080,988839,1038280,1038280,49441,5.0,1038280,49441,5.0,1038280,1038280,1399-7-20
879,ضفلا8082,اختيارخ فولاد-13775-1399/08/28,3,14,70010000,4350,5000,5001,651,14.97,5001,651,14.97,5000,5001,1399-7-20
880,اخزا718,اسنادخزانه-م18بودجه97-000525,3,14197,12301663866,872481,866328,866501,-5980,-0.69,866497,-5984,-0.69,866328,866502,1399-7-20
881,تملي707,تسهيلات مسكن ب. ملي-مهر97,2,8,6188936,736779,773617,773617,36838,5.0,773617,36838,5.0,773617,773617,1399-7-20
882,بفجر2,فجر انرژي خليج فارس,2,2001252,68963143920,32970,34460,34460,1490,4.52,34460,1490,4.52,34460,34460,1399-7-20
883,ضبدر8060,اختيارخ شبندر-29580-1399/08/18,2,2,21000000,9696,11000,10000,304,3.14,10500,804,8.29,10000,11000,1399-7-20
884,وسبوشهر,شركت س استان بوشهر,2,74049,93301740,1000,1260,1260,260,26.0,1260,260,26.0,1260,1260,1399-7-20
885,ضپار1115,اختيارخ خپارس-5000-1399/11/19,2,10,70000000,5750,7000,7000,1250,21.74,7000,1250,21.74,7000,7000,1399-7-20
886,ضسپا8016,اختيارخ خساپا-2000-1399/08/26,2,40,42040000,1000,1051,1051,51,5.1,1051,51,5.1,1051,1051,1399-7-20
887,آگاس2,صندوق س.هستي بخش آگاه-س,2,1000000,1000000,74383,1,1,-74382,-100.0,1,-74382,-100.0,1,1,1399-7-20
888,تملي805,تسهيلات مسكن ب. ملي-مرداد98,2,50,16095500,306581,321910,321910,15329,5.0,321910,15329,5.0,321910,321910,1399-7-20
889,ضملي8067,اختيارخ فملي -14750-1399/08/06,2,24,348000000,12108,14500,14500,2392,19.76,14500,2392,19.76,14500,14500,1399-7-20
890,صگل1411,ص اجاره گل گهر 1411-3 ماهه 17%,2,90,87301200,970352,970000,970030,-322,-0.03,970013,-339,-0.03,970000,970030,1399-7-20
891,اميد99,مشارکت ليزينگ اميد9907,2,388,388000000,1000141,1000000,1000000,-141,-0.01,1000000,-141,-0.01,1000000,1000000,1399-7-20
892,تملي801,تسهيلات مسكن ب. ملي-فروردين98,2,20,11919860,567613,595993,595993,28380,5.0,595993,28380,5.0,595993,595993,1399-7-20
893,زعف9908پ12,زعفران9908پوشالمعمول سحرخيز(پ),2,180,15510420,82166,86169,86169,4003,4.87,86169,4003,4.87,86169,86169,1399-7-20
894,صايپا012,صكوك مرابحه سايپا012-3ماهه 16%,2,31,30576143,993002,1006591,973529,-19473,-1.96,986327,-6675,-0.67,973529,1006591,1399-7-20
895,خودرو2,ايران‌ خودرو,2,4318,15458440,3410,3580,3580,170,4.99,3580,170,4.99,3580,3580,1399-7-20
896,ضفلا8090,اختيارخ فولاد-23775-1399/08/28,2,20,16363000,850,850,759,-91,-10.71,818,-32,-3.76,759,850,1399-7-20
897,اعتماد2,صندوق س.اعتماد آفرين پارسيان-د,2,15000000,15000000,32744,1,1,-32743,-100.0,1,-32743,-100.0,1,1,1399-7-20
898,ضغدر8030,اختيارخ وغدير-6510-1399/08/26,2,3,32098000,9150,10699,10700,1550,16.94,10699,1549,16.93,10699,10700,1399-7-20
899,ضسان1039,اختيارخ پارسان-20000-99/10/14,2,10,114000000,10660,11000,12000,1340,12.57,11400,740,6.94,11000,12000,1399-7-20
900,ضفلا8080,اختيارخ فولاد-11775-1399/08/28,2,8,54010000,5967,6300,7022,1055,17.68,6751,784,13.14,6300,7022,1399-7-20
901,وسزنجان,شركت س استان زنجان,2,30650,45975000,1430,1500,1500,70,4.9,1430,0,0.0,1500,1500,1399-7-20
902,ضپاس7013,اختيارخ وپارس-3600-1399/07/30,2,13,14000000,838,1100,1000,162,19.33,1077,239,28.52,1000,1100,1399-7-20
903,ضجار1010,اختيارخ وتجارت-1600-1399/10/21,2,27,58780000,2344,3000,1990,-354,-15.1,2177,-167,-7.12,1990,3000,1399-7-20
904,ضپنا1022,اختيارخ رمپنا-18806-1399/10/09,2,10,122182500,9249,8500,8000,-1249,-13.5,8250,-999,-10.8,8000,8500,1399-7-20
905,زعف9908پ08,زعفران9908نگين روستا(پ),2,200,20276600,97015,101383,101383,4368,4.5,101383,4368,4.5,101383,101383,1399-7-20
906,ضفار8040,اختيارخ فارس-15826-1399/08/06,2,11,12000000,1000,2000,1000,0,0.0,1091,91,9.1,1000,2000,1399-7-20
907,ضجار1011,اختيارخ وتجارت-1800-1399/10/21,2,5,9200000,1792,2000,1800,8,0.45,1840,48,2.68,1800,2000,1399-7-20
908,ضسپا8033,اختيارخ خساپا-6000-1399/08/26,2,3,179000,134,99,40,-94,-70.15,60,-74,-55.22,40,99,1399-7-20
909,تملي706,تسهيلات مسكن ب. ملي-شهريور97,2,12,4812624,381955,401052,401052,19097,5.0,401052,19097,5.0,401052,401052,1399-7-20
910,تملي809,تسهيلات مسكن ب. ملي-آذر98,2,42,8753934,198502,208427,208427,9925,5.0,208427,9925,5.0,208427,208427,1399-7-20
911,اخزا722,اسنادخزانه-م22بودجه97-000428,2,411,361291164,879348,878854,879349,1,0.0,879054,-294,-0.03,878854,879349,1399-7-20
912,تملي712,تسهيلات مسكن ب. ملي-اسفند97,2,13,12227241,895769,940557,940557,44788,5.0,940557,44788,5.0,940557,940557,1399-7-20
913,ضفلا8079,اختيارخ فولاد-10775-1399/08/28,1,2,19996000,7500,9998,9998,2498,33.31,9998,2498,33.31,9998,9998,1399-7-20
914,ساراب2,سيمان‌ داراب‌,1,282,3775980,13500,13390,13390,-110,-0.81,13390,-110,-0.81,13390,13390,1399-7-20
915,ضگل8057,اختيارخ كگل-13100-1399/08/21,1,46,414000000,8718,9000,9000,282,3.23,9000,282,3.23,9000,9000,1399-7-20
916,اروند01,منفعت صبا اروند اميد14001113,1,10,8625830,862582,862583,862583,1,0.0,862583,1,0.0,862583,862583,1399-7-20
917,عپلي جم,سلف پلي اتيلن سنگين تزريقي,1,10,13826540,1396350,1382654,1382654,-13696,-0.98,1382654,-13696,-0.98,1382654,1382654,1399-7-20
918,تابان02,اجاره تابان لوتوس14021206,1,2000,1822000000,915000,911000,911000,-4000,-0.44,911000,-4000,-0.44,911000,911000,1399-7-20
919,كشم0001پ01,كشمش سبز0001خليل آباد(پ),1,12,5034240,441599,419520,419520,-22079,-5.0,419520,-22079,-5.0,419520,419520,1399-7-20
920,ضبدر8064,اختيارخ شبندر-37580-1399/08/18,1,3,21066000,6510,7022,7022,512,7.86,7022,512,7.86,7022,7022,1399-7-20
921,فولاژ2,فولاد آلياژي ايران,1,935,24983200,27070,26720,26720,-350,-1.29,26720,-350,-1.29,26720,26720,1399-7-20
922,ورنا2,سرمايه‌گذاري‌ رنا(هلدينگ‌,1,92,1042360,10870,11330,11330,460,4.23,11330,460,4.23,11330,11330,1399-7-20
923,ضفار1120,اختيارخ فارس-8826-1399/11/07,1,5,85000000,16000,17000,17000,1000,6.25,17000,1000,6.25,17000,17000,1399-7-20
924,حكشتي2,كشتيراني جمهوري اسلامي ايران,1,1741,82453760,46050,47360,47360,1310,2.84,47360,1310,2.84,47360,47360,1399-7-20
925,ضغدر8039,اختيارخ وغدير-12000-1399/08/26,1,13,68250000,4700,5250,5250,550,11.7,5250,550,11.7,5250,5250,1399-7-20
926,شرق1400,مشاركت ليزينگ ايران وشرق140010,1,10,10394940,1021000,1039494,1039494,18494,1.81,1039494,18494,1.81,1039494,1039494,1399-7-20
927,ضمخا7052,اختيارخ اخابر-16750-1399/07/30,1,10,34500000,2900,3450,3450,550,18.97,3450,550,18.97,3450,3450,1399-7-20
928,تهران012,مشاركت ش تهران012-3ماهه18%,1,500,476525000,954815,953050,953050,-1765,-0.18,953050,-1765,-0.18,953050,953050,1399-7-20
929,ضصاد1105,اختيارخ وبصادر-5000-1399/11/12,1,10,10000000,1,1000,1000,999,99900.0,1000,999,99900.0,1000,1000,1399-7-20
930,ضپار1116,اختيارخ خپارس-6000-1399/11/19,1,1,4990000,4100,4990,4990,890,21.71,4990,890,21.71,4990,4990,1399-7-20
931,ضپيك7021,اختيارخ تاپيكو-8870-1399/07/20,1,1,9500000,17900,9500,9500,-8400,-46.93,9500,-8400,-46.93,9500,9500,1399-7-20
932,وبصادر2,بانك صادرات ايران,1,31543,147621240,4490,4680,4680,190,4.23,4680,190,4.23,4680,4680,1399-7-20
933,سدشت2,صنايع سيمان دشتستان,1,275,11063250,38320,40230,40230,1910,4.98,40230,1910,4.98,40230,40230,1399-7-20
934,ضصاد1107,اختيارخ وبصادر-7000-1399/11/12,1,100,40000000,1,400,400,399,39900.0,400,399,39900.0,400,400,1399-7-20
935,ضجار7031,اختيارخ وتجارت-4600-1399/07/22,1,1,1000,1,1,1,0,0.0,1,0,0.0,1,1,1399-7-20
936,ضپاس7021,اختيارخ وپارس-5500-1399/07/30,1,80,1200000,128,15,15,-113,-88.28,15,-113,-88.28,15,15,1399-7-20
937,ضفلا8070,اختيارخ فولاد-5775-1399/08/28,1,1,12000000,11000,12000,12000,1000,9.09,12000,1000,9.09,12000,12000,1399-7-20
938,جم2,پتروشيمي جم,1,759,36834270,47330,48530,48530,1200,2.54,48530,1200,2.54,48530,48530,1399-7-20
939,رمپنا2,گروه مپنا (سهامي عام),1,6055,140052150,22070,23130,23130,1060,4.8,23130,1060,4.8,23130,23130,1399-7-20
940,دمعيار2,صندوق س. توازن معيار-د,1,500000,500000,10036,1,1,-10035,-99.99,1,-10035,-99.99,1,1,1399-7-20
941,ضغدر8046,اختيارخ وغدير-19000-1399/08/26,1,1,600000,997,600,600,-397,-39.82,600,-397,-39.82,600,600,1399-7-20
942,شيراز2,پتروشيمي‌شيراز,1,1600000,101232000000,60260,63270,63270,3010,5.0,63270,3010,5.0,63270,63270,1399-7-20
943,اروند10,منفعت صبا اروند لوتوس 14001222,1,430,453650000,1045000,1055000,1055000,10000,0.96,1055000,10000,0.96,1055000,1055000,1399-7-20
944,سنفت001,سلف موازي استاندارد سنفت001,1,47810,50001132300,1038540,1045830,1045830,7290,0.7,1045830,7290,0.7,1045830,1045830,1399-7-20
945,ضفلا8093,اختيارخ فولاد-29775-1399/08/28,1,5,2000000,207,400,400,193,93.24,400,193,93.24,400,400,1399-7-20
946,ضپيك1021,اختيارخ تاپيكو-16000-99/10/16,1,1,8500000,7800,8500,8500,700,8.97,8500,700,8.97,8500,8500,1399-7-20
947,بسويچ2,پارس‌سويچ‌,1,298,13088160,44930,43920,43920,-1010,-2.25,43920,-1010,-2.25,43920,43920,1399-7-20
948,ضفار8041,اختيارخ فارس-16826-1399/08/06,1,24,16800000,431,700,700,269,62.41,700,269,62.41,700,700,1399-7-20
949,اشاد102,مشاركت دولتي10-شرايط خاص001226,1,69,64860000,959808,940000,940000,-19808,-2.06,940000,-19808,-2.06,940000,940000,1399-7-20
950,ضپاس7019,اختيارخ وپارس-4800-1399/07/30,1,15,1950000,10,130,130,120,1200.0,130,120,1200.0,130,130,1399-7-20
951,ضترا8024,اختيارخ شتران-5181-1399/08/11,1,10,187550000,31000,11000,11000,-20000,-64.52,11000,-20000,-64.52,11000,11000,1399-7-20
952,ضبدر8070,اختيارخ شبندر-59580-1399/08/18,1,1,170000,150,170,170,20,13.33,170,20,13.33,170,170,1399-7-20
953,ضغدر8047,اختيارخ وغدير-20000-1399/08/26,1,15,150000,660,10,10,-650,-98.48,10,-650,-98.48,10,10,1399-7-20
954,صخود0004,صكوك رهني خودرو0004- 3ماهه 16%,1,5,4850000,970000,970000,970000,0,0.0,970000,0,0.0,970000,970000,1399-7-20
955,دانا2,بيمه دانا,1,1147,8935130,7440,7790,7790,350,4.7,7790,350,4.7,7790,7790,1399-7-20
956,ثباغ2,شهر سازي و خانه سازي باغميشه,1,4000000,105092000000,25022,26273,26273,1251,5.0,26273,1251,5.0,26273,26273,1399-7-20
957,زعف9908پ11,زعفران9908نگين سحرخيز(پ),1,70,7096810,97015,101383,101383,4368,4.5,101383,4368,4.5,101383,101383,1399-7-20
958,ضصاد1104,اختيارخ وبصادر-4500-1399/11/12,1,10,14000000,1236,1400,1400,164,13.27,1400,164,13.27,1400,1400,1399-7-20
959,ضبدر8067,اختيارخ شبندر-47580-1399/08/18,1,25,125000,75,5,5,-70,-93.33,5,-70,-93.33,5,5,1399-7-20
960,شبريز2,پالايش نفت تبريز,1,755,26055050,32870,34510,34510,1640,4.99,34510,1640,4.99,34510,34510,1399-7-20
961,وتوصا2,گروه س توسعه صنعتي ايران,1,671,9380580,13410,13980,13980,570,4.25,13980,570,4.25,13980,13980,1399-7-20
962,اشاد10,مشاركت دولتي10-شرايط خاص001226,1,200,190000000,959808,950000,950000,-9808,-1.02,950000,-9808,-1.02,950000,950000,1399-7-20
963,تملي703,تسهيلات مسكن ب. ملي-خرداد97,1,5,2449565,466584,489913,489913,23329,5.0,489913,23329,5.0,489913,489913,1399-7-20
964,ضپيك7028,اختيارخ تاپيكو-15370-99/07/20,1,5,30000000,6200,6000,6000,-200,-3.23,6000,-200,-3.23,6000,6000,1399-7-20
965,تملي708,تسهيلات مسكن ب. ملي-آبان97,1,10,3128490,297952,312849,312849,14897,5.0,312849,14897,5.0,312849,312849,1399-7-20
966,كگل2,معدني و صنعتي گل گهر,1,3148,69633760,21530,22120,22120,590,2.74,22120,590,2.74,22120,22120,1399-7-20
967,فايرا2,آلومينيوم‌ايران‌,1,984,18735360,18270,19040,19040,770,4.21,19040,770,4.21,19040,19040,1399-7-20
968,ضغدر8035,اختيارخ وغدير-9000-1399/08/26,1,1,8500000,1000,8500,8500,7500,750.0,8500,7500,750.0,8500,8500,1399-7-20
969,ضخوز1016,اختيارخ فخوز-15238-1399/10/16,1,1,8000000,8000,8000,8000,0,0.0,8000,0,0.0,8000,8000,1399-7-20
970,تملي702,تسهيلات مسكن ب. ملي-ارديبهشت97,1,6,5366628,851846,894438,894438,42592,5.0,894438,42592,5.0,894438,894438,1399-7-20
971,ضفلا8089,اختيارخ فولاد-21775-1399/08/28,1,20,17000000,800,850,850,50,6.25,850,50,6.25,850,850,1399-7-20
972,غيوان,كيوان,1,500,7718500,15285,15437,15437,152,0.99,15285,0,0.0,15437,15437,1399-7-20
973,شبندر2,پالايش نفت بندرعباس,1,2261,91344400,38680,40400,40400,1720,4.45,40400,1720,4.45,40400,40400,1399-7-20
974,ضملي8076,اختيارخ فملي -27750-1399/08/06,1,24,81600000,2001,3400,3400,1399,69.92,3400,1399,69.92,3400,3400,1399-7-20
975,ضمخا7050,اختيارخ اخابر-14750-1399/07/30,1,2,6000000,2000,3000,3000,1000,50.0,3000,1000,50.0,3000,3000,1399-7-20
976,دومينو4,اجاره دومينو14040208,1,500,475000000,950000,950000,950000,0,0.0,950000,0,0.0,950000,950000,1399-7-20
977,ضجار7028,اختيارخ وتجارت-4000-1399/07/22,1,5,5000,1,1,1,0,0.0,1,0,0.0,1,1,1399-7-20
978,كايتا,ايتالران‌,1,500,4864000,9265,9728,9728,463,5.0,9265,0,0.0,9728,9728,1399-7-20
979,فارس2,صنايع پتروشيمي خليج فارس,1,19111,591867670,29860,30970,30970,1110,3.72,30970,1110,3.72,30970,30970,1399-7-20
980,صخابر102,صكوك اجاره مخابرات-3 ماهه 16%,1,2637,2481417000,955658,941000,941000,-14658,-1.53,941000,-14658,-1.53,941000,941000,1399-7-20
981,اخزا7132,اسنادخزانه-م13بودجه97-000518,1,104539,90531192156,866004,866004,866004,0,0.0,866004,0,0.0,866004,866004,1399-7-20
982,اخزا720,اسنادخزانه-م20بودجه97-000324,1,1000,892503000,894810,892503,892503,-2307,-0.26,892503,-2307,-0.26,892503,892503,1399-7-20
983,كچاد2,معدني‌وصنعتي‌چادرملو,1,3864,77820960,19350,20140,20140,790,4.08,20140,790,4.08,20140,20140,1399-7-20
984,تملي705,تسهيلات مسكن ب. ملي-مرداد97,1,10,5882140,560204,588214,588214,28010,5.0,588214,28010,5.0,588214,588214,1399-7-20
985,خساپا2,سايپا,1,1141,3377360,2820,2960,2960,140,4.96,2960,140,4.96,2960,2960,1399-7-20
986,ضصاد8022,اختيارخ وبصادر-4800-1399/08/11,1,50,15000000,200,300,300,100,50.0,300,100,50.0,300,300,1399-7-20
987,مبين014,اجاره اعتماد مبين لوتوس011019,1,2000,1910000000,974000,955000,955000,-19000,-1.95,955000,-19000,-1.95,955000,955000,1399-7-20
988,ضفلا8091,اختيارخ فولاد-25775-1399/08/28,1,1,501000,500,501,501,1,0.2,501,1,0.2,501,501,1399-7-20
989,ضچاد1012,اختيارخ كچاد-10000-1399/10/02,1,1,12000000,11000,12000,12000,1000,9.09,12000,1000,9.09,12000,12000,1399-7-20
990,انرژي12,نهادهاي مالي بورس انرژي,1,1274900,438922572000,362390,344280,344280,-18110,-5.0,344280,-18110,-5.0,344280,344280,1399-7-20
991,كمند2,صندوق س. با درآمد ثابت كمند,1,140000000,140000000,10030,1,1,-10029,-99.99,1,-10029,-99.99,1,1,1399-7-20
992,اعتماد4,صندوق س.اعتماد آفرين پارسيان-د,1,30000000,983220000000,32744,32774,32774,30,0.09,32774,30,0.09,32774,32774,1399-7-20
993,صايپا203,صكوك مرابحه سايپا203-3ماهه 16%,1,10,9510000,951000,951000,951000,0,0.0,951000,0,0.0,951000,951000,1399-7-20
994,صايپا998,صكوك مرابحه سايپا998-3ماهه 18%,1,6,5969706,994952,994951,994951,-1,0.0,994951,-1,0.0,994951,994951,1399-7-20
995,ضصاد8002,اختيارخ وبصادر-1400-1399/08/11,1,1,2240000,3100,2240,2240,-860,-27.74,2240,-860,-27.74,2240,2240,1399-7-20
