,نماد,نام,تعداد,حجم,ارزش,دیروز,اولین,آخرین معامله - مقدار,آخرین معامله - تغییر,آخرین معامله - درصد,قیمت پایانی - مقدار,قیمت پایانی - تغییر,قیمت پایانی - درصد,کمترین,بیشترین,تاریخ
0,پيزد,مجتمع صنايع لاستيك يزد,142106,10587492,1040653116986,99148,94191,95701,-3447,-3.48,98291,-857,-0.86,94191,101723,1399-8-24
1,وپويا,سرمايه گذاري پويا,100740,117208619,1265575720507,10864,10321,10552,-312,-2.87,10798,-66,-0.61,10321,11270,1399-8-24
2,وسپهر,سرمايه گذاري مالي سپهرصادرات,80696,223390089,2931837631413,11358,13300,13153,1795,15.8,13124,1766,15.55,12635,13960,1399-8-24
3,دارا يكم,صندوق واسطه گري مالي يكم-سهام,70939,35017980,6710239778080,181240,185700,194380,13140,7.25,191620,10380,5.73,185300,194780,1399-8-24
4,ثشاهد,سرمايه‌ گذاري‌ شاهد,46169,152413742,4080184892150,27480,26110,26150,-1330,-4.84,26770,-710,-2.58,26110,28310,1399-8-24
5,زملارد,كشاورزي و دامپروري ملارد شير,42562,5526604,214195024203,37220,38480,39081,1861,5.0,38757,1537,4.13,37300,39081,1399-8-24
6,بپيوند,برق و انرژي پيوندگستر پارس,41560,38754408,991874894390,23632,24800,25995,2363,10.0,25594,1962,8.3,24700,25995,1399-8-24
7,شاروم,پتروشيمي اروميه,28002,9590217,194432737968,19395,20190,20364,969,5.0,20274,879,4.53,19600,20364,1399-8-24
8,گدنا,تهيه توزيع غذاي دنا آفرين فدك,24396,6354459,120731057862,18200,18998,19110,910,5.0,18999,799,4.39,18401,19110,1399-8-24
9,ونيرو,سرمايه‌گذاري‌نيرو,22118,325220670,1468676793950,4610,4380,4580,-30,-0.65,4520,-90,-1.95,4380,4770,1399-8-24
10,بگيلان,توسعه مسير برق گيلان,21010,7489156,203713783901,26111,26870,27416,1305,5.0,27201,1090,4.17,26210,27416,1399-8-24
11,سيتا,سرمايه گذاري سيمان تامين,20870,31487537,566089761430,17230,17570,18090,860,4.99,17980,750,4.35,17230,18090,1399-8-24
12,ثاميد,توسعه و عمران اميد,20507,40564476,96137808120,2260,2370,2370,110,4.87,2370,110,4.87,2370,2370,1399-8-24
13,غزر,صنعتي زر ماكارون,20176,4007506,200796370430,47920,48000,50310,2390,4.99,50110,2190,4.57,48000,50310,1399-8-24
14,آبادا,توليد نيروي برق آبادان,19496,6079501,109829523050,17250,17730,18110,860,4.99,18070,820,4.75,17390,18110,1399-8-24
15,امين,تامين سرمايه امين,18557,18906030,223171283520,11320,11550,11880,560,4.95,11800,480,4.24,11400,11880,1399-8-24
16,ومعادن,توسعه‌معادن‌وفلزات‌,17955,188293109,2628610140190,15990,13530,13990,-2000,-12.51,13960,-2030,-12.7,13530,14200,1399-8-24
17,ثبهساز,بهساز كاشانه تهران,16895,139836194,403894457960,2760,2880,2890,130,4.71,2890,130,4.71,2820,2890,1399-8-24
18,وساپا,سرمايه‌گذاري‌ سايپا,14995,179681318,1504012835910,8210,8000,8580,370,4.51,8370,160,1.95,7960,8620,1399-8-24
19,ولپارس,ليزينگ پارسيان,13710,2343532,11975448520,4870,5110,5110,240,4.93,4910,40,0.82,5110,5110,1399-8-24
20,رافزا,رايان هم افزا,13602,79154,2790732578,33579,35257,35257,1678,5.0,33668,89,0.27,35257,35257,1399-8-24
21,لپارس,پارس‌ الكتريك‌,13309,9385811,1538929506100,171660,163080,163080,-8580,-5.0,163960,-7700,-4.49,163080,170000,1399-8-24
22,خاذين,سايپاآذين‌,11448,112772434,747008501060,6800,6460,6540,-260,-3.82,6620,-180,-2.65,6460,6950,1399-8-24
23,بكام,كارخانجات توليدي شهيد قندي,10600,100924374,463968322070,4660,4760,4470,-190,-4.08,4600,-60,-1.29,4430,4790,1399-8-24
24,غشهداب,كشت و صنعت شهداب ناب خراسان,10586,106486076,508310663252,4773,4535,4925,152,3.18,4773,0,0.0,4535,4980,1399-8-24
25,ثعمرا,عمران و توسعه شاهد,10243,70251027,1104699382108,16390,15571,15571,-819,-5.0,15725,-665,-4.06,15571,16390,1399-8-24
26,دماوند,توليد نيروي برق دماوند,10212,12068689,813961175566,67771,64383,68500,729,1.08,67444,-327,-0.48,64383,69840,1399-8-24
27,ختور,رادياتور ايران‌,10195,18495489,874400586260,48330,45920,45920,-2410,-4.99,47280,-1050,-2.17,45920,49900,1399-8-24
28,فارس,صنايع پتروشيمي خليج فارس,10061,111254273,1414836677610,12850,12520,12910,60,0.47,12720,-130,-1.01,12520,13100,1399-8-24
29,خودرو,ايران‌ خودرو,9741,397035225,1353784747700,3250,3410,3410,160,4.92,3410,160,4.92,3360,3410,1399-8-24
30,انرژي3,سايراشخاص بورس انرژي,9680,2394663,717166168400,293610,297300,296250,2640,0.9,299490,5880,2.0,293100,306990,1399-8-24
31,آريا,پليمر آريا ساسول,9396,2022615,340635713429,160541,167150,168568,8027,5.0,168414,7873,4.9,164600,168568,1399-8-24
32,فولاد,فولاد مباركه اصفهان,8839,79522632,978816059980,11760,12200,12340,580,4.93,12310,550,4.68,12000,12340,1399-8-24
33,رانفور,خدمات‌انفورماتيك‌,8223,17171153,580006612570,34420,34400,33050,-1370,-3.98,33780,-640,-1.86,32700,35000,1399-8-24
34,پترول,گروه پتروشيمي س. ايرانيان,7927,55560448,733124651470,12690,12970,13320,630,4.96,13200,510,4.02,12600,13320,1399-8-24
35,خريخت,صنايع‌ريخته‌گري‌ايران‌,7741,99410479,469621377010,4880,4640,4640,-240,-4.92,4720,-160,-3.28,4640,4940,1399-8-24
36,وشهر,بانك شهر,7723,275321397,1918728287691,7111,6969,6969,-142,-2.0,6969,-142,-2.0,6969,7000,1399-8-24
37,فرابورس,فرابورس ايران,7131,16624419,768880503596,44864,44730,47107,2243,5.0,46250,1386,3.09,44700,47107,1399-8-24
38,صباح,ح . سرمايه گذاري صبا تامين,6826,37253359,212080214602,5440,5540,5712,272,5.0,5693,253,4.65,5500,5712,1399-8-24
39,شبندر,پالايش نفت بندرعباس,6812,32872444,773767679280,22500,23100,23620,1120,4.98,23540,1040,4.62,23100,23620,1399-8-24
40,غصينو,صنعتي مينو,5965,11386961,585954112552,51471,52170,48898,-2573,-5.0,51458,-13,-0.03,48898,54000,1399-8-24
41,شپترو,پتروشيمي آبادان,5815,93916516,395704943114,4334,4118,4258,-76,-1.75,4213,-121,-2.79,4118,4394,1399-8-24
42,خمهر,مهركام‌پارس‌,5695,53480608,367088143950,7060,6710,6780,-280,-3.97,6860,-200,-2.83,6710,7160,1399-8-24
43,خمحركه,نيرو محركه‌,5592,58449844,367288504140,6030,6130,6330,300,4.98,6280,250,4.15,6100,6330,1399-8-24
44,غپينو,پارس‌ مينو,5539,31985412,239272751870,7360,7720,7250,-110,-1.49,7480,120,1.63,7080,7720,1399-8-24
45,ساوه,سيمان ساوه,5420,2096492,96422204100,44194,44970,46403,2209,5.0,45992,1798,4.07,43200,46403,1399-8-24
46,غگيلا,شيرپاستوريزه پگاه گيلان,5331,89993,1578117248,16701,17536,17536,835,5.0,16726,25,0.15,17536,17536,1399-8-24
47,شيران,س. صنايع‌شيميايي‌ايران,5246,13858843,433080616490,30640,30640,31000,360,1.17,31250,610,1.99,30210,31980,1399-8-24
48,فاذر,صنايع‌ آذرآب‌,5032,18261394,517977872210,36860,28700,27270,-9590,-26.02,28360,-8500,-23.06,27270,30000,1399-8-24
49,وبصادر,بانك صادرات ايران,5021,152388480,414614261130,2600,2690,2730,130,5.0,2720,120,4.62,2660,2730,1399-8-24
50,سكرد,سيمان كردستان,4883,31219766,300193864730,10030,9530,9530,-500,-4.99,9620,-410,-4.09,9530,9910,1399-8-24
51,وبملت,بانك ملت,4823,119065371,536667828010,4310,4460,4520,210,4.87,4510,200,4.64,4360,4520,1399-8-24
52,خشرق,الكتريك‌ خودرو شرق‌,4791,16891771,321635936550,19750,18770,18770,-980,-4.96,19040,-710,-3.59,18770,19700,1399-8-24
53,حفارس,حمل و نقل بين المللي خليج فارس,4670,64449614,280264891730,4520,4300,4300,-220,-4.87,4350,-170,-3.76,4300,4490,1399-8-24
54,صبا,سرمايه گذاري صبا تامين,4652,20628593,155275960056,7206,7449,7566,360,5.0,7527,321,4.45,7206,7566,1399-8-24
55,لسرما,سرما آفرين‌,4443,9403444,288229444680,31670,30090,30090,-1580,-4.99,30650,-1020,-3.22,30090,32500,1399-8-24
56,قاسم,قاسم ايران,4427,22228720,302735904356,13151,13880,13340,189,1.44,13619,468,3.56,13186,14574,1399-8-24
57,خاهن,آهنگري‌ تراكتورسازي‌ ايران‌,4403,9608744,324464441110,34480,32950,33000,-1480,-4.29,33770,-710,-2.06,32760,34990,1399-8-24
58,قثابت,قند ثابت‌ خراسان‌,4315,4419715,326705561300,73340,73340,72300,-1040,-1.42,73920,580,0.79,69700,76440,1399-8-24
59,آگاس,صندوق س.هستي بخش آگاه-س,4286,9872190,639121675652,61278,63760,65100,3822,6.24,64740,3462,5.65,63003,65100,1399-8-24
60,كمند,صندوق س. با درآمد ثابت كمند,4152,186205097,1872661593200,10078,10080,10061,-17,-0.17,10057,-21,-0.21,10050,10080,1399-8-24
61,ورنا,سرمايه‌گذاري‌ رنا(هلدينگ‌,4099,38234733,323412208020,8200,8200,8610,410,5.0,8460,260,3.17,7900,8610,1399-8-24
62,سمگا,گروه سرمايه گذاري ميراث فرهنگي,4085,19968979,368761610086,18319,18250,18400,81,0.44,18467,148,0.81,18000,18830,1399-8-24
63,ولغدر,ليزينگ‌خودروغدير,3991,20668022,379144260890,18160,18600,17280,-880,-4.85,18340,180,0.99,17260,19060,1399-8-24
64,ثتران,سرمايه گذاري مسكن تهران,3989,51674106,269183682108,5433,5162,5162,-271,-4.99,5209,-224,-4.12,5162,5370,1399-8-24
65,غگل,گلوكوزان‌,3877,48832639,207032070540,4050,4190,4250,200,4.94,4240,190,4.69,4150,4250,1399-8-24
66,سپاها,سيمان‌سپاهان‌,3834,20019248,166650363770,8470,8050,8180,-290,-3.42,8320,-150,-1.77,8050,8650,1399-8-24
67,ذوب,سهامي ذوب آهن  اصفهان,3793,67797197,300351283707,4235,4360,4446,211,4.98,4430,195,4.6,4359,4446,1399-8-24
68,اميد,تامين سرمايه اميد,3568,21303587,236337709570,11370,10810,11100,-270,-2.37,11090,-280,-2.46,10810,11670,1399-8-24
69,وهور,مديريت انرژي اميد  تابان هور,3453,11036155,442595277532,41490,39520,39419,-2071,-4.99,40104,-1386,-3.34,39416,42000,1399-8-24
70,دفارا,داروسازي‌ فارابي‌,3414,6376654,372669435180,60600,57570,57900,-2700,-4.46,58440,-2160,-3.56,57570,60590,1399-8-24
71,قشير,قند شيروان قوچان و بجنورد,3375,10843559,248414791341,23971,22773,22773,-1198,-5.0,22909,-1062,-4.43,22773,23597,1399-8-24
72,خمحور,توليدمحورخودرو,3297,7496567,374760686530,51540,48970,50810,-730,-1.42,49990,-1550,-3.01,48970,52890,1399-8-24
73,شگويا,پتروشيمي تندگويان,3275,17015903,170008204178,9550,9901,10027,477,4.99,9991,441,4.62,9751,10027,1399-8-24
74,حتوكا,حمل‌ونقل‌توكا,3206,16217359,336982985170,21670,20590,20590,-1080,-4.98,20780,-890,-4.11,20590,21570,1399-8-24
75,وليز,ليزينگ‌ايران‌,3186,23228291,204072751640,9060,8760,8610,-450,-4.97,8790,-270,-2.98,8610,9430,1399-8-24
76,مرقام,ايران‌ارقام‌,2923,8394387,194202835090,22780,23750,22760,-20,-0.09,23130,350,1.54,21700,23750,1399-8-24
77,كالا,بورس كالاي ايران,2914,6019572,212118676360,34200,34860,35910,1710,5.0,35240,1040,3.04,33750,35910,1399-8-24
78,شپلي,پلي اكريل ايران,2905,34310273,187924289898,5468,5304,5632,164,3.0,5477,9,0.16,5304,5632,1399-8-24
79,بالاس,مهندسي ساختمان تاسيسات راه آهن,2736,3554179,162264183750,47201,44841,46500,-701,-1.49,45654,-1547,-3.28,44841,48500,1399-8-24
80,مدير,ص.س.مديريت ثروت ص.بازنشستگي-س,2657,13676467,137621638469,9286,9520,10214,928,9.99,10063,777,8.37,9520,10214,1399-8-24
81,ارزش,صندوق س ارزش آفرين بيدار-سهام,2623,16950120,169915328230,9250,9600,10170,920,9.95,10020,770,8.32,9510,10170,1399-8-24
82,غپاك,لبنيات‌ پاك‌,2612,13339734,163954966080,12720,12090,12090,-630,-4.95,12290,-430,-3.38,12090,12900,1399-8-24
83,غالبر,لبنيات‌ كالبر,2540,10260412,125255508710,12710,12080,12080,-630,-4.96,12210,-500,-3.93,12080,12710,1399-8-24
84,چفيبر,فيبر ايران‌,2536,28105801,196700483000,7020,6670,7370,350,4.99,7000,-20,-0.28,6670,7370,1399-8-24
85,ودي,بيمه  دي,2535,14711398,339066888623,20928,23200,23200,2272,10.86,23048,2120,10.13,22500,24200,1399-8-24
86,سرو,صندوق س سروسودمند مدبران-سهام,2529,3603369,212891585720,54710,57010,59900,5190,9.49,59080,4370,7.99,57010,59900,1399-8-24
87,اعتماد,صندوق س.اعتماد آفرين پارسيان-د,2496,83229920,2773239894390,33274,33320,33321,47,0.14,33320,46,0.14,33319,33328,1399-8-24
88,اپرداز,آتيه داده پرداز,2487,5743501,173998698698,30601,31200,29400,-1201,-3.92,30295,-306,-1.0,29200,31480,1399-8-24
89,شكربن,كربن‌ ايران‌,2477,2808321,197871543840,73560,69890,69890,-3670,-4.99,70460,-3100,-4.21,69890,74300,1399-8-24
90,فلوله,لوله‌وماشين‌سازي‌ايران‌,2448,10225119,221704349940,22740,21610,21610,-1130,-4.97,21680,-1060,-4.66,21610,22330,1399-8-24
91,طلا,صندوق س.پشتوانه طلاي لوتوس,2422,1199100,106606388667,89618,89666,87470,-2148,-2.4,88905,-713,-0.8,87000,90998,1399-8-24
92,سشرق,سيمان‌ شرق‌,2417,21106929,120104227950,5470,5610,5740,270,4.94,5690,220,4.02,5400,5740,1399-8-24
93,كساوه,صنايع‌ كاشي‌ و سراميك‌ سينا,2406,7644571,466774984830,58170,61070,61070,2900,4.99,61060,2890,4.97,60000,61070,1399-8-24
94,شصدف,صنعتي دوده فام,2383,506345,12153799035,22860,24003,24003,1143,5.0,23125,265,1.16,24003,24003,1399-8-24
95,ونوين,بانك‌اقتصادنوين‌,2375,81973602,384894564160,4480,4680,4700,220,4.91,4700,220,4.91,4570,4700,1399-8-24
96,واتي,سرمايه‌ گذاري‌ آتيه‌ دماوند,2369,23789804,316040844810,13910,13220,13250,-660,-4.74,13280,-630,-4.53,13220,13680,1399-8-24
97,تاپكيش,تجارت الكترونيك پارسيان كيش,2337,18545724,289450159400,14925,15671,15671,746,5.0,15607,682,4.57,15061,15671,1399-8-24
98,زدشت,كشت و صنعت دشت خرم دره,2306,7035179,239555673045,31270,33200,34397,3127,10.0,34051,2781,8.89,32750,34397,1399-8-24
99,كگازح,ح . شيشه‌ و گاز,2262,7821832,125598916820,14740,15000,16210,1470,9.97,16060,1320,8.96,14550,16210,1399-8-24
100,ثعتما,س. ساختماني اعتماد گستر,2218,6747836,212947130062,31878,30922,32834,956,3.0,31558,-320,-1.0,30922,32834,1399-8-24
101,سدور,سيمان‌ دورود,2212,15068057,116167359230,7980,7590,7770,-210,-2.63,7710,-270,-3.38,7590,7970,1399-8-24
102,وگستر,گسترش سرمايه گذاري ايرانيان,2205,5536224,106970266082,19312,18370,19640,328,1.7,19322,10,0.05,18370,19930,1399-8-24
103,خگستر,گسترش‌سرمايه‌گذاري‌ايران‌خودرو,2202,45774634,150140799520,3130,3280,3280,150,4.79,3280,150,4.79,3280,3280,1399-8-24
104,فملي,ملي‌ صنايع‌ مس‌ ايران‌,2178,11152980,232874222400,19890,20880,20880,990,4.98,20880,990,4.98,20880,20880,1399-8-24
105,قرن,پديده شيمي قرن,2175,3692972,204645678030,52950,53500,55590,2640,4.99,55410,2460,4.65,52960,55590,1399-8-24
106,نوري,پتروشيمي نوري,2173,2024616,370390047510,174460,181000,183180,8720,5.0,182940,8480,4.86,176110,183180,1399-8-24
107,اتكام,شركت بيمه اتكايي امين,2163,16532652,124865508652,7850,7458,7470,-380,-4.84,7553,-297,-3.78,7458,7840,1399-8-24
108,شتران,پالايش نفت تهران,2135,21595411,216601972330,9560,10030,10030,470,4.92,10030,470,4.92,10030,10030,1399-8-24
109,شبريز,پالايش نفت تبريز,2109,7347579,187714745440,24390,25480,25600,1210,4.96,25550,1160,4.76,25000,25600,1399-8-24
110,ثقزوي,شركت عمران و سازندگي قزوين,2080,6737148,199334621788,30140,30000,29236,-904,-3.0,29587,-553,-1.83,29236,31044,1399-8-24
111,آ س پ,آ.س.پ,2061,13905140,159765361679,12007,11407,11407,-600,-5.0,11490,-517,-4.31,11407,11863,1399-8-24
112,خساپا,سايپا,2027,44241173,97772992330,2110,2210,2210,100,4.74,2190,80,3.79,2210,2210,1399-8-24
113,شدوص,دوده‌ صنعتي‌ پارس‌,2013,6417541,164692979400,24700,25150,25300,600,2.43,25660,960,3.89,23790,25930,1399-8-24
114,زشريف,كشت وصنعت شريف آباد,2001,5529297,124421312293,23577,22399,22399,-1178,-5.0,22502,-1075,-4.56,22399,22895,1399-8-24
115,كحافظ,كاشي‌ وسراميك‌ حافظ‌,1995,9615990,218186813100,23880,22690,22690,-1190,-4.98,22690,-1190,-4.98,22690,22690,1399-8-24
116,ثالوند,سرمايه گذاري مسكن الوند,1991,13662781,195041968625,13702,13895,14120,418,3.05,14275,573,4.18,13300,14387,1399-8-24
117,تسه9907,امتياز تسهيلات مسكن مهر99,1961,78038,62964018796,785047,771000,824299,39252,5.0,806838,21791,2.78,771000,824299,1399-8-24
118,آوا,صندوق س.سهام آواي معيار-س,1951,14665512,113082449689,7031,7450,7850,819,11.65,7711,680,9.67,7246,7850,1399-8-24
119,ثفارس,عمران‌وتوسعه‌فارس‌,1943,18274524,119864197380,6280,6300,6590,310,4.94,6560,280,4.46,6300,6590,1399-8-24
120,پارند,صندوق س. پارند پايدار سپهر,1936,82187658,941116672358,11461,11455,11450,-11,-0.1,11451,-10,-0.09,11430,11462,1399-8-24
121,ولشرق,ليزينگ ايران و شرق,1934,16029044,103421692254,6705,6370,6370,-335,-5.0,6452,-253,-3.77,6370,6705,1399-8-24
122,دتوليد,داروسازي توليد دارو,1932,4755808,136915825526,27742,27800,29129,1387,5.0,28789,1047,3.77,26800,29129,1399-8-24
123,ثنوسا,نوسازي‌وساختمان‌تهران‌,1920,24096508,201785048800,8010,8250,8410,400,4.99,8370,360,4.49,8020,8410,1399-8-24
124,حآسا,آسيا سير ارس,1874,6368452,113378149141,17425,18050,18000,575,3.3,17803,378,2.17,16700,18280,1399-8-24
125,پخش,پخش البرز,1843,5123979,180295151201,34322,34410,36038,1716,5.0,35187,865,2.52,32606,36038,1399-8-24
126,وخارزم,سرمايه گذاري خوارزمي,1839,22488033,173056342430,7340,7700,7700,360,4.9,7700,360,4.9,7510,7700,1399-8-24
127,وآرين,شركت توسعه اقتصادي آرين,1830,17117103,88861138124,5318,5159,5181,-137,-2.58,5191,-127,-2.39,5159,5350,1399-8-24
128,تاپكيشح,ح.تجارت الكترونيك پارسيان كيش,1806,9346567,92919081760,9808,10297,9820,12,0.12,9942,134,1.37,9520,10297,1399-8-24
129,فنورد,نوردوقطعات‌ فولادي‌,1782,1252960,172663132450,131950,134000,138540,6590,4.99,137800,5850,4.43,126100,138540,1399-8-24
130,ولبهمن,شركت بهمن ليزينگ,1780,25183630,220578208333,8370,8788,8788,418,4.99,8759,389,4.65,8410,8788,1399-8-24
131,كپارس,كاشي‌ پارس‌,1746,1800990,236098615120,124880,131120,131120,6240,5.0,131090,6210,4.97,128620,131120,1399-8-24
132,غويتا,ويتانا,1729,5000719,234052779844,45745,45745,47290,1545,3.38,46804,1059,2.32,45745,47500,1399-8-24
133,اعتلا,شركت سرمايه گذاري اعتلاء البرز,1688,9659144,86830976812,9394,8925,8925,-469,-4.99,8990,-404,-4.3,8925,9290,1399-8-24
134,غديس,پاكديس,1656,12464832,109825379323,8358,8810,8663,305,3.65,8811,453,5.42,8500,9250,1399-8-24
135,بورس,بورس اوراق بهادار تهران,1642,3053846,141945387320,44680,45300,46910,2230,4.99,46480,1800,4.03,44550,46910,1399-8-24
136,فسرب,ملي‌ سرب‌وروي‌ ايران‌,1637,2464408,288275476110,114160,108460,119860,5700,4.99,116980,2820,2.47,108460,119860,1399-8-24
137,پاكشو,گروه صنعتي پاكشو,1634,1517092,136994438140,89690,88600,90000,310,0.35,90300,610,0.68,88000,91510,1399-8-24
138,افق,فروشگاههاي زنجيره اي افق كوروش,1631,1809028,132541850050,70210,72500,73720,3510,5.0,73270,3060,4.36,71000,73720,1399-8-24
139,امين يكم,صندوق درآمد ثابت امين يكم فردا,1595,49809847,510569395754,10239,10248,10250,11,0.11,10250,11,0.11,10242,10255,1399-8-24
140,زقيام,كشت و دام قيام اصفهان,1591,4159268,121293715472,26972,28005,29669,2697,10.0,29162,2190,8.12,28005,29669,1399-8-24
141,ستران,سيمان‌ تهران‌,1576,4317918,119589727830,26570,26900,27890,1320,4.97,27700,1130,4.25,26060,27890,1399-8-24
142,كپشير,پشم‌شيشه‌ايران‌,1556,4341322,74599627410,17710,16830,16830,-880,-4.97,17180,-530,-2.99,16830,18090,1399-8-24
143,وبيمهح,ح . سرمايه‌ گذاري‌ صنعت‌ بيمه‌,1548,50603565,59829979640,1100,1130,1210,110,10.0,1180,80,7.27,1130,1210,1399-8-24
144,رتاپح,ح.تجارت الكترونيك پارسيان,1512,8163159,38692472530,4350,4500,4790,440,10.11,4740,390,8.97,4370,4790,1399-8-24
145,زكوثر,سرمايه گذاري كشاورزي كوثر,1482,2757219,45806446920,15860,16500,16650,790,4.98,16520,660,4.16,16020,16650,1399-8-24
146,ختراك,ريخته‌گري‌ تراكتورسازي‌ ايران‌,1462,4564698,48467823570,10720,10220,10630,-90,-0.84,10620,-100,-0.93,10190,11050,1399-8-24
147,بپاس,بيمه پاسارگاد,1458,2647112,173374949353,63192,64000,66351,3159,5.0,65496,2304,3.65,63200,66351,1399-8-24
148,شپاس,نفت پاسارگاد,1452,4387668,86728642057,20247,20330,19235,-1012,-5.0,19766,-481,-2.38,19235,20800,1399-8-24
149,فزرين,زرين معدن آسيا,1438,8109357,143101301829,16946,17770,17793,847,5.0,17646,700,4.13,16550,17793,1399-8-24
150,حكشتي,كشتيراني جمهوري اسلامي ايران,1422,6285711,158839916970,24070,25270,25270,1200,4.99,25270,1200,4.99,25270,25270,1399-8-24
151,زاگرس,پتروشيمي زاگرس,1385,2154945,350524893395,155023,158120,162774,7751,5.0,162661,7638,4.93,157110,162774,1399-8-24
152,كلر,كلر پارس,1383,1676289,88697130604,50906,51000,53451,2545,5.0,52913,2007,3.94,50906,53451,1399-8-24
153,وپاسار,بانك  پاسارگاد,1368,20341037,180491871650,8460,8800,8880,420,4.96,8870,410,4.85,8700,8880,1399-8-24
154,چكاپا,گروه صنايع كاغذ پارس,1346,22113994,105605500620,4570,4660,4790,220,4.81,4780,210,4.6,4620,4790,1399-8-24
155,وبوعلي,سرمايه‌گذاري‌بوعلي‌,1328,11145925,78223439740,6750,6880,7080,330,4.89,7020,270,4.0,6640,7080,1399-8-24
156,درهآور,دارويي ره آورد تامين,1323,1608204,55801785591,34147,35854,33330,-817,-2.39,34698,551,1.61,32610,35854,1399-8-24
157,شلعابح,ح . لعابيران‌,1320,14121246,61940253960,4060,4210,4470,410,10.1,4390,330,8.13,4100,4470,1399-8-24
158,ختوقا,قطعات‌ اتومبيل‌ ايران‌,1320,24844354,76435462450,2940,3070,3080,140,4.76,3080,140,4.76,3020,3080,1399-8-24
159,ميدكو,هلدينگ صنايع  معدني خاورميانه,1309,11313527,261077572102,22577,23100,23098,521,2.31,23077,500,2.21,22780,23499,1399-8-24
160,كيان,صندوق س. با درآمد ثابت كيان,1295,43131822,1117312755549,25881,25901,25902,21,0.08,25905,24,0.09,25898,25915,1399-8-24
161,ثشرق,سرمايه گذاري مسكن شمال شرق,1272,19322614,107674030230,5850,5560,5560,-290,-4.96,5570,-280,-4.79,5560,5730,1399-8-24
162,سخزر,سيمان‌ خزر,1268,2841885,68178195810,24700,23580,23510,-1190,-4.82,23990,-710,-2.87,23470,25790,1399-8-24
163,بجهرم,توسعه مولد نيروگاهي جهرم,1266,16771863,59065135695,3362,3459,3530,168,5.0,3522,160,4.76,3419,3530,1399-8-24
164,زمگسا,كشاورزي‌ ودامپروي‌ مگسال‌,1264,3457660,92656535410,27400,26030,26660,-740,-2.7,26800,-600,-2.19,26030,28250,1399-8-24
165,فيروزه,صندوق شاخص30 شركت فيروزه- سهام,1247,1022960,160173844440,144800,152120,159280,14480,10.0,156580,11780,8.14,152120,159280,1399-8-24
166,شكلر,نيروكلر,1247,1618097,75596328010,46210,47970,46210,0,0.0,46720,510,1.1,45220,48000,1399-8-24
167,كطبس,ذغال‌سنگ‌ نگين‌ ط‌بس‌,1245,2296742,110978603840,48290,45890,47520,-770,-1.59,48320,30,0.06,45890,50330,1399-8-24
168,وپارس,بانك‌پارسيان‌,1234,71302850,203213122500,2720,2850,2850,130,4.78,2850,130,4.78,2850,2850,1399-8-24
169,شتوكا,توكا رنگ فولاد سپاهان,1223,1960608,57333273629,29226,28100,29500,274,0.94,29243,17,0.06,28000,30320,1399-8-24
170,وبيمه,سرمايه‌ گذاري‌ صنعت‌ بيمه‌,1221,16935467,44141752300,2500,2560,2620,120,4.8,2590,90,3.6,2500,2620,1399-8-24
171,فجر,فولاد اميركبيركاشان,1214,4391780,239234858170,52330,50710,54940,2610,4.99,54470,2140,4.09,50710,54940,1399-8-24
172,داوه,داروسازي آوه سينا,1199,3253140,50832433739,15630,14849,15800,170,1.09,15626,-4,-0.03,14849,16200,1399-8-24
173,زر,صندوق س.پشتوانه سكه طلاي زر,1198,920449,49108152822,54062,53831,52409,-1653,-3.06,53352,-710,-1.31,52030,54650,1399-8-24
174,فاراك,ماشين‌ سازي‌ اراك‌,1197,13689501,85571472170,5970,6200,6260,290,4.86,6250,280,4.69,6110,6260,1399-8-24
175,كاوه,فولاد كاوه جنوب كيش,1197,20092037,391407180860,18570,19000,19490,920,4.95,19480,910,4.9,18950,19490,1399-8-24
176,زشگزا,شير و گوشت زاگرس شهركرد,1178,1195058,128642855048,98847,103000,108731,9884,10.0,107646,8799,8.9,103000,108731,1399-8-24
177,هجرت,پخش هجرت,1176,1448680,78207322485,54752,52015,53700,-1052,-1.92,53985,-767,-1.4,52015,55800,1399-8-24
178,دشيمي,شيمي‌ داروئي‌ داروپخش‌,1145,2037290,139963194250,68200,67120,68390,190,0.28,68700,500,0.73,65430,70500,1399-8-24
179,حبندر,دريايي و کشتيراني خط دريابندر,1145,9653605,226816436369,23455,22752,24158,703,3.0,23496,41,0.17,22752,24158,1399-8-24
180,ولملت,واسپاري ملت,1141,8543069,91895238390,11290,10730,10730,-560,-4.96,10760,-530,-4.69,10730,11000,1399-8-24
181,كپرور,فرآوري زغال سنگ پروده طبس,1140,2640786,119290471549,47343,44976,44976,-2367,-5.0,45172,-2171,-4.59,44976,47000,1399-8-24
182,ساراب,سيمان‌ داراب‌,1132,3003818,34972272410,11920,11330,11420,-500,-4.19,11720,-200,-1.68,11330,12470,1399-8-24
183,عيار,صندوق س. پشتوانه طلاي مفيد,1125,1100566,35370896109,32485,32952,31553,-932,-2.87,32139,-346,-1.07,31200,32952,1399-8-24
184,غگلستا,شير پاستوريزه پگاه گلستان,1125,2817204,40714748309,14618,13888,14000,-618,-4.23,14481,-137,-0.94,13888,15300,1399-8-24
185,زبينا,كشاورزي و دامپروري بينالود,1094,2621152,105691872043,36973,38520,40670,3697,10.0,40323,3350,9.06,38520,40670,1399-8-24
186,وآوا,سرمايه گذاري آوا نوين,1090,5042783,61184269311,11666,12222,12249,583,5.0,12133,467,4.0,11889,12249,1399-8-24
187,وبانك,سرمايه گذاري گروه توسعه ملي,1087,8894149,77720614540,8350,8570,8760,410,4.91,8670,320,3.83,8470,8760,1399-8-24
188,كمنگنز,معادن‌منگنزايران‌,1086,1403561,132262332680,98870,93930,93930,-4940,-5.0,94230,-4640,-4.69,93930,96780,1399-8-24
189,دشيري,شيرين دارو,1084,634416,106365142454,174547,165820,167500,-7047,-4.04,167658,-6889,-3.95,165820,183000,1399-8-24
190,فباهنر,مس‌ شهيدباهنر,1074,2183129,98620326830,43520,42800,45690,2170,4.99,45170,1650,3.79,42800,45690,1399-8-24
191,كاردان,صندوق س تجارت شاخصي كاردان,1070,788668,122288918640,142980,150000,157270,14290,9.99,155060,12080,8.45,150000,157270,1399-8-24
192,رتكو,كنترل‌خوردگي‌تكين‌كو,1067,3935549,61181073330,15960,15170,15230,-730,-4.57,15550,-410,-2.57,15170,16740,1399-8-24
193,نوين,بيمه نوين,1052,12251249,79647646111,6199,6508,6508,309,4.98,6501,302,4.87,6300,6508,1399-8-24
194,ومهان,گروه توسعه مالي مهر آيندگان,1051,7179977,96923196690,12883,13300,13527,644,5.0,13499,616,4.78,13190,13527,1399-8-24
195,كوير,توليدي فولاد سپيد فراب كوير,1049,4246008,55591112380,12570,12500,13190,620,4.93,13080,510,4.06,12500,13190,1399-8-24
196,وغدير,سرمايه‌گذاري‌غدير(هلدينگ‌,1039,11040000,113160000000,9770,10250,10250,480,4.91,10200,430,4.4,10250,10250,1399-8-24
197,بهپاك,صنعتي بهپاك,1034,1958600,59723607805,30736,29200,30699,-37,-0.12,30493,-243,-0.79,29200,31990,1399-8-24
198,غسالم,سالمين‌,1032,7902762,37696174740,4550,4770,4770,220,4.84,4710,160,3.52,4770,4770,1399-8-24
199,گكيش,توريستي ورفاهي آبادگران كيش,1022,1088970,73874211431,69413,67331,67331,-2082,-3.0,67839,-1574,-2.27,67331,71300,1399-8-24
200,فپنتا,سپنتا,1022,115630,43428076420,369210,386900,376600,7390,2.0,374650,5440,1.47,361110,386900,1399-8-24
201,وآذر,سرمايه‌گذاري‌توسعه‌آذربايجان‌,1018,684101,87899099200,124220,122000,130430,6210,5.0,128490,4270,3.44,122000,130430,1399-8-24
202,دتوزيع,توزيع دارو پخش,1006,1695165,79987392451,44960,47208,47208,2248,5.0,47186,2226,4.95,46000,47208,1399-8-24
203,شلعاب,لعابيران‌,1001,2785379,22312284080,8030,8060,7880,-150,-1.87,8020,-10,-0.12,7660,8290,1399-8-24
204,كپشيرح,ح . پشم‌شيشه‌ايران‌,997,5990255,67340350889,10408,10500,11450,1042,10.01,11242,834,8.01,10500,11450,1399-8-24
205,كصدف,كاشي صدف سرام استقلال آباده,992,3653637,64926524748,18189,17650,17950,-239,-1.31,17770,-419,-2.3,17644,18734,1399-8-24
206,فروي,ذوب روي اصفهان,967,1060256,47173407223,42378,44496,44496,2118,5.0,44278,1900,4.48,43400,44496,1399-8-24
207,غفارس,شير پاستوريزه پگاه فارس,967,3466055,32415129427,9818,9328,9328,-490,-4.99,9501,-317,-3.23,9328,9700,1399-8-24
208,سدبير,س. تدبيرگران فارس وخوزستان,966,2206402,64891506686,28602,28500,29792,1190,4.16,29411,809,2.83,28500,30030,1399-8-24
209,دكوثر,داروسازي‌ كوثر,961,3881435,73632062270,18260,18880,19170,910,4.98,18970,710,3.89,18090,19170,1399-8-24
210,وسكاب,س.ص.بازنشستگي كاركنان بانكها,957,16684271,102953587650,5900,6040,6190,290,4.92,6170,270,4.58,5880,6190,1399-8-24
211,ثمسكن,سرمايه‌گذاري‌ مسكن‌,938,10017582,54268987710,5190,5200,5440,250,4.82,5420,230,4.43,5200,5440,1399-8-24
212,افق ملت,صندوق س در سهام افق ملت,928,484423,63713977170,120990,125000,133080,12090,9.99,131530,10540,8.71,125000,133080,1399-8-24
213,ضخود1042,اختيارخ خودرو-3000-1399/10/07,927,27373,21950135000,628,660,805,177,28.18,802,174,27.71,660,840,1399-8-24
214,رنيك,جنرال مكانيك,924,2078566,42672604950,19733,19260,20719,986,5.0,20387,654,3.31,19260,20719,1399-8-24
215,غچين,كشت‌ و صنعت‌ چين‌ چين,924,1083157,45582405290,42100,42940,41000,-1100,-2.61,42080,-20,-0.05,40010,42940,1399-8-24
216,سغرب,سيمان‌غرب‌,922,1535739,28278499960,19180,18230,18850,-330,-1.72,18730,-450,-2.35,18230,19550,1399-8-24
217,فنرژي,گسترش صنايع انرژي آذرآب,918,6606897,72303242850,10854,10637,10637,-217,-2.0,10944,90,0.83,10637,11071,1399-8-24
218,سجام,مجتمع سيمان غرب آسيا,900,4170632,56687270668,13002,13652,13652,650,5.0,13592,590,4.54,13050,13652,1399-8-24
219,اطلس,صندوق س.توسعه اندوخته آينده-س,893,376916,67446955915,171397,175010,180500,9103,5.31,178944,7547,4.4,175001,180500,1399-8-24
220,كبافق,معادن‌ بافق‌,893,1598179,52975072890,31660,31500,33240,1580,4.99,33150,1490,4.71,31500,33240,1399-8-24
221,تيپيكو,سرمايه گذاري دارويي تامين,888,1107144,55566314800,48650,49000,50490,1840,3.78,49630,980,2.01,48700,50700,1399-8-24
222,والبر,سرمايه‌ گذاري‌ البرز(هلدينگ‌,882,4374113,64917835760,14250,14750,14960,710,4.98,14840,590,4.14,14300,14960,1399-8-24
223,كگل,معدني و صنعتي گل گهر,879,6914385,106599387270,14710,15350,15440,730,4.96,15310,600,4.08,15100,15440,1399-8-24
224,دكپسول,توليد ژلاتين كپسول ايران,878,1288350,44315767543,35715,33930,33930,-1785,-5.0,34502,-1213,-3.4,33930,36470,1399-8-24
225,رتاپ,تجارت الكترونيك  پارسيان,871,4982677,31000537870,5940,6170,6230,290,4.88,6110,170,2.86,6050,6230,1399-8-24
226,كوثر,بيمه كوثر,871,3847229,42861541929,11529,10954,11400,-129,-1.12,11185,-344,-2.98,10953,11400,1399-8-24
227,شبصير,توليدات پتروشيمي قائد بصير,868,492318,52062086490,105442,100250,105600,158,0.15,105749,307,0.29,100250,110712,1399-8-24
228,ثاخت,بين‌المللي‌توسعه‌ساختمان,866,13321099,47925951040,3430,3600,3600,170,4.96,3580,150,4.37,3500,3600,1399-8-24
229,شپارس,بين‌ المللي‌ محصولات‌  پارس‌,854,4188355,62089107050,14280,14800,14990,710,4.97,14820,540,3.78,13800,14990,1399-8-24
230,فاسمين,كالسيمين‌,853,5155594,65363389730,12130,12720,12730,600,4.95,12680,550,4.53,12260,12730,1399-8-24
231,كروي,توسعه‌ معادن‌ روي‌ ايران‌,837,3466534,85524200180,23610,24500,24790,1180,5.0,24670,1060,4.49,23610,24790,1399-8-24
232,فخوز,فولاد  خوزستان,833,5877915,203903372710,33040,34690,34690,1650,4.99,34690,1650,4.99,34420,34690,1399-8-24
233,كچاد,معدني‌وصنعتي‌چادرملو,832,7405686,120601681790,15520,16290,16290,770,4.96,16250,730,4.7,16000,16290,1399-8-24
234,سفاسي,شركت فارسيت اهواز,831,5339985,57930702211,11108,10775,10775,-333,-3.0,10848,-260,-2.34,10775,11288,1399-8-24
235,دابور,داروسازي‌ ابوريحان‌,816,659321,31367351700,47190,48800,46600,-590,-1.25,47430,240,0.51,46000,48800,1399-8-24
236,بالبر,كابل‌ البرز,798,1786169,40675348970,23560,22390,22390,-1170,-4.97,22900,-660,-2.8,22390,24000,1399-8-24
237,وتوسم,سرمايه‌گذاري‌توسعه‌ملي‌,794,5394183,66911174550,11830,12370,12420,590,4.99,12400,570,4.82,12000,12420,1399-8-24
238,جم,پتروشيمي جم,787,4063368,165267658140,39130,39130,41080,1950,4.98,40670,1540,3.94,39020,41080,1399-8-24
239,دامين,داروسازي‌ امين‌,775,3296749,40008194770,11640,12180,12220,580,4.98,12020,380,3.26,11500,12220,1399-8-24
240,قزوين,كارخانجات‌ قند قزوين‌,770,3217896,121827246330,36060,37860,37860,1800,4.99,37860,1800,4.99,37700,37860,1399-8-24
241,سپح,ح . پرداخت الكترونيك سامان كيش,766,1245985,13543587630,9910,10600,10900,990,9.99,10870,960,9.69,10600,10900,1399-8-24
242,ماديرا,صنايع ماشين هاي اداري ايران,760,4372261,110128902112,24042,24700,25244,1202,5.0,25188,1146,4.77,24200,25244,1399-8-24
243,وبرق,س.کارکنان صنعت برق زنجان وقزوي,759,435852,80220818213,188359,182709,182709,-5650,-3.0,184055,-4304,-2.28,182709,188000,1399-8-24
244,زماهان,مجتمع توليد گوشت مرغ ماهان,758,1311599,29246502792,23035,21884,22310,-725,-3.15,22590,-445,-1.93,21884,22850,1399-8-24
245,پكويرح,ح. كوير تاير,753,11426653,136434236820,10850,11940,11940,1090,10.05,11940,1090,10.05,11940,11940,1399-8-24
246,هاي وب,داده گسترعصرنوين-هاي وب,745,3270780,72577937590,21170,22140,22220,1050,4.96,22190,1020,4.82,21710,22220,1399-8-24
247,سپ,پرداخت الكترونيك سامان كيش,745,2539075,35223066290,13240,13500,13900,660,4.98,13670,430,3.25,13400,13900,1399-8-24
248,قصفها,قنداصفهان‌,740,268158,37656103500,136010,140090,141910,5900,4.34,139230,3220,2.37,137370,142000,1399-8-24
249,هرمز,فولاد هرمزگان جنوب,734,10437490,129978079300,11879,12472,12472,593,4.99,12453,574,4.83,12104,12472,1399-8-24
250,قلرست,قند لرستان‌,733,1434449,32561978290,22570,21850,21800,-770,-3.41,22650,80,0.35,21720,23590,1399-8-24
251,حسينا,توسعه خدمات دريايي وبندري سينا,725,1069707,65566908171,57442,60000,61690,4248,7.4,61294,3852,6.71,60000,62000,1399-8-24
252,واعتبار,سرمايه گذاري اعتبار ايران,708,6139007,27844951760,4440,4590,4580,140,3.15,4490,50,1.13,4350,4610,1399-8-24
253,وپترو,سرمايه‌گذاري صنايع پتروشيمي‌,708,4683062,63987121700,13100,13230,13750,650,4.96,13660,560,4.27,13230,13750,1399-8-24
254,آريان,سرمايه گذاري پارس آريان,705,10876187,138287506195,12373,12400,12744,371,3.0,12715,342,2.76,12400,12744,1399-8-24
255,ريشمك,توليد و صادرات ريشمك,701,1495334,48031301911,30632,32160,32163,1531,5.0,31996,1364,4.45,30700,32163,1399-8-24
256,دروز,داروسازي‌ روزدارو,698,2413167,42920744650,18530,17610,17610,-920,-4.96,17860,-670,-3.62,17610,18530,1399-8-24
257,پارسان,گسترش نفت و گاز پارسيان,698,4345846,81360445470,17890,18480,18780,890,4.97,18430,540,3.02,18230,18780,1399-8-24
258,وآيند,بانك  آينده,698,3307947,85490582268,26371,25844,25844,-527,-2.0,25911,-460,-1.74,25844,25844,1399-8-24
259,بنو,بيمه تجارت نو,689,2701985,99852660911,38814,37050,36874,-1940,-5.0,36955,-1859,-4.79,36874,37900,1399-8-24
260,كاريس,صندوق س.سپهر كاريزما-س,689,389610,67833882006,163126,167300,178900,15774,9.67,174107,10981,6.73,167300,179000,1399-8-24
261,آبين,كشت و صنعت آبشيرين,674,4780281,15201614270,3193,3120,3126,-67,-2.1,3183,-10,-0.31,3110,3258,1399-8-24
262,كفرآور,فرآورده هاي سيمان شرق,672,3437349,72086505932,21040,21000,20409,-631,-3.0,20972,-68,-0.32,20409,21550,1399-8-24
263,شراز,پالايش نفت شيراز,670,290681,26909913910,90364,87300,92520,2156,2.39,91526,1162,1.29,87300,94000,1399-8-24
264,زگلدشت,كشت و دام گلدشت نمونه اصفهان,668,1316978,42574526423,31614,33194,32280,666,2.11,32208,594,1.88,31120,33194,1399-8-24
265,سشمال,سيمان‌ شمال‌,667,2743612,24489991010,9260,8800,8860,-400,-4.32,9090,-170,-1.84,8800,9200,1399-8-24
266,وسبحان,سرمايه گذاري سبحان,664,5711239,44882897835,7513,7810,7888,375,4.99,7810,297,3.95,7645,7888,1399-8-24
267,وصنا,گروه‌صنايع‌بهشهرايران‌,662,4509437,49404907050,10500,10970,11020,520,4.95,10930,430,4.1,10500,11020,1399-8-24
268,وساخت,سرمايه‌ گذاري‌ ساختمان‌ايران‌,660,968371,54359864380,53540,56210,56210,2670,4.99,56140,2600,4.86,55010,56210,1399-8-24
269,سيمرغ,سيمرغ,657,2514080,34288712690,13020,13500,13670,650,4.99,13430,410,3.15,13500,13670,1399-8-24
270,سصوفي,سيمان‌ صوفيان‌,653,4019912,45570043520,10840,10630,11380,540,4.98,11270,430,3.97,10630,11380,1399-8-24
271,بركت,گروه دارويي بركت,652,2459783,34510755490,13370,14030,14030,660,4.94,13800,430,3.22,14030,14030,1399-8-24
272,چدن,توليدي چدن سازان,646,2697973,67979143560,24100,24100,25300,1200,4.98,25200,1100,4.56,24100,25300,1399-8-24
273,خپارس,پارس‌ خودرو,645,3470223,23042280720,6330,6640,6640,310,4.9,6450,120,1.9,6640,6640,1399-8-24
274,وكار,بانك‌ كارآفرين‌,644,6975970,27436449070,3810,3890,3970,160,4.2,3880,70,1.84,3710,3990,1399-8-24
275,ددام,داروسازي زاگرس فارمد پارس,644,1701784,22181498280,12990,13190,12950,-40,-0.31,13010,20,0.15,12740,13390,1399-8-24
276,غنوش,نوش‌ مازندران‌,638,1155326,79324683160,72270,68660,68660,-3610,-5.0,68660,-3610,-5.0,68660,68660,1399-8-24
277,قشكر,شكرشاهرود,636,904452,32738231800,35100,36850,36850,1750,4.99,35800,700,1.99,35160,36850,1399-8-24
278,پرديس,سرمايه گذاري پرديس,636,5950430,39059552280,6270,6310,6580,310,4.94,6490,220,3.51,6310,6580,1399-8-24
279,شغدير,پتروشيمي غدير,636,1312678,62127536130,45178,45010,47436,2258,5.0,47329,2151,4.76,45010,47436,1399-8-24
280,حخزر,كشتيراني درياي خزر,631,1539546,31562039992,21160,20457,20920,-240,-1.13,20731,-429,-2.03,20102,21800,1399-8-24
281,تشتاد,صنايع توليدي اشتاد ايران‌,629,2103954,32126646504,15376,15836,14915,-461,-3.0,15270,-106,-0.69,14915,15836,1399-8-24
282,گوهران,سرمايه گذاري توسعه گوهران اميد,627,3091180,22884802077,7241,7007,7380,139,1.92,7314,73,1.01,7007,7530,1399-8-24
283,تاصيكو,سرمايه گذاري صدرتامين,626,11039112,97985816710,8460,8860,8880,420,4.96,8830,370,4.37,8710,8880,1399-8-24
284,غشهد,شهد ايران ‌,626,4473224,27414714940,5910,5790,6200,290,4.91,6030,120,2.03,5700,6200,1399-8-24
285,آتيمس,صندوق س.آرمان آتيه درخشان مس-س,622,240649,46344702238,184249,190841,194497,10248,5.56,192582,8333,4.52,187050,194500,1399-8-24
286,پسهند,صنايع‌ لاستيكي‌  سهند,616,1108352,52938324770,49760,47280,47360,-2400,-4.82,47760,-2000,-4.02,47280,50480,1399-8-24
287,لبوتان,گروه‌صنعتي‌بوتان‌,615,292538,19583456270,65590,68680,66480,890,1.36,66110,520,0.79,65960,68850,1399-8-24
288,شاراك,پتروشيمي شازند,611,5475455,113271307350,19710,20500,20690,980,4.97,20690,980,4.97,20120,20690,1399-8-24
289,فولاژ,فولاد آلياژي ايران,610,1554430,33743378240,20780,20640,21810,1030,4.96,21380,600,2.89,20640,21810,1399-8-24
290,رمپنا,گروه مپنا (سهامي عام),607,4929343,79052571390,15290,15700,16050,760,4.97,15760,470,3.07,15500,16050,1399-8-24
291,دانا,بيمه دانا,606,6809988,37992922910,5330,5480,5590,260,4.88,5510,180,3.38,5310,5590,1399-8-24
292,ما,بيمه  ما,604,8402627,57012626030,6470,6510,6790,320,4.95,6790,320,4.95,6510,6790,1399-8-24
293,سكارون,سيمان كارون,604,402275,51174491812,128467,132321,124613,-3854,-3.0,127213,-1254,-0.98,124613,132321,1399-8-24
294,خفولا,خدمات فني فولاد يزد,599,953415,26700798782,28586,29350,27729,-857,-3.0,28005,-581,-2.03,27729,29350,1399-8-24
295,سباقر,سيمان باقران,597,2220226,30120180091,13845,14180,13430,-415,-3.0,13566,-279,-2.02,13430,14254,1399-8-24
296,دعبيد,لابراتوارداروسازي‌  دكترعبيدي‌,591,483752,14238764460,28370,29650,29250,880,3.1,28660,290,1.02,29000,29780,1399-8-24
297,اوصتا2,صندوق انديشه ورزان صباتامين -د,583,58300000,58300000,16981,1,1,-16980,-99.99,1,-16980,-99.99,1,1,1399-8-24
298,غبهنوش,بهنوش‌ ايران‌,582,377912,21156210700,56980,54140,55000,-1980,-3.47,56550,-430,-0.75,54140,57870,1399-8-24
299,وخاور,بانك خاورميانه,582,5475516,48931453470,8540,8930,8960,420,4.92,8900,360,4.22,8600,8960,1399-8-24
300,لوتوس,تامين سرمايه لوتوس پارسيان,582,1915559,25668752800,12990,13590,13400,410,3.16,13190,200,1.54,13000,13630,1399-8-24
301,شلرد,كود شيميايي اوره لردگان,574,7446521,52110753958,6795,6998,6998,203,2.99,6998,203,2.99,6998,6998,1399-8-24
302,كسرا,سراميك‌هاي‌صنعتي‌اردكان‌,574,2553961,46230733330,17260,18120,18120,860,4.98,18000,740,4.29,17360,18120,1399-8-24
303,مداران,داده‌پردازي‌ايران‌,561,980071,22157208480,22780,21700,22460,-320,-1.4,22700,-80,-0.35,21650,23910,1399-8-24
304,فايرا,آلومينيوم‌ايران‌,559,2700741,48340490980,17120,17310,17970,850,4.96,17840,720,4.21,17310,17970,1399-8-24
305,دجابر,داروسازي‌ جابرابن‌حيان‌,558,654285,22886381110,34890,33150,35500,610,1.75,34930,40,0.11,33150,35900,1399-8-24
306,وسنا,سرمايه گذاري نيروگاهي ايران,547,2857043,38618978293,13927,13510,13510,-417,-2.99,13517,-410,-2.94,13510,13800,1399-8-24
307,جم پيلن,پلي پروپيلن جم - جم پيلن,546,982389,77999640970,76050,79000,79850,3800,5.0,79400,3350,4.4,76980,79850,1399-8-24
308,وهنر,گروه توسعه هنر ايران,546,16351144,66653460091,3964,3940,4082,118,2.98,4076,112,2.83,3865,4082,1399-8-24
309,خلنت,لنت‌ ترمزايران‌,545,299562,25549673680,89170,84730,84720,-4450,-4.99,87100,-2070,-2.32,84720,86970,1399-8-24
310,كماسه,تامين‌ ماسه‌ ريخته‌گري‌,542,922516,45221734320,51600,49020,49020,-2580,-5.0,49140,-2460,-4.77,49020,49020,1399-8-24
311,چكارن,كارتن‌ ايران‌,539,8717445,30162359700,3300,3460,3460,160,4.85,3390,90,2.73,3460,3460,1399-8-24
312,ثزاگرس,سرمايه گذاري توسعه عمران زاگرس,535,1503908,68915902786,45761,47133,44389,-1372,-3.0,45825,64,0.14,44389,47133,1399-8-24
313,ختراكح,ح . ريخته‌گري‌ تراكتورسازي‌,531,1884758,14119024120,6870,7200,7560,690,10.04,7490,620,9.02,7100,7560,1399-8-24
314,غگرجي,بيسكويت‌  گرجي‌,526,1189775,33055453700,26510,27800,27830,1320,4.98,27310,800,3.02,27000,27830,1399-8-24
315,دتماد,توليدمواداوليه‌داروپخش‌,523,1025902,46462937250,43190,43900,45340,2150,4.98,45050,1860,4.31,43900,45340,1399-8-24
316,ساروم,سيمان‌اروميه‌,518,1402537,30314479070,20910,21400,21850,940,4.5,21320,410,1.96,19920,21930,1399-8-24
317,اوان,مبين وان كيش,515,2564819,140391736430,52172,54780,54780,2608,5.0,54737,2565,4.92,53000,54780,1399-8-24
318,ساينا,صنايع بهداشتي ساينا,513,217389,37905760274,167397,162500,175766,8369,5.0,172471,5074,3.03,162500,175766,1399-8-24
319,ولساپا,ليزينگ رايان‌ سايپا,509,13283311,51937746010,3730,3910,3910,180,4.83,3910,180,4.83,3910,3910,1399-8-24
320,كگهر,سنگ آهن گهرزمين,507,400625,16726090124,39819,41700,41809,1990,5.0,40076,257,0.65,40010,41809,1399-8-24
321,وصندوق,سرمايه‌گذاري‌صندوق‌بازنشستگي‌,505,8657909,117565309310,12970,13210,13610,640,4.93,13540,570,4.39,12980,13610,1399-8-24
322,فرآور,فرآوري‌موادمعدني‌ايران‌,505,1158652,23559409840,19790,19110,20400,610,3.08,20040,250,1.26,19110,20650,1399-8-24
323,زفكا,كشت و دامداري فكا,501,842780,34699995495,39335,39512,41301,1966,5.0,40554,1219,3.1,39512,41301,1399-8-24
324,كاما,باما,501,3409990,526741155300,147120,154470,154470,7350,5.0,154470,7350,5.0,154470,154470,1399-8-24
325,ملت,بيمه ملت,501,2319488,26835041320,11070,11460,11620,550,4.97,11330,260,2.35,10810,11620,1399-8-24
326,مارون,پتروشيمي مارون,500,188329,24214906697,123432,123300,128990,5558,4.5,124628,1196,0.97,123300,129500,1399-8-24
327,سبهان,سيمان‌ بهبهان‌,498,365247,19281374450,54890,52150,52500,-2390,-4.35,54050,-840,-1.53,52150,54250,1399-8-24
328,آساس,صندوق س.آسمان آرماني سهام-س,497,582900,90008511016,146766,153990,155999,9233,6.29,154415,7649,5.21,152010,157000,1399-8-24
329,كي بي سي,شركت كي بي سي,496,542108,15551225115,28819,28330,28150,-669,-2.32,28778,-41,-0.14,28150,29414,1399-8-24
330,ديران,ايران‌دارو,496,4142076,72291254810,16640,17300,17470,830,4.99,17450,810,4.87,16720,17470,1399-8-24
331,سبزوا,سيمان لار سبزوار,494,4098467,24357189381,6255,5943,5943,-312,-4.99,6095,-160,-2.56,5943,5943,1399-8-24
332,ولانا,شركت ليزينگ آريا دانا,493,1173471,24057512310,20108,20711,20711,603,3.0,20501,393,1.95,20000,20711,1399-8-24
333,وپست,پست بانك ايران,491,4505264,52531378240,11110,11660,11660,550,4.95,11660,550,4.95,11660,11660,1399-8-24
334,لابسا,آبسال‌,490,833508,26890929520,30790,32320,32320,1530,4.97,31550,760,2.47,31560,32320,1399-8-24
335,خديزل,بهمن  ديزل,485,1137699,45302484497,38816,37100,40150,1334,3.44,39702,886,2.28,37100,40490,1399-8-24
336,وتوشه,سرمايه‌ گذاري‌ پارس‌ توشه‌,482,1275572,23833352530,18060,18300,18960,900,4.98,18350,290,1.61,18200,18960,1399-8-24
337,غمهراح,ح . توليدي‌مهرام‌,479,438815,19887330380,41580,45250,45740,4160,10.0,45320,3740,8.99,42190,45740,1399-8-24
338,اخابر,مخابرات ايران,479,8307003,95281324410,10930,11470,11470,540,4.94,11340,410,3.75,11470,11470,1399-8-24
339,دسبحان,سبحان دارو,479,1136386,19978564410,16840,16900,17680,840,4.99,17120,280,1.66,16620,17680,1399-8-24
340,فخاس,فولاد خراسان,477,639791,20790613510,32440,30950,32090,-350,-1.08,32450,10,0.03,30950,33490,1399-8-24
341,سيدكو,سرمايه گذاري توسعه صنايع سيمان,475,3353405,22768577220,6480,6640,6800,320,4.94,6610,130,2.01,6640,6800,1399-8-24
342,غبشهر,صنعتي‌ بهشهر,475,2547894,61224211520,22920,23900,24060,1140,4.97,24030,1110,4.84,22050,24060,1399-8-24
343,شفن,پتروشيمي فناوران,475,240230,62522921640,247950,255000,260340,12390,5.0,255730,7780,3.14,250050,260340,1399-8-24
344,ومعلم,بيمه معلم,474,3282002,20139964515,5850,6142,6142,292,4.99,5960,110,1.88,5850,6142,1399-8-24
345,زكشت,كشاورزي مكانيزه اصفهان كشت,472,1358523,37907710934,26624,27370,27955,1331,5.0,27550,926,3.48,27000,27955,1399-8-24
346,كرماشا,صنايع پتروشيمي كرمانشاه,471,1497064,54208458020,34570,35550,36290,1720,4.98,36210,1640,4.74,35510,36290,1399-8-24
347,كرمان,س. توسعه و عمران استان كرمان,471,597357,41178207438,72562,68934,68934,-3628,-5.0,69417,-3145,-4.33,68934,68934,1399-8-24
348,شپاكسا,پاكسان‌,469,2988610,75047958280,24000,24160,25200,1200,5.0,25110,1110,4.63,24160,25200,1399-8-24
349,سمازن,سيمان‌مازندران‌,463,2353503,21438596950,8700,8890,9130,430,4.94,8870,170,1.95,8660,9130,1399-8-24
350,سرود,سيمان‌شاهرود,462,1228537,17138273860,14050,13360,14090,40,0.28,14020,-30,-0.21,13360,14500,1399-8-24
351,وگردش,بانك گردشگري,459,4351215,73896684345,16489,16983,16983,494,3.0,16847,358,2.17,16983,16983,1399-8-24
352,بفجر,فجر انرژي خليج فارس,454,1534110,43459163030,27010,27310,28360,1350,5.0,27790,780,2.89,27310,28360,1399-8-24
353,بكاب,صنايع‌جوشكاب‌يزد,454,374507,76684053320,195010,204760,204760,9750,5.0,204760,9750,5.0,204760,204760,1399-8-24
354,تسه9906,امتياز تسهيلات مسكن شهريور99,451,5496,4551692125,799295,800000,839259,39964,5.0,828183,28888,3.61,800000,839259,1399-8-24
355,دالبر,البرزدارو,450,864322,16751773290,18510,19200,19430,920,4.97,18790,280,1.51,18680,19430,1399-8-24
356,درازك,دارويي‌ رازك‌,447,2128930,71717413880,32140,32950,33740,1600,4.98,33690,1550,4.82,31310,33740,1399-8-24
357,كخاكح,ح . صنايع‌خاك‌چيني‌ايران‌,446,984163,39141427980,38490,38000,39400,910,2.36,39770,1280,3.33,38000,41000,1399-8-24
358,وسپه,سرمايه‌گذاري‌ سپه‌,445,4673261,55689661750,11360,11910,11920,560,4.93,11920,560,4.93,11510,11920,1399-8-24
359,شخارك,پتروشيمي‌ خارك‌,436,2001350,78292846970,37270,39000,39130,1860,4.99,38810,1540,4.13,38130,39130,1399-8-24
360,كرازي,كارخانجات‌توليدي‌شيشه‌رازي‌,435,3004251,53295412740,16900,17740,17740,840,4.97,17740,840,4.97,17740,17740,1399-8-24
361,مبين,مبين انرژي خليج فارس,434,3519795,69852146060,18910,19110,19850,940,4.97,19530,620,3.28,19110,19850,1399-8-24
362,واميد,گروه مديريت سرمايه گذاري اميد,428,966656,35074258770,34900,36380,36260,1360,3.9,35290,390,1.12,35010,36590,1399-8-24
363,كترام,توليدي‌ كاشي‌ تكسرام‌,425,967112,29796720720,29350,30810,30810,1460,4.97,30180,830,2.83,30810,30810,1399-8-24
364,دلر,داروسازي‌ اكسير,424,323647,31779528060,96810,97270,97670,860,0.89,97680,870,0.9,95680,100990,1399-8-24
365,سفارس,سيمان فارس و خوزستان,423,3044400,41401829400,12960,13600,13600,640,4.94,13460,500,3.86,13500,13600,1399-8-24
366,بخاور,بيمه زندگي خاورميانه,417,3201035,23535266262,7024,7100,7360,336,4.78,7172,148,2.11,7100,7375,1399-8-24
367,كاسپين,داروسازي كاسپين تامين,412,549426,13650988481,24250,23699,24630,380,1.57,24409,159,0.66,23361,25350,1399-8-24
368,سخاش,سيمان‌خاش‌,411,168487,13146776590,75060,78450,78340,3280,4.37,75810,750,1.0,76000,78500,1399-8-24
369,پارس,پتروشيمي پارس,409,814736,108723165840,127120,133470,133470,6350,5.0,133450,6330,4.98,128200,133470,1399-8-24
370,دارا,صندوق س. دارا الگوريتم-د,406,15574930,156964921767,10039,10080,10080,41,0.41,10078,39,0.39,10074,10090,1399-8-24
371,ونفت,سرمايه‌گذاري‌ صنعت‌ نفت‌,405,3343640,37555038290,10760,10900,11290,530,4.93,11100,340,3.16,10900,11290,1399-8-24
372,دزهراوي,داروسازي‌زهراوي‌,393,3090915,35081885250,10810,11350,11350,540,5.0,11170,360,3.33,11350,11350,1399-8-24
373,كخاك,صنايع‌خاك‌چيني‌ايران‌,393,804918,35283108170,45810,43520,43520,-2290,-5.0,44350,-1460,-3.19,43520,45790,1399-8-24
374,دسبحا,گروه دارويي سبحان,392,806683,13260846470,16110,15750,16320,210,1.3,16200,90,0.56,15710,16870,1399-8-24
375,كلوند,كاشي‌ الوند,390,1648171,37158880370,21510,22390,22580,1070,4.97,22240,730,3.39,21850,22580,1399-8-24
376,فاما,صنعتي‌ آما,385,838999,22724684770,25810,27100,27100,1290,5.0,26360,550,2.13,26500,27100,1399-8-24
377,ارفع,شركت آهن و فولاد ارفع,378,2651475,35781655125,12853,13495,13495,642,4.99,13208,355,2.76,13495,13495,1399-8-24
378,شيراز,پتروشيمي‌شيراز,369,1763051,86004046860,46580,48900,48900,2320,4.98,48480,1900,4.08,47430,48900,1399-8-24
379,كنور,توسعه معدني و صنعتي صبانور,369,1378369,48167895480,33300,34900,34960,1660,4.98,34810,1510,4.53,33310,34960,1399-8-24
380,وسينا,بانك سينا,368,5421320,47976999580,8430,8850,8850,420,4.98,8810,380,4.51,8770,8850,1399-8-24
381,سكه0012پ01,سكه تمام بهارتحويلي 1روزه رفاه,367,130300,166208160600,1291073,1291000,1260000,-31073,-2.41,1275581,-15492,-1.2,1253000,1298999,1399-8-24
382,وتوصا,گروه س توسعه صنعتي ايران,366,4552279,42108580750,8810,9250,9250,440,4.99,9160,350,3.97,9250,9250,1399-8-24
383,گوهر,صندوق سكه طلاي كيان,366,267098,17115272702,64458,65000,63600,-858,-1.33,64079,-379,-0.59,63500,65440,1399-8-24
384,فسازان,غلتك سازان سپاهان,365,1631447,41618813700,24330,25300,25540,1210,4.97,25270,940,3.86,24300,25540,1399-8-24
385,شپديس,پتروشيمي پرديس,365,892896,78189666960,83570,84050,87740,4170,4.99,86550,2980,3.57,84050,87740,1399-8-24
386,حريل,ريل پردازسير,365,5677462,19906710120,3344,3461,3511,167,4.99,3406,62,1.85,3460,3511,1399-8-24
387,آسيا,بيمه آسيا,360,2025809,43288819630,20370,21000,21380,1010,4.96,21190,820,4.03,21000,21380,1399-8-24
388,گكوثر,هتل پارسيان كوثر اصفهان,359,511462,62898062374,111798,122977,122977,11179,10.0,122977,11179,10.0,122977,122977,1399-8-24
389,تسه9902,امتياز تسهيلات مسكن ارديبهشت99,359,6305,5178539887,788870,828313,828313,39443,5.0,821339,32469,4.12,760000,828313,1399-8-24
390,كفرا,فراورده‌ هاي‌ نسوزايران‌,359,857262,42302255040,47010,49290,49360,2350,5.0,48890,1880,4.0,48030,49360,1399-8-24
391,شاوان,پالايش نفت لاوان,358,427446,36181316963,81035,83990,85086,4051,5.0,83536,2501,3.09,80210,85086,1399-8-24
392,خرينگ,رينگ‌سازي‌مشهد,357,959019,39185516340,38920,40860,40860,1940,4.98,40370,1450,3.73,40860,40860,1399-8-24
393,وبشهر,توسعه‌ صنايع‌ بهشهر(هلدينگ,349,3599919,46260063010,12280,12700,12890,610,4.97,12780,500,4.07,12110,12890,1399-8-24
394,همراه,شركت ارتباطات سيار ايران,347,971876,27970567700,27410,28780,28780,1370,5.0,27770,360,1.31,28600,28780,1399-8-24
395,سفار,سيمان‌فارس‌,328,160697,14525406450,89680,85200,88500,-1180,-1.32,89880,200,0.22,85200,93990,1399-8-24
396,آكورد,صندوق س. آرمان آتي كوثر-د,323,8633791,253318047317,29295,29315,29347,52,0.18,29340,45,0.15,29315,29349,1399-8-24
397,شاملا,معدني‌ املاح‌  ايران‌,323,235141,14958359240,65690,62410,63300,-2390,-3.64,65050,-640,-0.97,62410,68900,1399-8-24
398,دارو,كارخانجات‌داروپخش‌,323,203437,10828078750,52520,53700,52500,-20,-0.04,52670,150,0.29,51100,53790,1399-8-24
399,وصنعت,سرمايه گذاري توسعه صنعت وتجارت,321,5861666,45076211540,7330,7690,7690,360,4.91,7640,310,4.23,7690,7690,1399-8-24
400,دسانكو,داروسازي سبحان انكولوژي,319,2374480,33045883691,13257,13890,13919,662,4.99,13673,416,3.14,13630,13919,1399-8-24
401,سيستم,همكاران سيستم,318,1097112,31933453750,28030,28010,29400,1370,4.89,28690,660,2.35,28000,29430,1399-8-24
402,ضخود1044,اختيارخ خودرو-4000-1399/10/07,315,8856,3068802000,311,300,355,44,14.15,347,36,11.58,300,365,1399-8-24
403,شفا,سرمايه گذاري شفادارو,314,165231,9828103120,59140,56500,59080,-60,-0.1,59210,70,0.12,56500,61490,1399-8-24
404,سكه9912پ04,سكه تمام بهارتحويل1روزه صادرات,313,112500,142912621000,1287400,1282200,1257500,-29900,-2.32,1270334,-17066,-1.33,1250000,1296000,1399-8-24
405,سرچشمه,سرمايه گذاري مس سرچشمه,312,2947136,20830904945,6737,7060,7073,336,4.99,6869,132,1.96,6950,7073,1399-8-24
406,ضصاد1102,اختيارخ وبصادر-3500-1399/11/12,306,12351,4319458000,256,335,370,114,44.53,350,94,36.72,315,390,1399-8-24
407,سهرمز,سيمان‌هرمزگان‌,305,939979,14875618380,15740,14980,16120,380,2.41,15770,30,0.19,14980,16130,1399-8-24
408,تسه9904,امتياز تسهيلات مسكن تير99,303,2478,2041179772,795709,835494,835494,39785,5.0,823721,28012,3.52,778888,835494,1399-8-24
409,ثترانح,ح سرمايه گذاري مسكن تهران,303,2117488,5084958505,2290,2404,2404,114,4.98,2401,111,4.85,2313,2404,1399-8-24
410,پكرمان,گروه‌ صنعتي‌ بارز,302,1328023,41102311850,29480,30950,30950,1470,4.99,30630,1150,3.9,30950,30950,1399-8-24
411,پارسيانح,ح.بيمه پارسيان,302,2267476,19629187130,7890,8380,8680,790,10.01,8660,770,9.76,8380,8680,1399-8-24
412,اوصتا,صندوق انديشه ورزان صباتامين -د,302,24659930,419304908252,16981,17000,16900,-81,-0.48,17003,22,0.13,16900,17050,1399-8-24
413,خصدرا,صنعتي‌ دريايي‌ ايران‌,300,1426042,7927367478,5730,5559,5559,-171,-2.98,5707,-23,-0.4,5559,5559,1399-8-24
414,خكرمان,گروه اقتصادي كرمان خودرو,299,4518101,18736564847,4027,4147,4147,120,2.98,4136,109,2.71,4147,4147,1399-8-24
415,تسه9810,امتياز تسهيلات مسكن دي98,298,5772,4719838873,786520,765555,825846,39326,5.0,817713,31193,3.97,765555,825846,1399-8-24
416,داسوه,داروسازي‌ اسوه‌,297,602407,15330780080,25210,26400,24900,-310,-1.23,25280,70,0.28,24560,26400,1399-8-24
417,ثجوان,تامين مسكن جوانان,296,1814268,11685209810,6226,5930,6537,311,5.0,6347,121,1.94,5930,6537,1399-8-24
418,بمپنا,توليد برق عسلويه  مپنا,296,917008,76823915565,79804,83794,83794,3990,5.0,83777,3973,4.98,79881,83794,1399-8-24
419,سكرما,سيمان‌ كرمان‌,295,1393708,19025523190,13050,12700,13700,650,4.98,13270,220,1.69,12700,13700,1399-8-24
420,فنفت,صنايع تجهيزات نفت,291,1008403,14286181362,14502,14067,14067,-435,-3.0,14257,-245,-1.69,14067,14841,1399-8-24
421,مفاخر,توسعه فناوري اطلاعات خوارزمي,284,773327,33500793395,41443,40011,43515,2072,5.0,42646,1203,2.9,39382,43515,1399-8-24
422,پرداخت,به پرداخت ملت,283,274823,11793737790,42040,42040,42550,510,1.21,42240,200,0.48,41340,44100,1399-8-24
423,كهمدا,شيشه‌ همدان‌,279,1354096,13594271510,9570,10040,10040,470,4.91,9690,120,1.25,9870,10040,1399-8-24
424,كيميا,معدني كيمياي زنجان گستران,279,1378316,29924618676,20678,21711,21711,1033,5.0,21267,589,2.85,21711,21711,1399-8-24
425,واحصا,احياء صنايع خراسان,277,1026303,22426755730,21424,22066,22066,642,3.0,21852,428,2.0,20782,22066,1399-8-24
426,دپارس,پارس‌ دارو,276,468420,50412635910,103780,108000,108960,5180,4.99,107520,3740,3.6,103780,108960,1399-8-24
427,تسه9905,امتياز تسهيلات مسكن مرداد99,272,2034,1673711092,790676,773111,830209,39533,5.0,822867,32191,4.07,773111,830209,1399-8-24
428,دسينا,داروسازي‌ سينا,272,376218,9529975530,25080,24980,25260,180,0.72,25130,50,0.2,24230,25720,1399-8-24
429,دكيمي,كيميدارو,270,314233,6791245610,21450,20500,21580,130,0.61,21470,20,0.09,20500,22170,1399-8-24
430,پارسيان,بيمه پارسيان,268,3016280,33325005000,10530,11020,11050,520,4.94,10860,330,3.13,10750,11050,1399-8-24
431,تسه9903,امتياز تسهيلات مسكن خرداد99,268,3380,2778499861,788967,800000,828415,39448,5.0,822041,33074,4.19,800000,828415,1399-8-24
432,بترانس,ايران‌ ترانسفو,265,2194109,52658616000,22860,24000,24000,1140,4.99,24000,1140,4.99,24000,24000,1399-8-24
433,وتعاون,بيمه  تعاون,262,1181207,7292952015,6011,6012,6191,180,2.99,6069,58,0.96,6012,6191,1399-8-24
434,وبهمن,سرمايه‌گذاري‌بهمن‌,262,2126689,27200352310,12190,12790,12790,600,4.92,12500,310,2.54,12790,12790,1399-8-24
435,خراسان,پتروشيمي خراسان,256,460510,29536231440,61110,63750,64160,3050,4.99,62810,1700,2.78,63000,64160,1399-8-24
436,وسيزد,شركت س استان يزد,251,5597497,7146135010,1280,1220,1280,0,0.0,1280,0,0.0,1220,1340,1399-8-24
437,وپخش,داروپخش‌ (هلدينگ‌,246,292924,33656025910,109910,105100,115400,5490,4.99,113120,3210,2.92,105100,115400,1399-8-24
438,سفانو,سيمان فارس نو,246,303993,9014755400,29650,28210,28940,-710,-2.39,29650,0,0.0,28210,30420,1399-8-24
439,فسپا,گروه‌صنعتي‌سپاهان‌,243,1284694,52353360200,38920,40300,40860,1940,4.98,40750,1830,4.7,38000,40860,1399-8-24
440,ركيش,كارت اعتباري ايران كيش,243,3887610,53338009200,13070,13720,13720,650,4.97,13720,650,4.97,13720,13720,1399-8-24
441,آپ,آسان پرداخت پرشين,243,1117067,18610336220,15870,16660,16660,790,4.98,16150,280,1.76,16660,16660,1399-8-24
442,سهگمت,سيمان‌هگمتان‌,242,756563,15167839580,19290,18940,20250,960,4.98,19510,220,1.14,18330,20250,1399-8-24
443,دفرا,فرآورده‌هاي‌ تزريقي‌ ايران‌,240,357086,8171173380,23350,23900,22700,-650,-2.78,23270,-80,-0.34,22190,24490,1399-8-24
444,شجم,صنايع پتروشيمي تخت جمشيد,240,3288087,23467076919,7357,7137,7137,-220,-2.99,7137,-220,-2.99,7137,7137,1399-8-24
445,كمرجان,بازرگاني و توليدي مرجان كار,239,306133,19750782761,61445,64517,64517,3072,5.0,62601,1156,1.88,64517,64517,1399-8-24
446,خكاوه,سايپا ديزل,239,2241452,12632823472,5810,5636,5636,-174,-2.99,5697,-113,-1.94,5636,5636,1399-8-24
447,پكوير,كوير تاير,238,4237265,62075932250,13960,14650,14650,690,4.94,14650,690,4.94,14650,14650,1399-8-24
448,كساپا,سايپاشيشه‌,237,1276174,27003841840,20160,21160,21160,1000,4.96,20670,510,2.53,21160,21160,1399-8-24
449,تابا,تابان نيرو سپاهان,235,527364,18210933648,33527,34532,34532,1005,3.0,34415,888,2.65,34532,34532,1399-8-24
450,گپارس,امور رفاهي كارگزاران پارس,219,113860,16181346441,138735,142897,138500,-235,-0.17,141405,2670,1.92,137310,142897,1399-8-24
451,زپارس,ملي كشت و صنعت و دامپروري پارس,216,198884,12253841680,59480,60000,62000,2520,4.24,59980,500,0.84,56520,62450,1399-8-24
452,ولتجار,واسپاري تجارت وسرمايه ايرانيان,214,2107264,12496021264,6107,5924,5924,-183,-3.0,5993,-114,-1.87,5924,6010,1399-8-24
453,بزاگرس,نيروگاه زاگرس كوثر,212,1237546,17246441056,14669,13936,13936,-733,-5.0,14403,-266,-1.81,13936,13936,1399-8-24
454,سخوز,سيمان خوزستان,211,1430368,27677102770,18430,19350,19350,920,4.99,18910,480,2.6,19100,19350,1399-8-24
455,فلات,گروه صنايع معادن فلات ايرانيان,208,1861974,23750681901,12389,12760,12760,371,2.99,12756,367,2.96,12410,12760,1399-8-24
456,سقاين,سيمان‌ قائن‌,207,163323,6411231080,38940,37010,38240,-700,-1.8,38980,40,0.1,37010,40750,1399-8-24
457,سپاس,صندوق س. پاداش سهامداري توسعه1,207,7719227,77600205176,10041,10050,10050,9,0.09,10053,12,0.12,10050,10058,1399-8-24
458,تكمبا,كمباين‌ سازي‌ ايران‌,206,1242743,11855768220,10040,9540,9540,-500,-4.98,9920,-120,-1.2,9540,9540,1399-8-24
459,تبرك,گروه كارخانجات صنعتي تبرك,206,435844,11521971984,27827,26436,26436,-1391,-5.0,27490,-337,-1.21,26436,26436,1399-8-24
460,وآفري,بيمه كارآفرين,205,886666,12629563511,14416,14000,14497,81,0.56,14306,-110,-0.76,13984,14640,1399-8-24
461,وثخوز,سرمايه گذاري و توسعه خوزستان,200,227071,7361312221,31673,32100,32580,907,2.86,31941,268,0.85,31980,32623,1399-8-24
462,صايند,صندوق س. گنجينه آينده روشن-د,195,2945050,29205428080,9909,9945,9920,11,0.11,9917,8,0.08,9902,9957,1399-8-24
463,اتكاي,بيمه اتكايي ايرانيان,194,668661,8435880418,12290,12670,12750,460,3.74,12344,54,0.44,12362,12750,1399-8-24
464,تسه9710,امتياز تسهيلات مسكن دي 97,194,2423,1989089941,796971,760010,836800,39829,5.0,820920,23949,3.01,760010,836819,1399-8-24
465,ياقوت,صندوق س ياقوت آگاه-ثابت,192,4636211,51965845942,11200,11200,11221,21,0.19,11209,9,0.08,11191,11239,1399-8-24
466,شفارس,صنايع‌ شيميايي‌ فارس‌,191,945549,33387335190,33630,35310,35310,1680,5.0,34700,1070,3.18,35310,35310,1399-8-24
467,آساميد,صندوق س.مشترك آسمان اميد -د,187,8343907,91643463620,10966,10963,10985,19,0.17,10983,17,0.16,10963,10990,1399-8-24
468,توريل,توکاريل,185,719716,13593276092,17988,18887,18887,899,5.0,18221,233,1.3,18887,18887,1399-8-24
469,تسه9709,امتياز تسهيلات مسكن آذر97,185,3674,3000055970,791056,800101,828400,37344,4.72,816564,25508,3.22,780000,830608,1399-8-24
470,كسرام,پارس‌ سرام‌,184,2537285,16543098200,6210,6520,6520,310,4.99,6310,100,1.61,6520,6520,1399-8-24
471,ضخود1048,اختيارخ خودرو-7000-1399/10/07,183,9494,702272000,77,100,74,-3,-3.9,74,-3,-3.9,70,100,1399-8-24
472,بذر,صندوق س بذر اميد آفرين-سهام,182,84812,8507851910,96290,97830,103000,6710,6.97,100310,4020,4.17,97830,103000,1399-8-24
473,غدام,خوراك‌  دام‌ پارس‌,181,181790,51350221300,269020,282470,282470,13450,5.0,282180,13160,4.89,282470,282470,1399-8-24
474,قهكمت,قندهكمتان‌,179,213947,9086184060,41870,41500,42790,920,2.2,41980,110,0.26,41500,43100,1399-8-24
475,ضخود1043,اختيارخ خودرو-3500-1399/10/07,176,7130,3701077000,427,509,522,95,22.25,519,92,21.55,464,545,1399-8-24
476,ثباغ,شهر سازي و خانه سازي باغميشه,176,765511,20923712163,28771,27333,27333,-1438,-5.0,28138,-633,-2.2,27333,27333,1399-8-24
477,غمارگ,مارگارين‌,175,644759,14893932900,22000,23100,23100,1100,5.0,22310,310,1.41,23100,23100,1399-8-24
478,كگاز,شيشه‌ و گاز,174,916119,21803632200,25050,23800,23800,-1250,-4.99,24480,-570,-2.28,23800,23800,1399-8-24
479,شگل,گلتاش‌,174,2324150,52627970910,21580,22590,22650,1070,4.96,22640,1060,4.91,22310,22650,1399-8-24
480,تنوين,تامين سرمايه نوين,171,4098764,22994066040,5350,5610,5610,260,4.86,5460,110,2.06,5610,5920,1399-8-24
481,شوينده,مديريت صنعت شوينده ت.ص.بهشهر,171,344988,11826934620,32720,34200,34350,1630,4.98,33070,350,1.07,33000,34350,1399-8-24
482,ولصنم,ليزينگ‌صنعت‌ومعدن‌,171,2623543,19965162230,7250,7610,7610,360,4.97,7390,140,1.93,7610,7610,1399-8-24
483,تسه9712,امتياز تسهيلات مسكن اسفند97,168,2705,2234094726,793200,832000,826222,33022,4.16,825913,32713,4.12,780011,832860,1399-8-24
484,تسه9812,امتياز تسهيلات مسكن اسفند98,168,1758,1438693959,784366,823584,823584,39218,5.0,818370,34004,4.34,800000,823584,1399-8-24
485,كفپارس,فرآورده‌هاي‌ نسوز پارس‌,166,281129,2586386800,9680,9200,9200,-480,-4.96,9650,-30,-0.31,9200,9200,1399-8-24
486,شكبير,پتروشيمي اميركبير,166,481338,27201563334,58187,56442,56442,-1745,-3.0,57627,-560,-0.96,56442,59931,1399-8-24
487,سمتاز,سيمان ممتازان كرمان,164,712909,16264939251,23497,23010,22793,-704,-3.0,22926,-571,-2.43,22793,23010,1399-8-24
488,تپولا,مهندسي مرآت پولاد,164,2019191,57326851681,27565,28391,28391,826,3.0,28391,826,3.0,28391,28391,1399-8-24
489,تسه9901,امتياز تسهيلات مسكن فروردين99,162,1426,1179767745,793344,833011,833011,39667,5.0,827327,33983,4.28,803122,833011,1399-8-24
490,تسه9711,امتياز تسهيلات مسكن بهمن 97,161,2221,1824777755,793179,781000,832837,39658,5.0,821602,28423,3.58,781000,832837,1399-8-24
491,ضپاس1001,اختيارخ وپارس-2500-1399/10/30,159,3714,2671909000,452,600,769,317,70.13,719,267,59.07,600,777,1399-8-24
492,وتوس,توسعه‌شهري‌توس‌گستر,159,165381,5302114860,33740,32060,32060,-1680,-4.98,33550,-190,-0.56,32060,32060,1399-8-24
493,ضصاد1100,اختيارخ وبصادر-2500-1399/11/12,159,4102,2589568000,470,500,700,230,48.94,631,161,34.26,490,748,1399-8-24
494,وسرمد,بيمه  سرمد,157,2395960,13630237791,5555,5510,5721,166,2.99,5644,89,1.6,5510,5721,1399-8-24
495,حتايد,تايدواترخاورميانه,155,1604990,25214392900,14970,15710,15710,740,4.94,15330,360,2.4,15710,15710,1399-8-24
496,تشتادح,ح.صنايع توليدي اشتاد ايران‌,155,1758222,18707182196,11009,11669,10400,-609,-5.53,10640,-369,-3.35,10349,11669,1399-8-24
497,كمينا,شيشه سازي مينا,154,520946,15026687370,30363,28845,28845,-1518,-5.0,29162,-1201,-3.96,28845,28845,1399-8-24
498,سكه0011پ02,سكه تمام بهارتحويلي 1روزه ملت,152,45600,58105282500,1289536,1282000,1259999,-29537,-2.29,1274239,-15297,-1.19,1251200,1296500,1399-8-24
499,ضپاس1002,اختيارخ وپارس-3000-1399/10/30,152,4715,2258180000,337,469,540,203,60.24,479,142,42.14,440,540,1399-8-24
500,سفارود,كارخانه فارسيت درود,150,2021333,20124391348,9761,9956,9956,195,2.0,9956,195,2.0,9956,9956,1399-8-24
501,وكادو,تكادو,145,452814,7123669848,16218,15732,15732,-486,-3.0,16040,-178,-1.1,15732,15732,1399-8-24
502,پتاير,ايران‌ تاير,143,77754,7972895160,97660,102540,102540,4880,5.0,98400,740,0.76,102540,102540,1399-8-24
503,سكه0112پ03,سكه تمام بهارتحويلي1روزه سامان,141,40200,50870807000,1292091,1283500,1251100,-40991,-3.17,1265443,-26648,-2.06,1250000,1296110,1399-8-24
504,كيان2,صندوق س. با درآمد ثابت كيان,140,14000000,14000000,25881,1,1,-25880,-100.0,1,-25880,-100.0,1,1,1399-8-24
505,غمهرا,توليدي‌مهرام‌,138,80767,3987722410,48910,49390,50000,1090,2.23,48950,40,0.08,48280,50000,1399-8-24
506,ساذريح,ح . آذريت‌,134,938880,4935520061,5268,5420,5182,-86,-1.63,5257,-11,-0.21,5144,5420,1399-8-24
507,تماوند,تامين سرمايه دماوند,128,629396,8565450164,14325,13609,13609,-716,-5.0,14002,-323,-2.25,13609,13609,1399-8-24
508,پاسا,ايران‌ياساتايرورابر,126,349724,6959507600,18960,19900,19900,940,4.96,19080,120,0.63,19900,19900,1399-8-24
509,وسناح,ح. سرمايه گذاري نيروگاهي ايران,123,185605,1700923368,9084,8881,9356,272,2.99,9164,80,0.88,8881,9356,1399-8-24
510,تسه9811,امتياز تسهيلات مسكن بهمن98,122,1073,882074926,796681,767111,835000,38319,4.81,822064,25383,3.19,767111,836515,1399-8-24
511,سدشت,صنايع سيمان دشتستان,120,190173,7523340100,37960,37000,39850,1890,4.98,38190,230,0.61,37000,39850,1399-8-24
512,وايران,ليزينگ ايرانيان,118,535203,4950627750,9730,9250,9250,-480,-4.93,9680,-50,-0.51,9250,9250,1399-8-24
513,زعف9908پ10,زعفران9908نگين طلاي سرخ(پ),117,103085,8438502316,81762,81000,80701,-1061,-1.3,81860,98,0.12,80100,82780,1399-8-24
514,آسام,صندوق س.آرمان سپهر آشنا-م,117,98180,9513275650,94140,95890,97900,3760,3.99,96896,2756,2.93,94150,98000,1399-8-24
515,تسه9802,امتياز تسهيلات مسكن ارديبهشت98,116,729,594416900,784229,745556,823440,39211,5.0,815387,31158,3.97,745556,823440,1399-8-24
516,تايرا,تراكتورسازي‌ايران‌,116,670196,13476576450,19160,20110,20110,950,4.96,19400,240,1.25,19510,20110,1399-8-24
517,وملت,سرمايه گذاري ملت,115,2541296,12958068304,5203,5099,5099,-104,-2.0,5099,-104,-2.0,5099,5099,1399-8-24
518,سپرمي,پرميت‌,115,839005,6972764293,8456,8287,8287,-169,-2.0,8311,-145,-1.71,8287,8625,1399-8-24
519,ضغدر1119,اختيارخ وغدير-10000-1399/11/26,114,3170,8717200000,1558,2010,3000,1442,92.55,2750,1192,76.51,2010,3000,1399-8-24
520,سبجنو,سيمان‌ بجنورد,112,83768,2592888030,30660,30010,30810,150,0.49,30680,20,0.07,30010,31460,1399-8-24
521,وملي,گروه‌ صنعتي‌ ملي‌ (هلدينگ‌,110,10825,3925686250,381730,362650,362650,-19080,-5.0,380150,-1580,-0.41,362650,362650,1399-8-24
522,ساروج,بين المللي ساروج بوشهر,109,1564980,29727887988,19581,18994,18994,-587,-3.0,18996,-585,-2.99,18994,19800,1399-8-24
523,نطرين,عطرين نخ قم,109,371120,5609849920,15911,15116,15116,-795,-5.0,15817,-94,-0.59,15116,15116,1399-8-24
524,تليسه,دامداري تليسه نمونه,107,1334770,6159963550,4396,4615,4615,219,4.98,4422,26,0.59,4615,4615,1399-8-24
525,تسه9801,امتياز تسهيلات مسكن فروردين98,107,475,388697901,780062,819065,819065,39003,5.0,818311,38249,4.9,800000,819065,1399-8-24
526,غشاذر,پگاه‌آذربايجان‌غربي‌,106,238224,4569136320,20180,19180,19180,-1000,-4.96,20080,-100,-0.5,19180,19180,1399-8-24
527,سصفها,سيمان‌اصفهان‌,105,134943,20129447310,142070,149170,149170,7100,5.0,144790,2720,1.91,149170,149170,1399-8-24
528,فيروزا,صندوق بادرآمد ثابت فيروزه آسيا,104,836437,17681118367,21108,21055,21135,27,0.13,21139,31,0.15,21052,21160,1399-8-24
529,اخزا815,اسنادخزانه-م15بودجه98-010406,102,123352,90633645356,734595,735255,734482,-113,-0.02,734756,161,0.02,734482,736000,1399-8-24
530,خاور,ايران خودرو ديزل,101,272018,1725410174,6539,6343,6343,-196,-3.0,6522,-17,-0.26,6343,6343,1399-8-24
531,دمعيار,صندوق س. توازن معيار-د,100,3273197,32871070453,10028,10040,10045,17,0.17,10042,14,0.14,10031,10059,1399-8-24
532,سخند2,صندوق س.سپهرخبرگان نفت-د,100,10000000,10000000,10032,1,1,-10031,-99.99,1,-10031,-99.99,1,1,1399-8-24
533,صنوين,صندوق سرمايه‌گذاري صنوين-مختلط,98,40739,4079638800,98040,98010,101000,2960,3.02,100140,2100,2.14,98010,101000,1399-8-24
534,بموتو,موتوژن‌,98,279468,11514081600,39240,41200,41200,1960,4.99,39670,430,1.1,41200,41200,1399-8-24
535,ميهن,بيمه ميهن,98,1378304,6877736960,5252,4990,4990,-262,-4.99,5214,-38,-0.72,4990,4990,1399-8-24
536,تسه9803,امتياز تسهيلات مسكن خرداد98,97,700,570438400,776107,814912,814912,38805,5.0,814912,38805,5.0,814912,814912,1399-8-24
537,وجامي,سرمايه گذاري جامي,97,833438,11358926502,14050,13629,13629,-421,-3.0,13804,-246,-1.75,13629,13629,1399-8-24
538,شزنگ,تجهيزنيروي‌زنگان‌,96,89524,10711278028,116163,119647,119647,3484,3.0,117975,1812,1.56,119647,119647,1399-8-24
539,تسه9809,امتياز تسهيلات مسكن آذر98,96,1434,1169064248,785238,756666,824499,39261,5.0,815247,30009,3.82,756666,824499,1399-8-24
540,الماس,صندوق س.امين تدبيرگران فردا-س,93,44169,4843391637,106321,109000,110002,3681,3.46,109656,3335,3.14,108011,110002,1399-8-24
541,بنيرو,نيروترانس‌,92,132795,7327628100,58080,55180,55180,-2900,-4.99,57630,-450,-0.77,55180,55180,1399-8-24
542,بميلا,توسعه بازرگاني آهن وفولادميلاد,92,2079233,42605563403,19895,20491,20491,596,3.0,20491,596,3.0,20491,20491,1399-8-24
543,ارمغان,ص سرمايه گذاري ارمغان ايرانيان,91,11915991,119974348102,10040,10058,10070,30,0.3,10068,28,0.28,10050,10070,1399-8-24
544,قنيشا,قند  نيشابور,90,56812,4504055360,83450,79280,79280,-4170,-5.0,83050,-400,-0.48,79280,79280,1399-8-24
545,كقزوي,شيشه‌ قزوين‌,90,391654,3470446094,9327,8861,8861,-466,-5.0,9242,-85,-0.91,8861,8861,1399-8-24
546,ضچاد1014,اختيارخ كچاد-14000-1399/10/02,89,829,2754833000,2714,3001,3449,735,27.08,3323,609,22.44,3000,3500,1399-8-24
547,تسه9808,امتياز تسهيلات مسكن آبان98,87,1011,829910517,788080,789122,827484,39404,5.0,820881,32801,4.16,748760,827484,1399-8-24
548,سنوين,سرمايه گذاري اقتصاد نوين,84,1521797,14058216894,9384,9197,9197,-187,-1.99,9238,-146,-1.56,9197,9384,1399-8-24
549,اخزا817,اسنادخزانه-م17بودجه98-010512,78,103973,74708048377,720967,718888,717633,-3334,-0.46,718533,-2434,-0.34,702201,722000,1399-8-24
550,اخزا903,اسنادخزانه-م3بودجه99-011110,78,123714,79844305947,652846,650916,645000,-7846,-1.2,645394,-7452,-1.14,640000,654000,1399-8-24
551,بساما,بيمه سامان,77,470714,10530813608,21307,22372,22372,1065,5.0,21521,214,1.0,22372,22372,1399-8-24
552,اخزا808,اسنادخزانه-م8بودجه98-000817,76,66632,56254315653,844514,844990,844243,-271,-0.03,844254,-260,-0.03,844243,844990,1399-8-24
553,كتوكا,توليدي و خدمات صنايع نسوز توكا,75,19274,2314113536,126383,120064,120064,-6319,-5.0,126075,-308,-0.24,120064,120064,1399-8-24
554,ثپرديس,سرمايه گذاري مسكن پرديس,73,200557,2186472414,11475,10902,10902,-573,-4.99,11449,-26,-0.23,10902,10902,1399-8-24
555,شساخت,مهندسي و ساختمان صنايع نفت,73,80137,3068606004,40307,38292,38292,-2015,-5.0,40147,-160,-0.4,38292,38292,1399-8-24
556,كشرق,صنعتي و معدني شمال شرق شاهرود,72,155275,9398485200,57646,60528,60528,2882,5.0,58162,516,0.9,60528,60528,1399-8-24
557,ضصاد1101,اختيارخ وبصادر-3000-1399/11/12,72,1941,876244000,362,439,499,137,37.85,451,89,24.59,435,499,1399-8-24
558,اخزا811,اسنادخزانه-م11بودجه98-001013,68,303269,248784443143,820470,820649,820000,-470,-0.06,820342,-128,-0.02,820000,820900,1399-8-24
559,تسه9807,امتياز تسهيلات مسكن مهر98,67,853,698031116,786427,750011,825000,38573,4.9,818325,31898,4.06,750011,825748,1399-8-24
560,دلقما,دارويي‌ لقمان‌,67,169720,5144213200,31900,30310,30310,-1590,-4.98,31730,-170,-0.53,30310,30310,1399-8-24
561,حپارسا,توسعه حمل و نقل ريلي پارسيان,67,56588,1660801212,30893,29349,29349,-1544,-5.0,30839,-54,-0.17,29349,29349,1399-8-24
562,افران,صندوق س افرا نماد پايدار-ثابت,66,2148347,25683534471,11950,11970,11960,10,0.08,11955,5,0.04,11924,11970,1399-8-24
563,بايكا,كارخانجات كابلسازي ‌ايران‌,66,61044,2330843052,39363,38183,38183,-1180,-3.0,39221,-142,-0.36,38183,38183,1399-8-24
564,ولراز,ليزينگ رازي,65,163743,4280733249,24899,26143,26143,1244,5.0,25153,254,1.02,26143,26143,1399-8-24
565,سپر,صندوق س سپر سرمايه بيدار- ثابت,64,134835,1380496883,10123,10270,10248,125,1.23,10238,115,1.14,10190,10280,1399-8-24
566,ساربيل,سيمان آرتا اردبيل,64,52753,3232176310,64490,61270,61270,-3220,-4.99,64270,-220,-0.34,61270,61270,1399-8-24
567,تصميم,صندوق س با درآمد ثابت تصميم,64,1359724,20152908172,14790,14790,14828,38,0.26,14821,31,0.21,14790,14850,1399-8-24
568,بسويچ,پارس‌سويچ‌,64,65397,2664273780,42880,40740,40740,-2140,-4.99,42760,-120,-0.28,40740,40740,1399-8-24
569,دقاضي,داروسازي شهيد قاضي,63,15173,1309620522,87659,85467,87000,-659,-0.75,87569,-90,-0.1,85030,88950,1399-8-24
570,هصيكو402,اختيارف ت تاصيكو13500-00/02/20,62,86100,375051600,4095,4356,4356,261,6.37,4356,261,6.37,4356,4356,1399-8-24
571,آرمان,بيمه آرمان,60,2580250,19555714750,7219,7579,7579,360,4.99,7554,335,4.64,7579,7579,1399-8-24
572,شرنگي,شيميايي رنگين,59,17781,1809910868,107516,104292,101164,-6352,-5.91,106969,-547,-0.51,101164,104292,1399-8-24
573,كاذر,فرآورده‌هاي‌نسوزآذر,58,212908,4106995320,20300,19290,19290,-1010,-4.98,20210,-90,-0.44,19290,19290,1399-8-24
574,تسه9804,امتياز تسهيلات مسكن تير98,57,659,538319236,788252,827664,827664,39412,5.0,816873,28621,3.63,770888,827664,1399-8-24
575,شرانل,نفت ايرانول,57,515902,15140175994,27950,29347,29347,1397,5.0,28353,403,1.44,29347,29347,1399-8-24
576,حپترو,حمل و نقل پتروشيمي( سهامي عام,56,110747,3240457220,30790,29260,29260,-1530,-4.97,30690,-100,-0.32,29260,29260,1399-8-24
577,قپيرا,فرآورده‌هاي‌غدايي‌وقندپيرانشهر,56,82853,7581049500,87150,91500,91500,4350,4.99,87780,630,0.72,91500,91500,1399-8-24
578,لكما,كارخانجات‌مخابراتي‌ايران‌,55,585601,6154666510,10835,10510,10510,-325,-3.0,10732,-103,-0.95,10510,10510,1399-8-24
579,پلاسك,پلاسكوكار,54,183348,1516287960,8700,8270,8270,-430,-4.94,8690,-10,-0.11,8270,8270,1399-8-24
580,تسه9806,امتياز تسهيلات مسكن شهريور98,54,390,319726633,788050,827452,827452,39402,5.0,819812,31762,4.03,800000,827452,1399-8-24
581,اخزا809,اسنادخزانه-م9بودجه98-000923,54,63534,52530791375,826684,826685,826632,-52,-0.01,826814,130,0.02,826632,827500,1399-8-24
582,جوين,كشت و صنعت جوين,54,233910,5103682290,21184,21819,21819,635,3.0,21341,157,0.74,21819,21819,1399-8-24
583,اشاد9,مشاركت دولتي9-شرايط خاص990909,53,665000,663753600000,994122,994122,998500,4378,0.44,998126,4004,0.4,994122,998500,1399-8-24
584,ضخود1045,اختيارخ خودرو-4500-1399/10/07,53,1893,391964000,184,200,212,28,15.22,207,23,12.5,191,230,1399-8-24
585,ضپاس1003,اختيارخ وپارس-3500-1399/10/30,52,949,327573000,228,339,379,151,66.23,345,117,51.32,300,400,1399-8-24
586,ضخود1041,اختيارخ خودرو-2500-1399/10/07,52,801,963156000,954,1100,1249,295,30.92,1202,248,26.0,1100,1249,1399-8-24
587,تسه9805,امتياز تسهيلات مسكن مرداد98,49,378,309098330,790663,830196,830196,39533,5.0,817720,27057,3.42,789001,830196,1399-8-24
588,هترول911,اختيارف ت پترول-14730-99/11/15,48,61885,122903610,1892,1986,1986,94,4.97,1986,94,4.97,1986,1986,1399-8-24
589,وسين,بيمه سينا,47,148753,2820951892,19550,18964,18964,-586,-3.0,19465,-85,-0.43,18964,18964,1399-8-24
590,چكاوه,صنايع‌كاغذسازي‌كاوه‌,47,43518,1538361300,37210,35350,35350,-1860,-5.0,37150,-60,-0.16,35350,35350,1399-8-24
591,ثروتم,صندوق س. ثروت آفرين پارسيان-س,46,15490,1403437060,88547,89000,90900,2353,2.66,90603,2056,2.32,89000,90990,1399-8-24
592,ضچاد1015,اختيارخ كچاد-16000-1399/10/02,45,762,1685822000,1658,2200,2210,552,33.29,2212,554,33.41,2100,2390,1399-8-24
593,فولاي,صنايع فولاد آلياژي يزد,45,50005,2460746050,51799,49210,49210,-2589,-5.0,51665,-134,-0.26,49210,49210,1399-8-24
594,فسا,پتروشيمي فسا,44,137939,397264320,3031,2880,2880,-151,-4.98,3028,-3,-0.1,2880,2880,1399-8-24
595,اخزا806,اسنادخزانه-م6بودجه98-000519,44,102050,89638784964,878330,878294,878500,170,0.02,878381,51,0.01,878294,879000,1399-8-24
596,وسقم,شركت س استان قم,42,502648,673548320,1410,1340,1340,-70,-4.96,1410,0,0.0,1340,1340,1399-8-24
597,اخزا814,اسنادخزانه-م14بودجه98-010318,42,90220,67717609391,749864,750268,750268,404,0.05,750583,719,0.1,750268,751270,1399-8-24
598,ثاصفا,شركت‌ ساختمان‌ اصفهان‌,42,37351,962647323,26570,25773,25773,-797,-3.0,26530,-40,-0.15,25773,25773,1399-8-24
599,سيلام,سيمان‌ ايلام‌,42,271363,2735339040,10610,10080,10080,-530,-5.0,10580,-30,-0.28,10080,10080,1399-8-24
600,اخزا821,اسنادخزانه-م21بودجه98-020906,41,18105,10308300680,569904,569904,570000,96,0.02,569362,-542,-0.1,565002,571000,1399-8-24
601,خفنر,فنرسازي‌خاور,41,70414,1310404540,19580,18610,18610,-970,-4.95,19550,-30,-0.15,18610,18610,1399-8-24
602,سايرا,ايرانيت‌,41,62467,2293288433,36143,36865,36865,722,2.0,36271,128,0.35,35421,36865,1399-8-24
603,ضبدر1158,اختيارخ شبندر-24000-1399/11/19,40,196,746615000,3453,3600,3685,232,6.72,3809,356,10.31,3600,4000,1399-8-24
604,ضفلا1154,اختيارخ فولاد-12000-1399/11/28,40,1096,3397292000,2048,2005,3300,1252,61.13,3100,1052,51.37,2005,3390,1399-8-24
605,خزر,فنرسازي‌زر,39,322391,4774610710,14110,14810,14810,700,4.96,14170,60,0.43,14810,14810,1399-8-24
606,اخزا818,اسنادخزانه-م18بودجه98-010614,39,59088,41865796758,708700,711000,709000,300,0.04,708533,-167,-0.02,707000,711000,1399-8-24
607,اخزا904,اسنادخزانه-م4بودجه99-011215,36,54775,34921258105,638227,638009,633500,-4727,-0.74,637540,-687,-0.11,622522,639010,1399-8-24
608,شفارا,پتروشيمي فارابي,35,211437,1089957735,5314,5155,5155,-159,-2.99,5305,-9,-0.17,5155,5155,1399-8-24
609,نگين,ص.س. زمين و ساختمان نگين شهرري,35,25989,1302033490,50110,50000,50000,-110,-0.22,50100,-10,-0.02,50000,50970,1399-8-24
610,سمايه,بانك سرمايه,34,62130,573335640,9513,9228,9228,-285,-3.0,9505,-8,-0.08,9228,9228,1399-8-24
611,خموتور,موتورسازان‌تراكتورسازي‌ايران‌,34,136282,1580871200,12210,11600,11600,-610,-5.0,12190,-20,-0.16,11600,11600,1399-8-24
612,تكنار,مجتمع معادن مس تكنار,34,52448,4970287168,97696,94766,94766,-2930,-3.0,96945,-751,-0.77,94766,94766,1399-8-24
613,وارس,سرمايه گذاري ارس صبا,33,66791,4983209719,72436,74609,74609,2173,3.0,72962,526,0.73,74609,74609,1399-8-24
614,سخند,صندوق س.سپهرخبرگان نفت-د,33,411150,4134261670,10032,10060,10066,34,0.34,10055,23,0.23,10035,10070,1399-8-24
615,غشصفا,شيرپاستوريزه‌پگاه‌اصفهان‌,32,87599,2636729900,31680,30100,30100,-1580,-4.99,31590,-90,-0.28,30100,30100,1399-8-24
616,زنگان,صنعت روي زنگان,32,156568,23927661168,160869,152826,152826,-8043,-5.0,156817,-4052,-2.52,152826,152826,1399-8-24
617,شكف,كف,31,19374,1479418014,77919,76361,76361,-1558,-2.0,77684,-235,-0.3,76361,76361,1399-8-24
618,فنوال,نورد آلومينيوم‌,30,44617,1496008010,35290,33530,33530,-1760,-4.99,35230,-60,-0.17,33530,33530,1399-8-24
619,آكورد2,صندوق س. آرمان آتي كوثر-د,30,3000000,3000000,29295,1,1,-29294,-100.0,1,-29294,-100.0,1,1,1399-8-24
620,كيسون,شركت كيسون,30,38668,739641504,19719,19128,19128,-591,-3.0,19708,-11,-0.06,19128,19128,1399-8-24
621,نيرو,نيرو سرمايه,30,118401,5570293446,48501,47046,47046,-1455,-3.0,48083,-418,-0.86,47046,47046,1399-8-24
622,ضفلا8079,اختيارخ فولاد-10775-1399/08/28,30,145,226845000,833,1480,1849,1016,121.97,1564,731,87.76,1480,1849,1399-8-24
623,سنير,سيمان‌ سفيد ني‌ريز,29,21749,1696422000,82100,78000,78000,-4100,-4.99,81950,-150,-0.18,78000,78000,1399-8-24
624,خكار,ايركا پارت صنعت,29,24675,751353750,32050,30450,30450,-1600,-4.99,32020,-30,-0.09,30450,30450,1399-8-24
625,آگاس2,صندوق س.هستي بخش آگاه-س,28,6200000,6200000,61278,1,1,-61277,-100.0,1,-61277,-100.0,1,1,1399-8-24
626,لپيام,گسترش صنايع پيام,28,310555,9285283945,30823,29899,29899,-924,-3.0,30381,-442,-1.43,29899,29899,1399-8-24
627,خچرخش,چرخشگر,28,36225,658570500,19130,18180,18180,-950,-4.97,19120,-10,-0.05,18180,18180,1399-8-24
628,كهرام,توليدي گرانيت بهسرام,28,140371,8497885207,58784,60547,60547,1763,3.0,59508,724,1.23,60537,61568,1399-8-24
629,غپونه,نوش پونه مشهد,27,80287,1253601218,16096,15614,15614,-482,-2.99,16065,-31,-0.19,15614,15614,1399-8-24
630,غاذر,كشت‌وصنعت‌پياذر,27,12896,947211200,77310,73450,73450,-3860,-4.99,77230,-80,-0.1,73450,73450,1399-8-24
631,داراب,پتروشيمي داراب,26,235669,708421014,3164,3006,3006,-158,-4.99,3158,-6,-0.19,3006,3006,1399-8-24
632,شتولي,تولي‌پرس‌,26,64854,1489631526,23437,22969,22969,-468,-2.0,23366,-71,-0.3,22969,22969,1399-8-24
633,ثنور,سرمايه گذاري كوه نور,26,107744,776726496,7431,7209,7209,-222,-2.99,7422,-9,-0.12,7209,7209,1399-8-24
634,شستا991,اجاره تامين اجتماعي-امين991226,26,304,303209740,1009940,1010000,1009999,59,0.01,997400,-12540,-1.24,990099,1010000,1399-8-24
635,كسعدي,كاشي‌ سعدي‌,25,13096,748960240,60190,57190,57190,-3000,-4.98,60140,-50,-0.08,57190,57190,1399-8-24
636,نمرينو,ايران‌ مرينوس‌,25,17637,954690810,56970,54130,54130,-2840,-4.99,56910,-60,-0.11,54130,54130,1399-8-24
637,اخزا902,اسنادخزانه-م2بودجه99-011019,25,43732,28694049784,656470,656482,650000,-6470,-0.99,656134,-336,-0.05,650000,656700,1399-8-24
638,اخزا812,اسنادخزانه-م12بودجه98-001111,25,67093,54119591670,806636,806635,806635,-1,0.0,806635,-1,0.0,806635,806990,1399-8-24
639,خعمرا,توسعه و عمران شهرستان نائين,25,88183,1486853563,16059,16861,16861,802,4.99,16116,57,0.35,16861,16861,1399-8-24
640,كابگن,توليدي و صنعتي آبگينه‌,24,131370,640166010,4825,4873,4873,48,0.99,4831,6,0.12,4873,4873,1399-8-24
641,كشم0001پ01,كشمش سبز0001خليل آباد(پ),24,551,205814421,356959,374803,374800,17841,5.0,373529,16570,4.64,368000,374806,1399-8-24
642,حسير,ريل سير كوثر,24,32757,855580083,27493,26119,26119,-1374,-5.0,27468,-25,-0.09,26119,26119,1399-8-24
643,فوكا,فولاد كاويان,24,74571,1519384125,21005,20375,20375,-630,-3.0,20985,-20,-0.1,20375,20375,1399-8-24
644,ضفلا8085,اختيارخ فولاد-16775-1399/08/28,24,562,2689000,30,5,2,-28,-93.33,5,-25,-83.33,2,8,1399-8-24
645,غپآذر,شير پگاه آذربايجان شرقي,24,7242,378495888,55014,52264,52264,-2750,-5.0,54992,-22,-0.04,52264,52264,1399-8-24
646,ضملي1148,اختيارخ فملي-10140-1399/11/05,23,300,1591537000,3502,5000,5500,1998,57.05,5305,1803,51.48,4000,5500,1399-8-24
647,ضسپا8016,اختيارخ خساپا-2000-1399/08/26,23,555,165051000,193,290,340,147,76.17,297,104,53.89,250,340,1399-8-24
648,اخزا820,اسنادخزانه-م20بودجه98-020806,23,110702,63895710893,579744,579900,577000,-2744,-0.47,577187,-2557,-0.44,575001,580799,1399-8-24
649,چافست,افست‌,23,48641,1222834740,26460,25140,25140,-1320,-4.99,26430,-30,-0.11,25140,25140,1399-8-24
650,ضسپا8018,اختيارخ خساپا-2400-1399/08/26,22,539,7097000,9,12,13,4,44.44,13,4,44.44,10,35,1399-8-24
651,عيار2,صندوق س. پشتوانه طلاي مفيد,22,220000,220000,32485,1,1,-32484,-100.0,1,-32484,-100.0,1,1,1399-8-24
652,خپويش,سازه‌ پويش‌,22,22076,836680400,39890,37900,37900,-1990,-4.99,39850,-40,-0.1,37900,37900,1399-8-24
653,وساربيل,شركت س استان اردبيل,22,189395,231061900,1280,1220,1220,-60,-4.69,1280,0,0.0,1220,1220,1399-8-24
654,تملي702,تسهيلات مسكن ب. ملي-ارديبهشت97,22,461,533357272,1205333,1265599,1240000,34667,2.88,1156957,-48376,-4.01,1145067,1265599,1399-8-24
655,گنجين,صندوق س. گنجينه يكم آويد-د,22,138038,1607056879,11600,11635,11645,45,0.39,11642,42,0.36,11625,11650,1399-8-24
656,اخزا810,اسنادخزانه-م10بودجه98-001006,22,48690,40283302276,827246,827246,827146,-100,-0.01,827342,96,0.01,827000,828000,1399-8-24
657,اخزا813,اسنادخزانه-م13بودجه98-010219,21,47617,36234180170,761150,760952,760950,-200,-0.03,760950,-200,-0.03,760950,760952,1399-8-24
658,اخزا816,اسنادخزانه-م16بودجه98-010503,21,27969,20294180690,726502,732500,725058,-1444,-0.2,725595,-907,-0.12,725058,732500,1399-8-24
659,اطلس2,صندوق س.توسعه اندوخته آينده-س,21,210000,210000,171397,1,1,-171396,-100.0,1,-171396,-100.0,1,1,1399-8-24
660,ضفلا8082,اختيارخ فولاد-13775-1399/08/28,20,335,29349000,109,11,105,-4,-3.67,88,-21,-19.27,11,125,1399-8-24
661,ضگل1142,اختيارخ كگل-16000-1399/11/21,20,105,291650000,2492,3000,2500,8,0.32,2778,286,11.48,2500,3000,1399-8-24
662,گوهر2,صندوق سكه طلاي كيان,20,200000,200000,64458,1,1,-64457,-100.0,1,-64457,-100.0,1,1,1399-8-24
663,وسزنجان,شركت س استان زنجان,19,377477,509593950,1420,1350,1350,-70,-4.93,1420,0,0.0,1350,1350,1399-8-24
664,ضفلا1155,اختيارخ فولاد-14000-1399/11/28,19,155,268113000,1000,1500,1998,998,99.8,1730,730,73.0,1400,1998,1399-8-24
665,وسخراج,شركت س استان خراسان جنوبي,19,112435,240610900,2250,2140,2140,-110,-4.89,2250,0,0.0,2140,2140,1399-8-24
666,ضملي1149,اختيارخ فملي-12168-1399/11/05,19,326,933200000,1500,2000,3000,1500,100.0,2863,1363,90.87,2000,3000,1399-8-24
667,لخزر,پارس‌ خزر,19,4167,843150780,212980,202340,202340,-10640,-5.0,212790,-190,-0.09,202340,202340,1399-8-24
668,ثامان,سامان‌ گستراصفهان‌,19,30298,644741440,22400,21280,21280,-1120,-5.0,22380,-20,-0.09,21280,21280,1399-8-24
669,جهرم,پتروشيمي جهرم,19,239228,747587500,3289,3125,3125,-164,-4.99,3283,-6,-0.18,3125,3125,1399-8-24
670,فبيرا,بسته‌ بندي‌ ايران‌,18,153585,753641595,5058,4907,4907,-151,-2.99,5052,-6,-0.12,4907,4907,1399-8-24
671,ثتوسا,س.توسعه و عمران استان اردبيل,18,202478,13242263678,68843,65401,65401,-3442,-5.0,66444,-2399,-3.48,65401,65401,1399-8-24
672,وسكهبو,س.عدالت ا. كهگيلويه وبويراحمد,18,194881,210471480,1130,1080,1080,-50,-4.42,1130,0,0.0,1080,1080,1399-8-24
673,غدشت,دشت‌ مرغاب‌,18,1100,293436000,280790,266760,266760,-14030,-5.0,280700,-90,-0.03,266760,266760,1399-8-24
674,ضچاد1016,اختيارخ كچاد-18000-1399/10/02,18,270,377935000,1009,1390,1400,391,38.75,1400,391,38.75,1390,1401,1399-8-24
675,فمراد,آلومراد,18,2313,329301810,149860,142370,142370,-7490,-5.0,149810,-50,-0.03,142370,142370,1399-8-24
676,شمواد,توليد مواداوليه الياف مصنوعي,18,19948,1226762104,64734,61498,61498,-3236,-5.0,64525,-209,-0.32,61498,61498,1399-8-24
677,وسبوشهر,شركت س استان بوشهر,18,114954,137944800,1260,1200,1200,-60,-4.76,1260,0,0.0,1200,1200,1399-8-24
678,ثغرب,شركت سرمايه گذاري مسكن شمالغرب,17,24489,316397880,13600,12920,12920,-680,-5.0,13595,-5,-0.04,12920,12920,1399-8-24
679,وحكمت,بيمه حكمت صبا,17,74744,425816568,5873,5697,5697,-176,-3.0,5869,-4,-0.07,5697,5697,1399-8-24
680,غگلپا,شير پاستوريزه پگاه گلپايگان,17,20497,1454057180,74673,70940,70940,-3733,-5.0,74559,-114,-0.15,70940,70940,1399-8-24
681,ضسپا1102,اختيارخ خساپا-2000-1399/11/26,17,414,314267000,498,669,800,302,60.64,759,261,52.41,665,800,1399-8-24
682,اخزا721,اسنادخزانه-م21بودجه97-000728,17,116545,99746367270,855844,856000,856000,156,0.02,855861,17,0.0,855842,856000,1399-8-24
683,تملي703,تسهيلات مسكن ب. ملي-خرداد97,16,161,169292604,1018484,1069408,967560,-50924,-5.0,1051507,33023,3.24,967560,1069408,1399-8-24
684,تكشا,گسترش‌صنايع‌وخدمات‌كشاورزي‌,16,22255,1590787400,75240,71480,71480,-3760,-5.0,75110,-130,-0.17,71480,71480,1399-8-24
685,كايتاح,ح.ايتالران‌,16,46511,647156943,14343,13917,13913,-430,-3.0,13914,-429,-2.99,13913,13917,1399-8-24
686,اخزا807,اسنادخزانه-م7بودجه98-000719,16,78214,66990070113,856494,860000,856500,6,0.0,856497,3,0.0,856493,860000,1399-8-24
687,زعف9908پ05,زعفران9908نگين زرين(پ),16,4360,374306000,84091,85850,85850,1759,2.09,85850,1759,2.09,85850,85850,1399-8-24
688,تپمپي,پمپ‌ سازي‌ ايران‌,16,4515,160508250,37420,35550,35550,-1870,-5.0,37410,-10,-0.03,35550,35550,1399-8-24
689,ضسپا8017,اختيارخ خساپا-2200-1399/08/26,15,198,34675000,75,170,104,29,38.67,175,100,133.33,76,299,1399-8-24
690,لازما,كارخانه هاي صنعتي آزمايش,15,31043,945569780,31081,30460,30460,-621,-2.0,31021,-60,-0.19,30460,30460,1399-8-24
691,سخواف,سيمان مجد خواف,14,17385,280054965,16607,16109,16109,-498,-3.0,16600,-7,-0.04,16109,16109,1399-8-24
692,پارتا,مجتمع‌صنعتي‌آرتاويل‌تاير,14,6932,415025772,61722,59871,59871,-1851,-3.0,61695,-27,-0.04,59871,59871,1399-8-24
693,ضملي1153,اختيارخ فملي-20280-1399/11/05,14,167,64902000,235,370,397,162,68.94,389,154,65.53,282,397,1399-8-24
694,فالوم,آلومتك‌,14,3568,120380752,34782,33739,33739,-1043,-3.0,34776,-6,-0.02,33739,33739,1399-8-24
695,پست9908-04,پسته فندقي32-30سبزدانه9908,14,207,256131540,1158111,1121753,1239829,81718,7.06,1237350,79239,6.84,1121753,1239829,1399-8-24
696,قمرو,قند مرودشت‌,14,4940,163267000,34780,33050,33050,-1730,-4.97,34770,-10,-0.03,33050,33050,1399-8-24
697,ضغدر8030,اختيارخ وغدير-6510-1399/08/26,14,84,333350000,3063,3750,4400,1337,43.65,3968,905,29.55,3750,4400,1399-8-24
698,فماك,ماداكتو استيل كرد,14,252438,6813301620,24592,26990,26990,2398,9.75,26990,2398,9.75,26990,26990,1399-8-24
699,ضخود1040,اختيارخ خودرو-2000-1399/10/07,14,123,201324000,1437,1628,1790,353,24.57,1637,200,13.92,1508,1790,1399-8-24
700,ضفلا8080,اختيارخ فولاد-11775-1399/08/28,13,58,57478000,636,979,979,343,53.93,991,355,55.82,979,1000,1399-8-24
701,خكمك,كمك‌فنرايندامين‌,13,3492,181164960,54610,51880,51880,-2730,-5.0,54600,-10,-0.02,51880,51880,1399-8-24
702,حاريا,كشتيراني آريا,13,17191,530462687,31811,30857,30857,-954,-3.0,31785,-26,-0.08,30857,30857,1399-8-24
703,ضفلا8081,اختيارخ فولاد-12775-1399/08/28,13,255,97973000,99,245,400,301,304.04,384,285,287.88,201,400,1399-8-24
704,وثوق,سرمايه گذاري وثوق امين,13,18886,279814976,15274,14816,14816,-458,-3.0,15267,-7,-0.05,14816,14816,1399-8-24
705,كرونا2,تامين مالي جمعي صرفا اهداي سود,12,469,4690000,10000,10000,10000,0,0.0,10000,0,0.0,10000,10000,1399-8-24
706,افرا,افرانت,12,4062,214432980,55568,52790,52790,-2778,-5.0,55555,-13,-0.02,52790,52790,1399-8-24
707,ضترا1118,اختيارخ شتران-12000-1399/11/14,12,138,216219000,1170,900,1700,530,45.3,1567,397,33.93,900,1980,1399-8-24
708,خنصير,مهندسي‌نصيرماشين‌,12,20125,936215000,48960,46520,46520,-2440,-4.98,48910,-50,-0.1,46520,46520,1399-8-24
709,هبركت912,اختيارف ت بركت-22100-99/12/17,12,13481,95499404,7673,7084,7084,-589,-7.68,7084,-589,-7.68,7084,7084,1399-8-24
710,وپسا,س. پتروشيمي ساختمان  خليج فارس,12,20728,103121800,5128,4975,4975,-153,-2.98,5127,-1,-0.02,4975,4975,1399-8-24
711,نتوس,پشم‌ بافي‌ توس,12,8820,93200940,11123,10567,10567,-556,-5.0,11120,-3,-0.03,10567,10567,1399-8-24
712,ضخود1046,اختيارخ خودرو-5000-1399/10/07,11,390,62260000,148,160,169,21,14.19,160,12,8.11,150,169,1399-8-24
713,ضغدر8039,اختيارخ وغدير-12000-1399/08/26,11,35,371000,3,1,4,1,33.33,11,8,266.67,1,40,1399-8-24
714,ضفار1125,اختيارخ فارس-17826-1399/11/07,11,159,213590000,639,700,734,95,14.87,672,33,5.16,500,770,1399-8-24
715,افران2,صندوق س افرا نماد پايدار-ثابت,11,1100000,1100000,11950,1,1,-11949,-99.99,1,-11949,-99.99,1,1,1399-8-24
716,داريك,صندوق س.اعتماد داريك-د,11,10177,102184175,10026,10096,10000,-26,-0.26,10041,15,0.15,10000,10096,1399-8-24
717,لخانه,لوازم‌ خانگي‌ پارس‌,10,5614,312435942,58582,55653,55653,-2929,-5.0,58534,-48,-0.08,55653,55653,1399-8-24
718,ضملي1152,اختيارخ فملي-18252-1399/11/05,10,105,66529000,591,600,453,-138,-23.35,634,43,7.28,453,700,1399-8-24
719,زعف9908پ17,زعفران9908پوشالمعمول بيرجند(پ),10,1321,101676873,74165,80691,75000,835,1.13,76970,2805,3.78,75000,80691,1399-8-24
720,وسگلستا,شركت س استان گلستان,10,70971,83745780,1240,1180,1180,-60,-4.84,1240,0,0.0,1180,1180,1399-8-24
721,سرو2,صندوق س سروسودمند مدبران-سهام,10,1000000,1000000,54710,1,1,-54709,-100.0,1,-54709,-100.0,1,1,1399-8-24
722,ثنظام,س. ساختماني نظام مهندسي ايران,10,3388,144047596,43831,42517,42517,-1314,-3.0,43821,-10,-0.02,42517,42517,1399-8-24
723,ثاژن,سخت آژند,9,81400,683597200,8569,8398,8398,-171,-2.0,8557,-12,-0.14,8398,8398,1399-8-24
724,اخزا804,اسنادخزانه-م4بودجه98-000421,9,12248,10927156724,892159,892070,892073,-86,-0.01,892158,-1,0.0,892070,893000,1399-8-24
725,تكنو,تكنوتار,9,6651,97104600,15360,14600,14600,-760,-4.95,15360,0,0.0,14600,14600,1399-8-24
726,ضغدر8036,اختيارخ وغدير-9500-1399/08/26,9,38,35602000,267,750,761,494,185.02,937,670,250.94,750,1000,1399-8-24
727,وسمركز,شركت س استان مركزي,9,107828,143411240,1400,1330,1330,-70,-5.0,1400,0,0.0,1330,1330,1399-8-24
728,ضخوز1014,اختيارخ فخوز-12191-1399/10/16,9,12,75499000,5263,6099,6400,1137,21.6,6292,1029,19.55,6099,6400,1399-8-24
729,وسخراش,شركت س استان خراسان شمالي,9,72940,97010200,1390,1330,1330,-60,-4.32,1390,0,0.0,1330,1330,1399-8-24
730,زعف9908پ16,زعفران9908نگين بيرجند(پ),9,18783,1541622250,82342,83000,81050,-1292,-1.57,82075,-267,-0.32,80800,85839,1399-8-24
731,ضگل1141,اختيارخ كگل-14000-1399/11/21,8,127,486239000,2365,3763,3900,1535,64.9,3829,1464,61.9,3763,3900,1399-8-24
732,غشوكو,شوكو پارس,8,3759,165561396,45406,44044,44044,-1362,-3.0,45394,-12,-0.03,44044,44044,1399-8-24
733,ضسپا8007,اختيارخ خساپا-1100-1399/08/26,8,55,55435000,801,850,1200,399,49.81,1008,207,25.84,850,1200,1399-8-24
734,پست0008پ09,پسته بادامي30-28مه ولات0008(پ),8,105,166786957,1580000,1541000,1608000,28000,1.77,1588447,8447,0.53,1540000,1608000,1399-8-24
735,ضپنا1021,اختيارخ رمپنا-16106-1399/10/09,8,303,1252259550,2100,2500,3000,900,42.86,2791,691,32.9,2500,3000,1399-8-24
736,آينده,بازرگاني آينده سازان بهشت پارس,8,7645,168319965,22697,22017,22017,-680,-3.0,22691,-6,-0.03,22017,22017,1399-8-24
737,ضفلا8076,اختيارخ فولاد-8775-1399/08/28,8,190,828950000,2560,4000,3650,1090,42.58,4363,1803,70.43,3650,5500,1399-8-24
738,ضصاد1103,اختيارخ وبصادر-4000-1399/11/12,8,109,26495000,200,250,264,64,32.0,243,43,21.5,230,264,1399-8-24
739,ضغدر8038,اختيارخ وغدير-11000-1399/08/26,8,53,7485000,1,15,198,197,19700.0,141,140,14000.0,15,198,1399-8-24
740,حرهشا,رهشاد سپاهان (سهامي عام,7,7001,413920123,62234,59123,59123,-3111,-5.0,62166,-68,-0.11,59123,59123,1399-8-24
741,پدرخش,درخشان‌ تهران‌,7,265,57176400,227110,215760,215760,-11350,-5.0,227100,-10,0.0,215760,215760,1399-8-24
742,ضفلا8071,اختيارخ فولاد-6275-1399/08/28,7,49,205587000,5000,4739,6000,1000,20.0,4196,-804,-16.08,3725,6000,1399-8-24
743,زعف9908پ11,زعفران9908نگين سحرخيز(پ),7,3000,257550000,84519,85850,85850,1331,1.57,85850,1331,1.57,85850,85850,1399-8-24
744,زعف9908پ09,زعفران9908نگين نوين(پ),7,1276,109544600,84509,85850,85850,1341,1.59,85850,1341,1.59,85850,85850,1399-8-24
745,زعف9908پ08,زعفران9908نگين روستا(پ),7,804,69023400,82548,85850,85850,3302,4.0,85850,3302,4.0,85850,85850,1399-8-24
746,تملي612,تسهيلات مسكن بانك ملي-اسفند96,7,43,41813415,926100,972405,972405,46305,5.0,972405,46305,5.0,972405,972405,1399-8-24
747,ضپنا1020,اختيارخ رمپنا-13406-1399/10/09,7,85,507686800,3248,4100,4380,1132,34.85,4033,785,24.17,3300,4380,1399-8-24
748,ضفلا8087,اختيارخ فولاد-18775-1399/08/28,7,150,390000,2,1,1,-1,-50.0,3,1,50.0,1,9,1399-8-24
749,پست9908-02,پسته فندقي32-30طلاسبززرند9908,7,127,157426160,1180790,1239000,1239829,59039,5.0,1239576,58786,4.98,1239000,1239829,1399-8-24
750,تملي701,تسهيلات مسكن ب. ملي-فروردين97,6,60,83934188,1439841,1480000,1367849,-71992,-5.0,1398903,-40938,-2.84,1367849,1480000,1399-8-24
751,آوا2,صندوق س.سهام آواي معيار-س,6,5000000,5000000,7031,1,1,-7030,-99.99,1,-7030,-99.99,1,1,1399-8-24
752,اخزا704,اسنادخزانه-م4بودجه97-991022,6,851,828941902,972153,976500,972303,150,0.02,974080,1927,0.2,972303,976500,1399-8-24
753,پلاست,كارخانجات توليدي پلاستيران,6,880,36069440,43145,40988,40988,-2157,-5.0,43141,-4,-0.01,40988,40988,1399-8-24
754,ثاباد,توريستي ورفاهي آبادگران ايران,6,2393,73154010,32170,30570,30570,-1600,-4.97,32170,0,0.0,30570,30570,1399-8-24
755,وسيلام,شركت س استان ايلام,6,48350,57053000,1240,1180,1180,-60,-4.84,1240,0,0.0,1180,1180,1399-8-24
756,خفناور,مهندسي صنعتي روان فن آور,6,8548,205416988,24774,24031,24031,-743,-3.0,24766,-8,-0.03,24031,24031,1399-8-24
757,اخزا716,اسنادخزانه-م16بودجه97-000407,6,4962,4456949931,896095,895481,899000,2905,0.32,898216,2121,0.24,895480,900000,1399-8-24
758,ضپنا1022,اختيارخ رمپنا-18806-1399/10/09,6,260,846021250,10,2400,2180,2170,21700.0,2197,2187,21870.0,2180,2200,1399-8-24
759,ضصاد1107,اختيارخ وبصادر-7000-1399/11/12,6,310,25900000,74,90,81,7,9.46,84,10,13.51,80,90,1399-8-24
760,ضفلا8078,اختيارخ فولاد-9775-1399/08/28,6,55,148600000,1250,2700,2840,1590,127.2,2702,1452,116.16,2500,2840,1399-8-24
761,ضفلا1153,اختيارخ فولاد-10000-1399/11/28,6,23,103271000,3594,4332,4500,906,25.21,4490,896,24.93,4332,4500,1399-8-24
762,ضملت8032,اختيارخ وبملت-5789-1399/08/28,5,85,351985,2,1,1,-1,-50.0,1,-1,-50.0,1,1,1399-8-24
763,ضغدر8037,اختيارخ وغدير-10000-1399/08/26,5,35,20590000,400,260,1000,600,150.0,588,188,47.0,200,1000,1399-8-24
764,عفولاد3,اوراق سلف موازي ورق گرم فولاد,5,70,56121100,801481,788218,803982,2501,0.31,801730,249,0.03,788218,803982,1399-8-24
765,ومشان,س. فني و مهندسي مشانير,5,5547,318747261,59240,57463,57463,-1777,-3.0,59211,-29,-0.05,57463,57463,1399-8-24
766,زعف9908پ13,زعفران9908پوشالمعمول روستا(پ),5,300,22065000,74714,73250,73700,-1014,-1.36,73550,-1164,-1.56,73250,73700,1399-8-24
767,ضفلا8083,اختيارخ فولاد-14775-1399/08/28,5,103,5123000,169,50,41,-128,-75.74,50,-119,-70.41,41,50,1399-8-24
768,ضفلا8093,اختيارخ فولاد-29775-1399/08/28,5,22,216000,10,11,6,-4,-40.0,10,0,0.0,5,30,1399-8-24
769,فسديد,لوله‌وتجهيزات‌ سديد - ورشكسته,5,420,46032420,111837,109601,109601,-2236,-2.0,111816,-21,-0.02,109601,109601,1399-8-24
770,ضفلا1151,اختيارخ فولاد-8000-1399/11/28,5,13,79900000,4713,5900,6500,1787,37.92,6146,1433,30.41,5900,6500,1399-8-24
771,اخزا722,اسنادخزانه-م22بودجه97-000428,5,118498,105429933635,888244,890000,888243,-1,0.0,889719,1475,0.17,888243,890000,1399-8-24
772,تملي706,تسهيلات مسكن ب. ملي-شهريور97,5,45,37518615,794045,833747,833747,39702,5.0,833747,39702,5.0,833747,833747,1399-8-24
773,ضغدر1118,اختيارخ وغدير-9000-1399/11/26,5,28,104750000,2291,3500,3700,1409,61.5,3741,1450,63.29,3500,3800,1399-8-24
774,ورازي,بيمه رازي,5,2569,38000648,15249,14792,14792,-457,-3.0,15248,-1,-0.01,14792,14792,1399-8-24
775,ضفلا8091,اختيارخ فولاد-25775-1399/08/28,5,127,127000,1,1,1,0,0.0,1,0,0.0,1,1,1399-8-24
776,ضغدر8035,اختيارخ وغدير-9000-1399/08/26,5,19,27404000,849,1400,1202,353,41.58,1442,593,69.85,1202,1500,1399-8-24
777,صمسكن912,ص دين مسكن جنوب-ماهانه16درصد,5,1050,86975850,82896,82929,82099,-797,-0.96,82834,-62,-0.07,82099,82929,1399-8-24
778,ضمخا7068,اختيارخ اخابر-16000-1400/07/28,4,8,17800000,1800,2000,2300,500,27.78,2225,425,23.61,2000,2400,1399-8-24
779,زعف9908پ14,زعفران9908پوشالمعمول نوين(پ),4,282,21090375,77105,73260,78000,895,1.16,74789,-2316,-3.0,73260,78000,1399-8-24
780,زعف9908پ06,زعفران 9908پوشالمعمول زرين(پ),4,453,33182750,73038,73250,73255,217,0.3,73251,213,0.29,73250,73255,1399-8-24
781,ضفلا8088,اختيارخ فولاد-19775-1399/08/28,4,55,55000,3,1,1,-2,-66.67,1,-2,-66.67,1,1,1399-8-24
782,ضغدر8040,اختيارخ وغدير-13000-1399/08/26,4,11,11000,1,1,1,0,0.0,1,0,0.0,1,1,1399-8-24
783,ضبدر1149,اختيارخ شبندر-28000-1399/11/19,4,5,17898000,1440,3600,3498,2058,142.92,3580,2140,148.61,3498,3600,1399-8-24
784,وسكرشا,س.سهام عدالت استان كرمانشاه,4,21163,26242120,1300,1240,1240,-60,-4.62,1300,0,0.0,1240,1240,1399-8-24
785,زعف9908پ12,زعفران9908پوشالمعمول سحرخيز(پ),4,10117,818302620,81870,73263,80960,-910,-1.11,80884,-986,-1.2,73263,80960,1399-8-24
786,ضچاد1012,اختيارخ كچاد-10000-1399/10/02,4,8,56679000,6400,6427,6552,152,2.38,7085,685,10.7,6427,7300,1399-8-24
787,ضپاس1000,اختيارخ وپارس-2000-1399/10/30,4,4,4640000,901,1056,1300,399,44.28,1160,259,28.75,1056,1300,1399-8-24
788,غبهار,كشت وصنعت بهاران گلبهار خراسان,4,817,29771480,37566,36440,36440,-1126,-3.0,37564,-2,-0.01,36440,36440,1399-8-24
789,صايپا203,صكوك مرابحه سايپا203-3ماهه 16%,4,3317,3281867843,989999,952010,990000,1,0.0,989408,-591,-0.06,952010,990000,1399-8-24
790,ضملت1126,اختيارخ وبملت-4500-1399/11/28,4,20,20590000,653,960,1099,446,68.3,1029,376,57.58,960,1099,1399-8-24
791,شرق1400,مشاركت ليزينگ ايران وشرق140010,4,965,998775000,1035000,1035000,1035000,0,0.0,1035000,0,0.0,1035000,1035000,1399-8-24
792,فبستم,صنايع ‌بسته‌بندي‌ مشهد,4,21100,17217600,793,816,816,23,2.9,793,0,0.0,816,816,1399-8-24
793,ثرود,سرمايه‌گذاري مسكن زاينده رود,4,2216,26483416,12579,11951,11951,-628,-4.99,12579,0,0.0,11951,11951,1399-8-24
794,صگل411,ص اجاره گل گهر 411- 3 ماهه 17%,4,6070,6069445000,1020000,1000001,992000,-28000,-2.75,999909,-20091,-1.97,992000,1000001,1399-8-24
795,زير0003پ01,زيره سبز0003كيميابذر(پ),4,234,111418004,498750,519999,476000,-22750,-4.56,476145,-22605,-4.53,475000,519999,1399-8-24
796,تملي804,تسهيلات مسكن ب. ملي-تير98,3,32,22539712,670825,704366,704366,33541,5.0,704366,33541,5.0,704366,704366,1399-8-24
797,ضگل1149,اختيارخ كگل-10000-1399/11/21,3,4,26291000,5553,6397,7100,1547,27.86,6573,1020,18.37,6397,7100,1399-8-24
798,ضفلا8090,اختيارخ فولاد-23775-1399/08/28,3,85,85000,1,1,1,0,0.0,1,0,0.0,1,1,1399-8-24
799,ضملت8033,اختيارخ وبملت-6272-1399/08/28,3,44,182204,1,1,1,0,0.0,1,0,0.0,1,1,1399-8-24
800,ضچاد1017,اختيارخ كچاد-20000-1399/10/02,3,28,28000000,601,1000,1000,399,66.39,1000,399,66.39,1000,1000,1399-8-24
801,ضچاد1013,اختيارخ كچاد-12000-1399/10/02,3,31,164300000,3500,5300,5300,1800,51.43,5300,1800,51.43,5300,5300,1399-8-24
802,زير0003پ04,زيره سبز0003شركت مينوبذر(پ),3,41,17630020,451250,430000,430000,-21250,-4.71,430000,-21250,-4.71,430000,430001,1399-8-24
803,ضملت8025,اختيارخ وبملت-3616-1399/08/28,3,10,45551000,925,1100,1100,175,18.92,1100,175,18.92,1100,1100,1399-8-24
804,ضفلا8060,اختيارخ فولاد-3507-1399/08/28,3,6,86832000,7441,9000,9000,1559,20.95,9000,1559,20.95,9000,9000,1399-8-24
805,ضسپا1100,اختيارخ خساپا-1600-1399/11/26,3,30,31285000,822,957,1150,328,39.9,1043,221,26.89,957,1150,1399-8-24
806,پست0008پ08,پسته فندقي32-30مه ولات0008(پ),3,81,129637074,1559854,1600000,1637000,77146,4.95,1600458,40604,2.6,1597002,1637000,1399-8-24
807,ضغدر8044,اختيارخ وغدير-17000-1399/08/26,3,200,500000,1,1,4,3,300.0,2,1,100.0,1,4,1399-8-24
808,ضسپا8033,اختيارخ خساپا-6000-1399/08/26,3,75,75000,36,1,1,-35,-97.22,1,-35,-97.22,1,1,1399-8-24
809,ضصاد1106,اختيارخ وبصادر-6000-1399/11/12,3,130,18940000,199,101,159,-40,-20.1,146,-53,-26.63,101,159,1399-8-24
810,بشهاب,لامپ‌  پارس‌ شهاب‌,3,1200,75516000,66240,62930,62930,-3310,-5.0,66230,-10,-0.02,62930,62930,1399-8-24
811,ضخود1047,اختيارخ خودرو-6000-1399/10/07,3,200,21850000,105,106,120,15,14.29,109,4,3.81,105,120,1399-8-24
812,اراد37,مرابحه عام دولت3-ش.خ 0005,3,70000,68542390000,989177,979177,979177,-10000,-1.01,979177,-10000,-1.01,979177,979177,1399-8-24
813,هغدير912,اختيارف ت غدير-17380-99/12/16,3,1378,9101690,6760,6605,6605,-155,-2.29,6605,-155,-2.29,6605,6605,1399-8-24
814,تملي807,تسهيلات مسكن ب. ملي-مهر98,2,24,23999640,952367,999985,999985,47618,5.0,999985,47618,5.0,999985,999985,1399-8-24
815,صگل1411,ص اجاره گل گهر 1411-3 ماهه 17%,2,11,10460060,993333,950010,952000,-41333,-4.16,950915,-42418,-4.27,950010,952000,1399-8-24
816,ضفلا8092,اختيارخ فولاد-27775-1399/08/28,2,2,2000,5,1,1,-4,-80.0,1,-4,-80.0,1,1,1399-8-24
817,ضسپا8015,اختيارخ خساپا-1900-1399/08/26,2,10,5985000,193,599,598,405,209.84,598,405,209.84,598,599,1399-8-24
818,ضملي1154,اختيارخ فملي-24336-1399/11/05,2,76,3890000,200,140,50,-150,-75.0,51,-149,-74.5,50,140,1399-8-24
819,ساذري,آذريت‌,2,271,1618412,5799,5972,5972,173,2.98,5799,0,0.0,5972,5972,1399-8-24
820,ضغدر1120,اختيارخ وغدير-12000-1399/11/26,2,27,51140000,1800,1850,1920,120,6.67,1894,94,5.22,1850,1920,1399-8-24
821,اخزا718,اسنادخزانه-م18بودجه97-000525,2,9038,7924012272,876756,876744,876744,-12,0.0,876744,-12,0.0,876744,876744,1399-8-24
822,وايرا,سرمايه گذاري صنايع ايران,2,1550,13587300,9037,8766,8766,-271,-3.0,9037,0,0.0,8766,8766,1399-8-24
823,ضغدر8046,اختيارخ وغدير-19000-1399/08/26,2,4,4000,6,1,1,-5,-83.33,1,-5,-83.33,1,1,1399-8-24
824,ضپار1116,اختيارخ خپارس-6000-1399/11/19,2,4,8450000,1860,2150,2000,140,7.53,2112,252,13.55,2000,2150,1399-8-24
825,ضبدر1157,اختيارخ شبندر-20000-1399/11/19,2,3,21150000,5344,7050,7050,1706,31.92,7050,1706,31.92,7050,7050,1399-8-24
826,ضملت8027,اختيارخ وبملت-4100-1399/08/28,2,6,13665300,130,600,300,170,130.77,550,420,323.08,300,600,1399-8-24
827,اخزا720,اسنادخزانه-م20بودجه97-000324,2,5949,5363326950,901913,902550,901550,-363,-0.04,901551,-362,-0.04,901550,902550,1399-8-24
828,اوصتا4,صندوق انديشه ورزان صباتامين -د,2,58700000,1000248000000,16981,17040,17040,59,0.35,17040,59,0.35,17040,17040,1399-8-24
829,اخزا723,اسنادخزانه-م23بودجه97-000824,2,388,325088452,850000,837910,837856,-12144,-1.43,837857,-12143,-1.43,837856,837910,1399-8-24
830,ضغدر8027,اختيارخ وغدير-5010-1399/08/26,2,9,50000000,4097,5000,6000,1903,46.45,5556,1459,35.61,5000,6000,1399-8-24
831,ضسان1039,اختيارخ پارسان-20000-99/10/14,2,200,600000000,200,3000,3000,2800,1400.0,3000,2800,1400.0,3000,3000,1399-8-24
832,هاباد912,اختيارف ت آبادا-30100-99/12/12,2,318,3402600,10994,10700,10700,-294,-2.67,10700,-294,-2.67,10700,10700,1399-8-24
833,اشاد10,مشاركت دولتي10-شرايط خاص001226,2,200,188701000,941000,938011,948999,7999,0.85,943505,2505,0.27,938011,948999,1399-8-24
834,ضصاد1104,اختيارخ وبصادر-4500-1399/11/12,2,102,18460000,151,180,230,79,52.32,181,30,19.87,180,230,1399-8-24
835,ضپار1117,اختيارخ خپارس-7000-1399/11/19,2,20,31300000,1654,1550,1580,-74,-4.47,1565,-89,-5.38,1550,1580,1399-8-24
836,اراد33,مرابحه عام دولت3-ش.خ 0303,1,5000,4450000000,931500,890000,890000,-41500,-4.46,890000,-41500,-4.46,890000,890000,1399-8-24
837,ضگل1143,اختيارخ كگل-18000-1399/11/21,1,100,200000000,2400,2000,2000,-400,-16.67,2000,-400,-16.67,2000,2000,1399-8-24
838,ضغدر8049,اختيارخ وغدير-24000-1399/08/26,1,1,400000,1,400,400,399,39900.0,400,399,39900.0,400,400,1399-8-24
839,ارزش2,صندوق س ارزش آفرين بيدار-سهام,1,3500000,3500000,9250,1,1,-9249,-99.99,1,-9249,-99.99,1,1,1399-8-24
840,ضترا1117,اختيارخ شتران-10000-1399/11/14,1,1,2300000,1684,2300,2300,616,36.58,2300,616,36.58,2300,2300,1399-8-24
841,ضسپا1103,اختيارخ خساپا-2500-1399/11/26,1,3,1797000,350,599,599,249,71.14,599,249,71.14,599,599,1399-8-24
842,صينا205,صكوك منفعت سينا دارو-3ماهه 19%,1,53,52206060,985020,985020,985020,0,0.0,985020,0,0.0,985020,985020,1399-8-24
843,سيتا2,سرمايه گذاري سيمان تامين,1,15000000,254550000000,17230,16970,16970,-260,-1.51,16970,-260,-1.51,16970,16970,1399-8-24
844,ضفلا1152,اختيارخ فولاد-9000-1399/11/28,1,1,5332000,4486,5332,5332,846,18.86,5332,846,18.86,5332,5332,1399-8-24
845,اخزا7184,اسنادخزانه-م18بودجه97-000525,1,1249613,1095605695428,876756,876756,876756,0,0.0,876756,0,0.0,876756,876756,1399-8-24
846,ضفلا8086,اختيارخ فولاد-17775-1399/08/28,1,2,4000,2,2,2,0,0.0,2,0,0.0,2,2,1399-8-24
847,اخزا7232,اسنادخزانه-م23بودجه97-000824,1,738415,620268600000,850000,840000,840000,-10000,-1.18,840000,-10000,-1.18,840000,840000,1399-8-24
848,اخزا805,اسنادخزانه-م5بودجه98-000422,1,200,178424800,892131,892124,892124,-7,0.0,892124,-7,0.0,892124,892124,1399-8-24
849,اخزا7214,اسنادخزانه-م21بودجه97-000728,1,1582628,1354482678032,855844,855844,855844,0,0.0,855844,0,0.0,855844,855844,1399-8-24
850,ضملت1127,اختيارخ وبملت-5000-1399/11/28,1,2,1800000,649,900,900,251,38.67,900,251,38.67,900,900,1399-8-24
851,صخود00122,ص مرابحه خودرو0012- 3ماهه 18%,1,159400,159400000000,1020000,1000000,1000000,-20000,-1.96,1000000,-20000,-1.96,1000000,1000000,1399-8-24
852,اخزا8212,اسنادخزانه-م21بودجه98-020906,1,123118,70054142000,569904,569000,569000,-904,-0.16,569000,-904,-0.16,569000,569000,1399-8-24
853,زنگان2,صنعت روي زنگان,1,134000,20478684000,160869,152826,152826,-8043,-5.0,152826,-8043,-5.0,152826,152826,1399-8-24
854,مشير1122,مشاركت شهرداري شيراز-3ماهه18%,1,359000,351820359000,970000,980001,980001,10001,1.03,980001,10001,1.03,980001,980001,1399-8-24
855,ولپارس2,ليزينگ پارسيان,1,80000000,408800000000,4870,5110,5110,240,4.93,5110,240,4.93,5110,5110,1399-8-24
856,صخابر102,صكوك اجاره مخابرات-3 ماهه 16%,1,3000,2880000000,950000,960000,960000,10000,1.05,960000,10000,1.05,960000,960000,1399-8-24
857,ضپار1115,اختيارخ خپارس-5000-1399/11/19,1,1,3000000,2700,3000,3000,300,11.11,3000,300,11.11,3000,3000,1399-8-24
858,سنفت001,سلف موازي استاندارد سنفت001,1,56500,60021984000,1059909,1062336,1062336,2427,0.23,1062336,2427,0.23,1062336,1062336,1399-8-24
859,ضفلا8068,اختيارخ فولاد-4751-1399/08/28,1,1,12140400,6500,7550,7550,1050,16.15,7550,1050,16.15,7550,7550,1399-8-24
860,اخزا7224,اسنادخزانه-م22بودجه97-000428,1,919013,816307783172,888244,888244,888244,0,0.0,888244,0,0.0,888244,888244,1399-8-24
861,ضغدر8048,اختيارخ وغدير-22000-1399/08/26,1,1,1000,1,1,1,0,0.0,1,0,0.0,1,1,1399-8-24
862,اراد22,مرابحه عام دولت2-ش.خ لوتوس0212,1,3000,2640000000,865000,880000,880000,15000,1.73,880000,15000,1.73,880000,880000,1399-8-24
863,گواهي ظرفيت,گواهي ظرفيت نقدي,1,1200000,12766800000,10639,10639,10639,0,0.0,10639,0,0.0,10639,10639,1399-8-24
864,خشرق2,الكتريك‌ خودرو شرق‌,1,8000000,152400000000,19750,19050,19050,-700,-3.54,19050,-700,-3.54,19050,19050,1399-8-24
865,ضپاس1004,اختيارخ وپارس-4000-1399/10/30,1,7,1960000,100,280,280,180,180.0,280,180,180.0,280,280,1399-8-24
866,ضسپا8020,اختيارخ خساپا-2800-1399/08/26,1,18,36000,5,2,2,-3,-60.0,2,-3,-60.0,2,2,1399-8-24
867,حكشتي2,كشتيراني جمهوري اسلامي ايران,1,2000000,50540000000,24070,25270,25270,1200,4.99,25270,1200,4.99,25270,25270,1399-8-24
868,دمعيار2,صندوق س. توازن معيار-د,1,100000,100000,10028,1,1,-10027,-99.99,1,-10027,-99.99,1,1,1399-8-24
869,خمهر2,مهركام‌پارس‌,1,18000000,123840000000,7060,6880,6880,-180,-2.55,6880,-180,-2.55,6880,6880,1399-8-24
870,شستا003,اجاره تامين اجتماعي-سپهر000523,1,42,41580000,990001,990000,990000,-1,0.0,990000,-1,0.0,990000,990000,1399-8-24
871,طمخا7066,اختيارف اخابر-12000-1400/07/28,1,4,1200000,1000,300,300,-700,-70.0,300,-700,-70.0,300,300,1399-8-24
872,ضمخا1023,اختيارخ اخابر-12000-1399/10/30,1,40,100000000,1695,2500,2500,805,47.49,2500,805,47.49,2500,2500,1399-8-24
873,تملي803,تسهيلات مسكن ب. ملي-خرداد98,1,36,15034788,397746,417633,417633,19887,5.0,417633,19887,5.0,417633,417633,1399-8-24
874,ضغدر8021,اختيارخ وغدير-3510-1399/08/26,1,5,37500000,6114,7500,7500,1386,22.67,7500,1386,22.67,7500,7500,1399-8-24
875,تابان02,اجاره تابان لوتوس14021206,1,3000,2880000000,945000,960000,960000,15000,1.59,960000,15000,1.59,960000,960000,1399-8-24
876,صايپا908,صكوك مرابحه سايپا908-3ماهه 18%,1,3000,3000000000,989285,1000000,1000000,10715,1.08,1000000,10715,1.08,1000000,1000000,1399-8-24
877,ضغدر8013,اختيارخ وغدير-1910-1399/08/26,1,5,45000000,7005,9000,9000,1995,28.48,9000,1995,28.48,9000,9000,1399-8-24
878,ضفلا8084,اختيارخ فولاد-15775-1399/08/28,1,18,18000,4,1,1,-3,-75.0,1,-3,-75.0,1,1,1399-8-24
879,ضفلا8075,اختيارخ فولاد-8275-1399/08/28,1,1,3000000,2430,3000,3000,570,23.46,3000,570,23.46,3000,3000,1399-8-24
880,كمند2,صندوق س. با درآمد ثابت كمند,1,50000000,50000000,10078,1,1,-10077,-99.99,1,-10077,-99.99,1,1,1399-8-24
881,ضملت8031,اختيارخ وبملت-5306-1399/08/28,1,25,103525,1,1,1,0,0.0,1,0,0.0,1,1,1399-8-24
882,صايپا998,صكوك مرابحه سايپا998-3ماهه 18%,1,6,5969700,994950,994950,994950,0,0.0,994950,0,0.0,994950,994950,1399-8-24
883,اراد324,مرابحه عام دولت3-ش.خ0211,1,1000000,885730000000,1000000,885730,885730,-114270,-11.43,885730,-114270,-11.43,885730,885730,1399-8-24
884,كرمان00,رهني كرمان موتور14001130,1,1000,1022307000,997307,1022307,1022307,25000,2.51,1022307,25000,2.51,1022307,1022307,1399-8-24
885,وبملت2,بانك ملت,1,100000000,452000000000,4310,4520,4520,210,4.87,4520,210,4.87,4520,4520,1399-8-24
886,ضمخا7069,اختيارخ اخابر-18000-1400/07/28,1,3,4500000,3000,1500,1500,-1500,-50.0,1500,-1500,-50.0,1500,1500,1399-8-24
887,ضپنا1023,اختيارخ رمپنا-21506-1399/10/09,1,20,29620000,3500,1000,1000,-2500,-71.43,1000,-2500,-71.43,1000,1000,1399-8-24
888,ضگل1150,اختيارخ كگل-12000-1399/11/21,1,1,5500000,4053,5500,5500,1447,35.7,5500,1447,35.7,5500,5500,1399-8-24
889,شسم,توليد سموم‌ علف‌ كش,1,136,11440184,82470,84119,84119,1649,2.0,82472,2,0.0,84119,84119,1399-8-24
890,مبين014,اجاره اعتماد مبين لوتوس011019,1,3000,2850000000,939798,950000,950000,10202,1.09,950000,10202,1.09,950000,950000,1399-8-24
891,تملي707,تسهيلات مسكن ب. ملي-مهر97,1,5,5636000,1186526,1127200,1127200,-59326,-5.0,1127200,-59326,-5.0,1127200,1127200,1399-8-24
892,ضپار1118,اختيارخ خپارس-8000-1399/11/19,1,50,55000000,3300,1100,1100,-2200,-66.67,1100,-2200,-66.67,1100,1100,1399-8-24
893,شخارك2,پتروشيمي‌ خارك‌,1,7790000,304822700000,37270,39130,39130,1860,4.99,39130,1860,4.99,39130,39130,1399-8-24
894,جم پيلن2,پلي پروپيلن جم - جم پيلن,1,1100000,87835000000,76050,79850,79850,3800,5.0,79850,3800,5.0,79850,79850,1399-8-24
895,وغدير2,سرمايه‌گذاري‌غدير(هلدينگ‌,1,30000000,307500000000,9770,10250,10250,480,4.91,10250,480,4.91,10250,10250,1399-8-24
896,خمحركه2,نيرو محركه‌,1,20000000,126600000000,6030,6330,6330,300,4.98,6330,300,4.98,6330,6330,1399-8-24
897,ضسپا8011,اختيارخ خساپا-1500-1399/08/26,1,1,1000000,614,1000,1000,386,62.87,1000,386,62.87,1000,1000,1399-8-24
898,مبين2,مبين انرژي خليج فارس,1,7500000,148875000000,18910,19850,19850,940,4.97,19850,940,4.97,19850,19850,1399-8-24
899,اراد47,مرابحه عام دولت4-ش.خ 0008,1,10000,9800000000,960000,980000,980000,20000,2.08,980000,20000,2.08,980000,980000,1399-8-24
900,ضفلا8089,اختيارخ فولاد-21775-1399/08/28,1,11,11000,1,1,1,0,0.0,1,0,0.0,1,1,1399-8-24
901,اراد314,مرابحه عام دولت3-ش.خ 0208,1,2500000,2230275000000,1000000,892110,892110,-107890,-10.79,892110,-107890,-10.79,892110,892110,1399-8-24
902,ضملت1124,اختيارخ وبملت-3500-1399/11/28,1,1,1899000,1495,1899,1899,404,27.02,1899,404,27.02,1899,1899,1399-8-24
903,صايپا012,صكوك مرابحه سايپا012-3ماهه 16%,1,10,10000010,1050000,1000001,1000001,-49999,-4.76,1000001,-49999,-4.76,1000001,1000001,1399-8-24
904,كگل2,معدني و صنعتي گل گهر,1,4000000,61760000000,14710,15440,15440,730,4.96,15440,730,4.96,15440,15440,1399-8-24
905,فن آوا,گروه فن آوا,1,384,5419392,14549,14113,14113,-436,-3.0,14549,0,0.0,14113,14113,1399-8-24
906,اخزا713,اسنادخزانه-م13بودجه97-000518,1,1135,998800000,879942,880000,880000,58,0.01,880000,58,0.01,880000,880000,1399-8-24
