,نماد,نام,تعداد,حجم,ارزش,دیروز,اولین,آخرین معامله - مقدار,آخرین معامله - تغییر,آخرین معامله - درصد,قیمت پایانی - مقدار,قیمت پایانی - تغییر,قیمت پایانی - درصد,کمترین,بیشترین,تاریخ
0,دارا يكم,صندوق واسطه گري مالي يكم-سهام,84458,65613636,9292095973070,130490,143530,143280,12790,9.8,141620,11130,8.53,132000,143530,1399-11-5
1,شستا,سرمايه گذاري تامين اجتماعي,70932,330596592,7243235184030,21240,22300,22300,1060,4.99,21910,670,3.15,20810,22300,1399-11-5
2,پالايش,صندوق پالايشي يکم-سهام,55948,65808764,4893865930090,67710,74480,74480,6770,10.0,74360,6650,9.82,70150,74480,1399-11-5
3,خودرو,ايران‌ خودرو,51472,1469759589,4017601221660,2680,2810,2630,-50,-1.87,2730,50,1.87,2570,2810,1399-11-5
4,خساپا,سايپا,47318,1936460065,4277317524100,2150,2250,2150,0,0.0,2210,60,2.79,2080,2250,1399-11-5
5,چخزر,صنايع چوب خزر كاسپين,45790,13152197,719418005887,52449,55071,55071,2622,5.0,54699,2250,4.29,49827,55071,1399-11-5
6,شپنا,پالايش نفت اصفهان,41498,614411293,6471782565180,10040,10540,10540,500,4.98,10530,490,4.88,10300,10540,1399-11-5
7,فملي,ملي‌ صنايع‌ مس‌ ايران‌,38266,238362384,2663431537820,10890,11430,11430,540,4.96,11170,280,2.57,10570,11430,1399-11-5
8,وتجارت,بانك تجارت,36985,1283634734,3506240971310,2620,2750,2710,90,3.44,2730,110,4.2,2620,2750,1399-11-5
9,فولاد,فولاد مباركه اصفهان,34078,248088725,2881755388860,11210,11770,11440,230,2.05,11620,410,3.66,11160,11770,1399-11-5
10,شتران,پالايش نفت تهران,34016,378679438,3273849332860,8270,8680,8680,410,4.96,8650,380,4.59,8250,8680,1399-11-5
11,بركت,گروه دارويي بركت,33132,126849239,2599547026930,20490,21510,19500,-990,-4.83,20490,0,0.0,19470,21510,1399-11-5
12,سپيدار,سپيدار سيستم آسيا,32993,2214435,111124777170,47793,50182,50182,2389,5.0,50182,2389,5.0,50182,50182,1399-11-5
13,خگستر,گسترش‌سرمايه‌گذاري‌ايران‌خودرو,31680,802126638,2518960084490,3170,3320,3020,-150,-4.73,3140,-30,-0.95,3020,3320,1399-11-5
14,وسپهر,سرمايه گذاري مالي سپهرصادرات,31521,119127674,1242208682341,10758,10764,10222,-536,-4.98,10428,-330,-3.07,10221,10850,1399-11-5
15,وكبهمن,مديريت سرمايه گذاري كوثربهمن,29216,20930905,355576173905,17460,17450,16587,-873,-5.0,16988,-472,-2.7,16587,17830,1399-11-5
16,ثبهساز,بهساز كاشانه تهران,28265,420701682,1353511184060,3280,3370,3130,-150,-4.57,3220,-60,-1.83,3120,3420,1399-11-5
17,گشان,توسعه بين المللي پديده شانديز,27811,37730063,1857859776202,49687,48010,49499,-188,-0.38,49241,-446,-0.9,47700,51673,1399-11-5
18,ذوب,سهامي ذوب آهن  اصفهان,26846,384086986,1958810867775,5275,5389,5012,-263,-4.99,5100,-175,-3.32,5012,5440,1399-11-5
19,وخارزم,سرمايه گذاري خوارزمي,26208,249415028,2421196886140,9770,10250,9290,-480,-4.91,9710,-60,-0.61,9290,10250,1399-11-5
20,سيتا,سرمايه گذاري سيمان تامين,25454,77094877,1256445152000,16090,16890,15630,-460,-2.86,16300,210,1.31,15300,16890,1399-11-5
21,بوعلي,پتروشيمي بوعلي سينا,22757,15086105,708413471870,48620,49300,46190,-2430,-5.0,46960,-1660,-3.41,46190,49300,1399-11-5
22,وبصادر,بانك صادرات ايران,21487,755065228,1996538294710,2550,2670,2590,40,1.57,2640,90,3.53,2490,2670,1399-11-5
23,شبندر,پالايش نفت بندرعباس,20391,131749501,2866932307430,20820,21860,21860,1040,5.0,21760,940,4.51,20840,21860,1399-11-5
24,آوا,صندوق س.سهام آواي معيار-س,18415,167208071,1388253152553,8471,8880,7710,-761,-8.98,8303,-168,-1.98,7500,9500,1399-11-5
25,وبملت,بانك ملت,18006,469774226,1916909612300,3950,4140,3990,40,1.01,4080,130,3.29,3860,4140,1399-11-5
26,غزر,صنعتي زر ماكارون,17644,12288987,316067219360,25910,27000,25680,-230,-0.89,25720,-190,-0.73,24620,27200,1399-11-5
27,زملارد,كشاورزي و دامپروري ملارد شير,17430,9335770,370174745425,39036,40987,38000,-1036,-2.65,39651,615,1.58,37085,40987,1399-11-5
28,ثاميد,توسعه و عمران اميد,17314,202864738,411456438850,2090,2140,1990,-100,-4.78,2030,-60,-2.87,1990,2140,1399-11-5
29,بپيوند,برق و انرژي پيوندگستر پارس,16133,24378695,436936691886,18020,18921,17130,-890,-4.94,17923,-97,-0.54,17119,18921,1399-11-5
30,امين,تامين سرمايه امين,16041,26399144,277463451890,10900,11260,10410,-490,-4.5,10510,-390,-3.58,10360,11260,1399-11-5
31,پترول,گروه پتروشيمي س. ايرانيان,15662,106352223,1086358755660,10040,10540,9930,-110,-1.1,10210,170,1.69,9640,10540,1399-11-5
32,خزر,فنرسازي‌زر,15370,25623359,1050618639290,40550,41200,40000,-550,-1.36,41000,450,1.11,38530,42570,1399-11-5
33,وپارس,بانك‌پارسيان‌,15030,606580128,1837059173990,2920,3060,3020,100,3.42,3030,110,3.77,2850,3060,1399-11-5
34,كاما,باما,14920,64157427,1210550290690,19480,19480,18510,-970,-4.98,18870,-610,-3.13,18510,20110,1399-11-5
35,حكشتي,كشتيراني جمهوري اسلامي ايران,14525,66701157,1370808741370,20690,21720,19680,-1010,-4.88,20550,-140,-0.68,19660,21720,1399-11-5
36,شگويا,پتروشيمي تندگويان,13804,79619304,758773261611,9516,9991,9160,-356,-3.74,9530,14,0.15,9041,9991,1399-11-5
37,آريا,پليمر آريا ساسول,13731,6082267,537832480092,87626,92007,86200,-1426,-1.63,88426,800,0.91,83245,92007,1399-11-5
38,فارس,صنايع پتروشيمي خليج فارس,13229,79033684,780038067500,9380,10000,9670,290,3.09,9870,490,5.22,9500,10300,1399-11-5
39,بترانس,ايران‌ ترانسفو,13011,251219338,882509975650,3550,3720,3380,-170,-4.79,3510,-40,-1.13,3380,3720,1399-11-5
40,دانا,بيمه دانا,12973,159940377,1318888427720,8240,8650,7840,-400,-4.85,8250,10,0.12,7830,8650,1399-11-5
41,وهنر,گروه توسعه هنر ايران,12566,147972143,1088407358674,7030,7381,7381,351,4.99,7355,325,4.62,6729,7381,1399-11-5
42,كرمان,س. توسعه و عمران استان كرمان,12540,19727717,1403737904771,73692,72100,70008,-3684,-5.0,71156,-2536,-3.44,70008,75160,1399-11-5
43,بگيلان,توسعه مسير برق گيلان,12209,10105706,231756505664,22811,23900,21970,-841,-3.69,22933,122,0.53,21671,23951,1399-11-5
44,شاروم,پتروشيمي اروميه,11699,16778080,381133846571,23446,23289,22274,-1172,-5.0,22716,-730,-3.11,22274,24028,1399-11-5
45,انرژي3,سايراشخاص بورس انرژي,11574,2775238,1065696773410,384890,404130,368000,-16890,-4.39,384000,-890,-0.23,365650,404130,1399-11-5
46,ثشاهد,سرمايه‌ گذاري‌ شاهد,10827,46783901,897247783000,19450,20420,18610,-840,-4.32,19180,-270,-1.39,18480,20420,1399-11-5
47,خزاميا,زامياد,10605,101965598,898811218680,8820,9260,8420,-400,-4.54,8810,-10,-0.11,8380,9260,1399-11-5
48,خبهمن,گروه‌بهمن‌,10231,48781921,1180379595210,24560,24560,23340,-1220,-4.97,24200,-360,-1.47,23340,25700,1399-11-5
49,وغدير,سرمايه‌گذاري‌غدير(هلدينگ‌,9855,108697287,1198862875460,10620,11150,10870,250,2.35,11030,410,3.86,10410,11150,1399-11-5
50,فخوز,فولاد  خوزستان,9544,62763278,860051587140,13820,14510,13260,-560,-4.05,13700,-120,-0.87,13130,14510,1399-11-5
51,فروي,ذوب روي اصفهان,9508,9995187,701576765963,68787,72226,68000,-787,-1.14,70191,1404,2.04,66000,72226,1399-11-5
52,آگاس,صندوق س.هستي بخش آگاه-س,9435,14836123,1012431385168,71056,72800,65210,-5846,-8.23,68241,-2815,-3.96,64500,73000,1399-11-5
53,غنوش,نوش‌ مازندران‌,9358,15141099,958169969250,63600,65000,60900,-2700,-4.25,63280,-320,-0.5,60420,66780,1399-11-5
54,خپارس,پارس‌ خودرو,9253,127146725,767873738840,6120,6420,5820,-300,-4.9,6040,-80,-1.31,5820,6420,1399-11-5
55,سمگا,گروه سرمايه گذاري ميراث فرهنگي,9224,56385490,1765634190656,29961,31380,31166,1205,4.02,31314,1353,4.52,30020,31459,1399-11-5
56,سرو,صندوق س سروسودمند مدبران-سهام,9088,12267338,840274221660,69780,73400,66180,-3600,-5.16,68500,-1280,-1.83,63800,73490,1399-11-5
57,مدير,ص.س.مديريت ثروت ص.بازنشستگي-س,9016,60440466,618686729685,10265,11280,9740,-525,-5.11,10236,-29,-0.28,9444,11280,1399-11-5
58,غگل,گلوكوزان‌,8926,106141677,453363048220,4410,4500,4190,-220,-4.99,4270,-140,-3.17,4190,4590,1399-11-5
59,وآذر,سرمايه‌گذاري‌توسعه‌آذربايجان‌,8646,10658016,1125680099550,109120,103670,106680,-2440,-2.24,105620,-3500,-3.21,103670,113000,1399-11-5
60,نوري,پتروشيمي نوري,8637,11442029,685612592750,60130,63130,57620,-2510,-4.17,59920,-210,-0.35,57130,63130,1399-11-5
61,حفارس,حمل و نقل بين المللي خليج فارس,8068,124957219,665038645720,5200,5460,5180,-20,-0.38,5320,120,2.31,4940,5460,1399-11-5
62,رافزا,رايان هم افزا,7941,46284,1958044620,40291,42305,42305,2014,5.0,40366,75,0.19,42305,42305,1399-11-5
63,وپست,پست بانك ايران,7883,41533888,902346043610,21660,22610,20580,-1080,-4.99,21730,70,0.32,20580,22740,1399-11-5
64,صبا,سرمايه گذاري صبا تامين,7812,49594579,375378918576,7473,7846,7266,-207,-2.77,7569,96,1.28,7112,7846,1399-11-5
65,چكاپا,گروه صنايع كاغذ پارس,7594,109398102,717592093300,6620,6950,6290,-330,-4.98,6560,-60,-0.91,6290,6950,1399-11-5
66,پيزد,مجتمع صنايع لاستيك يزد,7510,1830078,134887901192,75837,75200,72046,-3791,-5.0,73706,-2131,-2.81,72046,77500,1399-11-5
67,آسيا,بيمه آسيا,7325,126377694,394885683040,3200,3210,3040,-160,-5.0,3120,-80,-2.5,3040,3320,1399-11-5
68,وپويا,سرمايه گذاري پويا,7212,25817021,157575119246,6242,6500,5930,-312,-5.0,6104,-138,-2.21,5930,6500,1399-11-5
69,وساپا,سرمايه‌گذاري‌ سايپا,7180,78983944,551398333910,7120,7470,6770,-350,-4.92,6980,-140,-1.97,6770,7470,1399-11-5
70,تاپيكو,س. نفت و گاز و پتروشيمي تأمين,6958,58496038,689309701300,11630,12210,11340,-290,-2.49,11780,150,1.29,11050,12210,1399-11-5
71,بالاس,مهندسي ساختمان تاسيسات راه آهن,6932,12568586,841170376632,67038,70389,63687,-3351,-5.0,66926,-112,-0.17,63687,70389,1399-11-5
72,كمند,صندوق س. با درآمد ثابت كمند,6921,321609338,3251686362665,10106,10110,10111,5,0.05,10111,5,0.05,10100,10115,1399-11-5
73,كاذر,فرآورده‌هاي‌نسوزآذر,6904,27318901,989842729890,34760,36490,36490,1730,4.98,36230,1470,4.23,34000,36490,1399-11-5
74,كبافق,معادن‌ بافق‌,6726,9920787,533840336950,51980,54570,53300,1320,2.54,53810,1830,3.52,50010,54570,1399-11-5
75,حفاري,حفاري شمال,6688,59971161,673291996390,10840,11380,11170,330,3.04,11230,390,3.6,10400,11380,1399-11-5
76,آبادا,توليد نيروي برق آبادان,6678,7090836,116763775460,15720,16500,16500,780,4.96,16470,750,4.77,16100,16500,1399-11-5
77,خمحركه,نيرو محركه‌,6503,68499981,375350718030,5500,5770,5240,-260,-4.73,5480,-20,-0.36,5230,5770,1399-11-5
78,لپارس,پارس‌ الكتريك‌,6319,3749498,402342444420,106750,112080,102990,-3760,-3.52,107310,560,0.52,101420,112080,1399-11-5
79,كماسه,تامين‌ ماسه‌ ريخته‌گري‌,6317,8671175,443318032520,49710,50000,49510,-200,-0.4,51130,1420,2.86,48010,52190,1399-11-5
80,تملت,تامين سرمايه بانك ملت,6245,42482044,292435098330,6930,7270,6620,-310,-4.47,6880,-50,-0.72,6590,7270,1399-11-5
81,بجهرم,توسعه مولد نيروگاهي جهرم,6236,85621752,281108493533,3346,3513,3180,-166,-4.96,3283,-63,-1.88,3179,3513,1399-11-5
82,ونيكي,سرمايه‌گذاري‌ ملي‌ايران‌,6217,33749811,459860284630,13690,14370,13090,-600,-4.38,13630,-60,-0.44,13010,14370,1399-11-5
83,ومعادن,توسعه‌معادن‌وفلزات‌,6198,74889162,838908174690,10710,11240,11240,530,4.95,11200,490,4.58,10800,11240,1399-11-5
84,ونوين,بانك‌اقتصادنوين‌,6067,186284552,821638288590,4250,4460,4350,100,2.35,4410,160,3.76,4130,4460,1399-11-5
85,خنصير,مهندسي‌نصيرماشين‌,6004,9098218,813112110470,93450,88780,88780,-4670,-5.0,89370,-4080,-4.37,88780,93420,1399-11-5
86,غبهار,كشت وصنعت بهاران گلبهار خراسان,5984,9529720,424749706046,42741,43300,44700,1959,4.58,44571,1830,4.28,42741,44878,1399-11-5
87,قثابت,قند ثابت‌ خراسان‌,5970,7116501,407642297240,58130,58130,57940,-190,-0.33,57280,-850,-1.46,55230,60820,1399-11-5
88,فرابورس,فرابورس ايران,5921,13809859,590614599462,42933,45079,40820,-2113,-4.92,42768,-165,-0.38,40787,45079,1399-11-5
89,تليسه,دامداري تليسه نمونه,5827,54526120,264680164225,4871,5114,4628,-243,-4.99,4854,-17,-0.35,4628,5114,1399-11-5
90,كساوه,صنايع‌ كاشي‌ و سراميك‌ سينا,5819,11506124,878052600620,75510,79280,73400,-2110,-2.79,76310,800,1.06,71740,79280,1399-11-5
91,زمگسا,كشاورزي‌ ودامپروي‌ مگسال‌,5813,10943476,385370046130,36250,34440,34440,-1810,-4.99,35210,-1040,-2.87,34440,37050,1399-11-5
92,وپاسار,بانك  پاسارگاد,5792,55553493,688612129870,12200,12810,12210,10,0.08,12400,200,1.64,11700,12810,1399-11-5
93,هاي وب,داده گسترعصرنوين-هاي وب,5627,22370876,593094296510,27550,28300,26180,-1370,-4.97,26510,-1040,-3.77,26180,28300,1399-11-5
94,ارزش,صندوق س ارزش آفرين بيدار-سهام,5623,41096117,417537297610,10340,10980,9740,-600,-5.8,10160,-180,-1.74,9400,11100,1399-11-5
95,ختوقا,قطعات‌ اتومبيل‌ ايران‌,5532,95455464,278633994620,2930,3070,2830,-100,-3.41,2920,-10,-0.34,2790,3070,1399-11-5
96,زنگان,صنعت روي زنگان,5530,3752924,405507452019,108802,103375,107000,-1802,-1.66,108051,-751,-0.69,103362,114200,1399-11-5
97,فوكا,فولاد كاويان,5466,49531344,620717146374,12806,12500,12600,-206,-1.61,12532,-274,-2.14,12422,12950,1399-11-5
98,كچاد,معدني‌وصنعتي‌چادرملو,5448,29268577,593220492310,19850,20840,19500,-350,-1.76,20270,420,2.12,19010,20840,1399-11-5
99,زماهان,مجتمع توليد گوشت مرغ ماهان,5446,8592802,340904388225,39387,39900,41356,1969,5.0,39673,286,0.73,37418,41356,1399-11-5
100,وملي,گروه‌ صنعتي‌ ملي‌ (هلدينگ‌,5427,2668833,576950132040,218460,229380,207540,-10920,-5.0,216180,-2280,-1.04,207540,229380,1399-11-5
101,كالا,بورس كالاي ايران,5399,12455669,518673248080,41870,43960,39780,-2090,-4.99,41640,-230,-0.55,39780,43960,1399-11-5
102,زدشت,كشت و صنعت دشت خرم دره,5345,8779873,301429457317,34129,35835,33060,-1069,-3.13,34332,203,0.59,32423,35835,1399-11-5
103,خرينگ,رينگ‌سازي‌مشهد,5279,9554502,563325356680,61570,58500,58500,-3070,-4.99,58960,-2610,-4.24,58500,61300,1399-11-5
104,بكام,كارخانجات توليدي شهيد قندي,5272,65967484,253901596030,3960,4090,3770,-190,-4.8,3850,-110,-2.78,3770,4110,1399-11-5
105,غسالم,سالمين‌,5256,53453664,249546435080,4690,4920,4510,-180,-3.84,4670,-20,-0.43,4460,4920,1399-11-5
106,لكما,كارخانجات‌مخابراتي‌ايران‌,5243,53137231,423794303230,8331,7915,7915,-416,-4.99,7975,-356,-4.27,7915,8187,1399-11-5
107,ولانا,شركت ليزينگ آريا دانا,5076,14365842,419234254933,28730,29591,28338,-392,-1.36,29183,453,1.58,27869,29591,1399-11-5
108,گكوثر,هتل پارسيان كوثر اصفهان,5020,83536597,280851102867,3472,3600,3299,-173,-4.98,3362,-110,-3.17,3299,3600,1399-11-5
109,شسينا,صنايع‌شيميايي‌سينا,4988,2135284,379883144590,177220,186000,174480,-2740,-1.55,177910,690,0.39,168360,186000,1399-11-5
110,خكمك,كمك‌فنرايندامين‌,4919,13020558,458028863210,34790,34710,33760,-1030,-2.96,35180,390,1.12,33060,36520,1399-11-5
111,غبهنوش,بهنوش‌ ايران‌,4916,5505899,463903491470,80640,81810,84670,4030,5.0,84260,3620,4.49,81500,84670,1399-11-5
112,وآوا,سرمايه گذاري آوا نوين,4909,33242492,296842409695,9321,8920,8855,-466,-5.0,8930,-391,-4.19,8855,9300,1399-11-5
113,فاراك,ماشين‌ سازي‌ اراك‌,4805,56726999,355771301610,6490,6780,6170,-320,-4.93,6270,-220,-3.39,6170,6790,1399-11-5
114,شيران,س. صنايع‌شيميايي‌ايران,4787,11871125,433225597690,36430,38000,36990,560,1.54,36490,60,0.16,35000,38200,1399-11-5
115,ونيرو,سرمايه‌گذاري‌نيرو,4760,82998992,259665296270,3200,3360,3040,-160,-5.0,3130,-70,-2.19,3040,3360,1399-11-5
116,چدن,توليدي چدن سازان,4746,13713014,429509121190,31450,33020,30050,-1400,-4.45,31320,-130,-0.41,29880,33020,1399-11-5
117,كاوه,فولاد كاوه جنوب كيش,4628,43460626,809107979320,17830,18720,18380,550,3.08,18620,790,4.43,17840,18720,1399-11-5
118,امين يكم,صندوق درآمد ثابت امين يكم فردا,4547,180112793,1823895466453,10121,10128,10127,6,0.06,10126,5,0.05,10121,10131,1399-11-5
119,بالبر,كابل‌ البرز,4545,12267728,511405881080,40900,42940,41380,480,1.17,41690,790,1.93,38860,42940,1399-11-5
120,كوثر,بيمه كوثر,4462,23411755,454451258863,19818,20000,18828,-990,-5.0,19411,-407,-2.05,18828,20700,1399-11-5
121,فجام,جام‌دارو,4439,34921254,409273253200,11300,11860,11690,390,3.45,11720,420,3.72,10750,11860,1399-11-5
122,ديران,ايران‌دارو,4430,10888160,362876055090,34640,32910,32910,-1730,-4.99,33330,-1310,-3.78,32910,34320,1399-11-5
123,سفارس,سيمان فارس و خوزستان,4337,29908915,512714663210,16550,17370,16690,140,0.85,17140,590,3.56,16030,17370,1399-11-5
124,كسرا,سراميك‌هاي‌صنعتي‌اردكان‌,4313,19750360,506551695640,26720,26750,25390,-1330,-4.98,25650,-1070,-4.0,25390,26840,1399-11-5
125,كاردان,صندوق س تجارت شاخصي كاردان,4312,3105916,488893292450,162400,169200,152360,-10040,-6.18,157410,-4990,-3.07,146160,177770,1399-11-5
126,خاور,ايران خودرو ديزل,4235,44594208,349922565296,7831,8060,7650,-181,-2.31,7847,16,0.2,7597,8065,1399-11-5
127,ساروم,سيمان‌اروميه‌,4190,16908021,519939506940,29870,31360,29280,-590,-1.98,30750,880,2.95,28390,31360,1399-11-5
128,دماوند,توليد نيروي برق دماوند,4168,5663987,286877293054,52046,54589,49444,-2602,-5.0,50649,-1397,-2.68,49444,54589,1399-11-5
129,كلوند,كاشي‌ الوند,4152,11742210,403530453830,32840,32900,34480,1640,4.99,34370,1530,4.66,32900,34480,1399-11-5
130,سفاسي,شركت فارسيت اهواز,4141,21803576,343099356951,16425,15604,15604,-821,-5.0,15736,-689,-4.19,15604,16219,1399-11-5
131,پلاسك,پلاسكوكار,4103,31502219,329384059140,10510,11030,10090,-420,-4.0,10460,-50,-0.48,9990,11030,1399-11-5
132,ساوه,سيمان ساوه,4060,3171713,168490596857,53032,55610,51132,-1900,-3.58,53123,91,0.17,50381,55683,1399-11-5
133,مرقام,ايران‌ارقام‌,4029,10311489,209325283410,20300,21300,19500,-800,-3.94,20300,0,0.0,19290,21310,1399-11-5
134,غپآذر,شير پگاه آذربايجان شرقي,4007,4350338,309986287317,70690,74224,67850,-2840,-4.02,71256,566,0.8,67156,74224,1399-11-5
135,زكوثر,سرمايه گذاري كشاورزي كوثر,4005,11352528,262752345310,23000,24150,22230,-770,-3.35,23140,140,0.61,21850,24150,1399-11-5
136,اخابر,مخابرات ايران,3982,26212122,301650853340,11400,11970,10960,-440,-3.86,11510,110,0.96,10830,11970,1399-11-5
137,نوين,بيمه نوين,3976,93217741,666001581772,6833,7174,7174,341,4.99,7145,312,4.57,6492,7174,1399-11-5
138,خلنت,لنت‌ ترمزايران‌,3935,2890085,385020869340,129610,123130,136090,6480,5.0,133220,3610,2.79,123130,136090,1399-11-5
139,ثشرق,سرمايه گذاري مسكن شمال شرق,3880,62135290,400157786140,6170,6230,6470,300,4.86,6440,270,4.38,6230,6470,1399-11-5
140,نطرين,عطرين نخ قم,3880,21543260,285797961713,13400,14070,12820,-580,-4.33,13266,-134,-1.0,12730,14070,1399-11-5
141,ولپارس,ليزينگ پارسيان,3854,18072579,139614595760,8080,8010,7680,-400,-4.95,7730,-350,-4.33,7680,8010,1399-11-5
142,پارسان,گسترش نفت و گاز پارسيان,3847,26007362,492139763810,19720,19900,18740,-980,-4.97,18920,-800,-4.06,18740,19960,1399-11-5
143,فاسمين,كالسيمين‌,3727,25151460,407905599950,16340,17150,15540,-800,-4.9,16220,-120,-0.73,15530,17150,1399-11-5
144,بكهنوج,توليد برق ماهتاب كهنوج,3726,78062017,171975847821,2174,2282,2106,-68,-3.13,2203,29,1.33,2070,2282,1399-11-5
145,واحيا,م .صنايع و معادن احياء سپاهان,3724,7350481,1231274480115,171876,166720,166720,-5156,-3.0,167509,-4367,-2.54,166720,175990,1399-11-5
146,كپارس,كاشي‌ پارس‌,3700,1629335,288028474070,179710,188610,170730,-8980,-5.0,176780,-2930,-1.63,170730,188610,1399-11-5
147,كگل,معدني و صنعتي گل گهر,3668,21941271,388446367410,17190,18040,17510,320,1.86,17700,510,2.97,16840,18040,1399-11-5
148,كرازي,كارخانجات‌توليدي‌شيشه‌رازي‌,3667,9557080,281272645460,30500,29200,28980,-1520,-4.98,29430,-1070,-3.51,28980,31000,1399-11-5
149,كحافظ,كاشي‌ وسراميك‌ حافظ‌,3652,15208332,209735752450,13750,14430,13500,-250,-1.82,13790,40,0.29,13070,14430,1399-11-5
150,كلر,كلر پارس,3618,3606245,404225461213,114639,117910,108908,-5731,-5.0,112090,-2549,-2.22,108908,119890,1399-11-5
151,ولساپا,ليزينگ رايان‌ سايپا,3599,66688817,257170979630,3950,4040,3760,-190,-4.81,3860,-90,-2.28,3760,4140,1399-11-5
152,ساربيل,سيمان آرتا اردبيل,3576,4683135,215401436100,46230,48540,44000,-2230,-4.82,46000,-230,-0.5,43920,48540,1399-11-5
153,زاگرس,پتروشيمي زاگرس,3574,2487470,485156892491,198660,205000,190601,-8059,-4.06,195040,-3620,-1.82,188727,208000,1399-11-5
154,كفپارس,فرآورده‌هاي‌ نسوز پارس‌,3568,37311554,183622232070,4940,5170,4720,-220,-4.45,4920,-20,-0.4,4700,5180,1399-11-5
155,خكرمان,گروه اقتصادي كرمان خودرو,3556,52277832,275030293920,5249,5380,5092,-157,-2.99,5261,12,0.23,5092,5406,1399-11-5
156,ثنوسا,نوسازي‌وساختمان‌تهران‌,3551,24175619,361234039830,15200,15950,14440,-760,-5.0,14940,-260,-1.71,14440,15960,1399-11-5
157,كتوكا,توليدي و خدمات صنايع نسوز توكا,3542,8894800,253497514547,29356,27889,27889,-1467,-5.0,28500,-856,-2.92,27889,30232,1399-11-5
158,غشهداب,كشت و صنعت شهداب ناب خراسان,3487,35141404,147341556895,4251,4463,4039,-212,-4.99,4193,-58,-1.36,4039,4463,1399-11-5
159,فلامي,لاميران‌,3477,4932326,223490792170,43350,45200,45510,2160,4.98,45310,1960,4.52,43650,45510,1399-11-5
160,چكارن,كارتن‌ ايران‌,3477,46658395,187468221020,4100,4290,3900,-200,-4.88,4020,-80,-1.95,3900,4290,1399-11-5
161,فزرين,زرين معدن آسيا,3455,13516812,304096423491,23314,23940,22149,-1165,-5.0,22498,-816,-3.5,22149,24240,1399-11-5
162,خفنر,فنرسازي‌خاور,3444,11569012,265499716000,23150,24300,22310,-840,-3.63,22950,-200,-0.86,22000,24300,1399-11-5
163,غويتا,ويتانا,3439,11557183,269130818904,22438,23500,23290,852,3.8,23287,849,3.78,21317,23559,1399-11-5
164,ملت,بيمه ملت,3434,21154069,330167374000,16090,16350,15290,-800,-4.97,15610,-480,-2.98,15290,16650,1399-11-5
165,غگيلا,شيرپاستوريزه پگاه گيلان,3429,86166,1952435394,21580,22659,22659,1079,5.0,21620,40,0.19,22659,22659,1399-11-5
166,سصفها,سيمان‌اصفهان‌,3424,981545,406923826890,397440,417310,417310,19870,5.0,414570,17130,4.31,378580,417310,1399-11-5
167,ددام,داروسازي زاگرس فارمد پارس,3416,21204515,458046410760,20730,21760,21760,1030,4.97,21600,870,4.2,20500,21760,1399-11-5
168,بسويچ,پارس‌سويچ‌,3405,4271056,264229400710,61970,65060,58920,-3050,-4.92,61870,-100,-0.16,58880,65060,1399-11-5
169,فجر,فولاد اميركبيركاشان,3400,13894994,875461991520,60420,63440,62130,1710,2.83,63010,2590,4.29,60510,63440,1399-11-5
170,فاذر,صنايع‌ آذرآب‌,3399,8741585,223385131960,25600,26880,24590,-1010,-3.95,25550,-50,-0.2,24320,26880,1399-11-5
171,شلعاب,لعابيران‌,3394,18788351,267066292050,13980,13290,14670,690,4.94,14210,230,1.65,13290,14670,1399-11-5
172,ونفت,سرمايه‌گذاري‌ صنعت‌ نفت‌,3379,22917592,435024340290,18550,19470,18320,-230,-1.24,18980,430,2.32,17630,19470,1399-11-5
173,دتوزيع,توزيع دارو پخش,3351,3800104,200152622613,53773,55000,51085,-2688,-5.0,52670,-1103,-2.05,51085,56200,1399-11-5
174,وصنعت,سرمايه گذاري توسعه صنعت وتجارت,3333,25549184,169227338950,6850,7050,6510,-340,-4.96,6620,-230,-3.36,6510,7080,1399-11-5
175,ومهان,گروه توسعه مالي مهر آيندگان,3331,19920278,262224668114,13451,14120,12800,-651,-4.84,13164,-287,-2.13,12779,14120,1399-11-5
176,فنورد,نوردوقطعات‌ فولادي‌,3314,1257254,310562613320,254830,255360,242090,-12740,-5.0,247020,-7810,-3.06,242090,264000,1399-11-5
177,ولملت,واسپاري ملت,3309,27776268,292509843930,10670,11200,10140,-530,-4.97,10530,-140,-1.31,10140,11200,1399-11-5
178,تبرك,گروه كارخانجات صنعتي تبرك,3304,11152035,191029728410,17661,18543,16782,-879,-4.98,17130,-531,-3.01,16778,18543,1399-11-5
179,ورنا,سرمايه‌گذاري‌ رنا(هلدينگ‌,3297,38643980,263339779120,6980,7310,6640,-340,-4.87,6810,-170,-2.44,6640,7320,1399-11-5
180,خريخت,صنايع‌ريخته‌گري‌ايران‌,3290,46651729,200857883850,4290,4400,4140,-150,-3.5,4310,20,0.47,4080,4500,1399-11-5
181,البرز,بيمه البرز,3288,47543267,222421223090,4750,4980,4520,-230,-4.84,4680,-70,-1.47,4520,4980,1399-11-5
182,ثالوند,سرمايه گذاري مسكن الوند,3287,15123613,325467954895,21094,22148,21700,606,2.87,21521,427,2.02,20250,22148,1399-11-5
183,پكوير,كوير تاير,3281,11886750,201840763950,17020,17620,16170,-850,-4.99,16980,-40,-0.24,16170,17870,1399-11-5
184,دزهراويح,ح . ‌داروسازي‌زهراوي‌,3280,13450860,105742749250,7910,8500,7500,-410,-5.18,7860,-50,-0.63,7120,8570,1399-11-5
185,فرآور,فرآوري‌موادمعدني‌ايران‌,3269,14371526,471810938590,31630,33210,32120,490,1.55,32830,1200,3.79,30050,33210,1399-11-5
186,زبينا,كشاورزي و دامپروري بينالود,3237,5837877,238972421705,39453,40157,41425,1972,5.0,40935,1482,3.76,38481,41425,1399-11-5
187,كسعدي,كاشي‌ سعدي‌,3199,11150380,206326759330,19280,19300,18320,-960,-4.98,18500,-780,-4.05,18320,19480,1399-11-5
188,بميلا,توسعه بازرگاني آهن وفولادميلاد,3149,15394597,378760588449,24845,24881,24000,-845,-3.4,24603,-242,-0.97,23603,26087,1399-11-5
189,سشرق,سيمان‌ شرق‌,3139,31032859,207513961520,6770,7100,6490,-280,-4.14,6690,-80,-1.18,6440,7100,1399-11-5
190,والبر,سرمايه‌ گذاري‌ البرز(هلدينگ‌,3108,12062287,188633607270,16230,16430,15420,-810,-4.99,15640,-590,-3.64,15420,16430,1399-11-5
191,وهور,مديريت انرژي اميد  تابان هور,3086,8703191,338963530585,39176,41099,37350,-1826,-4.66,38947,-229,-0.58,37218,41099,1399-11-5
192,ختور,رادياتور ايران‌,3084,5136671,163135209470,32450,33170,30830,-1620,-4.99,31760,-690,-2.13,30830,33200,1399-11-5
193,قرن,پديده شيمي قرن,3034,5112193,334316371930,65660,68850,63230,-2430,-3.7,65400,-260,-0.4,62920,68850,1399-11-5
194,وكارح,ح . بانك‌ كارآفرين‌,3022,73523847,168362316550,2350,2500,2190,-160,-6.81,2290,-60,-2.55,2120,2540,1399-11-5
195,شغدير,پتروشيمي غدير,3013,10356860,629498940376,58115,61020,61020,2905,5.0,60781,2666,4.59,58150,61020,1399-11-5
196,شلرد,كود شيميايي اوره لردگان,3004,25972548,214360361917,8343,8593,8093,-250,-3.0,8253,-90,-1.08,8093,8593,1399-11-5
197,وبانك,سرمايه گذاري گروه توسعه ملي,2996,22591768,189225151660,8120,8520,8170,50,0.62,8380,260,3.2,7850,8520,1399-11-5
198,غاذر,كشت‌وصنعت‌پياذر,2977,5052661,276986869580,56990,55600,54150,-2840,-4.98,54820,-2170,-3.81,54150,58500,1399-11-5
199,وكادو,تكادو,2963,16409174,411019401961,24498,25000,25232,734,3.0,25048,550,2.25,23765,25232,1399-11-5
200,حآسا,آسيا سير ارس,2957,6754495,294897085876,44705,45310,42470,-2235,-5.0,43659,-1046,-2.34,42470,45990,1399-11-5
201,فروس,فروسيليس‌ ايران‌,2906,24909118,130777611420,5230,5480,5050,-180,-3.44,5250,20,0.38,4970,5490,1399-11-5
202,سلار,شركت سيمان لارستان,2879,6991493,462237977778,65830,63900,67804,1974,3.0,66114,284,0.43,63856,67804,1399-11-5
203,شفن,پتروشيمي فناوران,2814,2725982,780667644510,273020,286670,286660,13640,5.0,286380,13360,4.89,280000,286670,1399-11-5
204,ومعلم,بيمه معلم,2777,23911278,140503049127,6018,6290,5718,-300,-4.99,5876,-142,-2.36,5718,6300,1399-11-5
205,بايكا,كارخانجات كابلسازي ‌ايران‌,2760,4415644,230546036457,53653,52044,52044,-1609,-3.0,52211,-1442,-2.69,52044,54000,1399-11-5
206,كترام,توليدي‌ كاشي‌ تكسرام‌,2760,6829093,295897140510,45520,43250,43250,-2270,-4.99,43330,-2190,-4.81,43250,44600,1399-11-5
207,فيروزه,صندوق شاخص30 شركت فيروزه- سهام,2759,1996534,305113709310,157390,168710,144220,-13170,-8.37,152820,-4570,-2.9,141660,168710,1399-11-5
208,رنيك,جنرال مكانيك,2750,10498265,238579535920,22424,23545,21590,-834,-3.72,22726,302,1.35,21304,23545,1399-11-5
209,حتايد,تايدواترخاورميانه,2726,12231029,345443815780,28960,30370,27520,-1440,-4.97,28240,-720,-2.49,27520,30380,1399-11-5
210,دزهراوي,داروسازي‌زهراوي‌,2722,10739512,104856099710,9930,10420,9440,-490,-4.93,9760,-170,-1.71,9440,10420,1399-11-5
211,ستران,سيمان‌ تهران‌,2709,7271295,215955678580,29820,31310,28330,-1490,-5.0,29700,-120,-0.4,28330,31310,1399-11-5
212,خاذين,سايپاآذين‌,2699,40260143,199610696160,5000,5250,4770,-230,-4.6,4960,-40,-0.8,4750,5250,1399-11-5
213,كروي,توسعه‌ معادن‌ روي‌ ايران‌,2698,6215566,211247496540,35240,36500,33480,-1760,-4.99,33990,-1250,-3.55,33480,36780,1399-11-5
214,دبالك,مواد اوليه دارويي البرز بالك,2648,8392767,194151763366,23010,24160,21860,-1150,-5.0,23133,123,0.53,21860,24160,1399-11-5
215,رانفور,خدمات‌انفورماتيك‌,2645,9071381,244035262920,28090,27800,27200,-890,-3.17,26900,-1190,-4.24,26690,28040,1399-11-5
216,تاپكيش,تجارت الكترونيك پارسيان كيش,2600,5895338,130852475351,22555,23570,21428,-1127,-5.0,22196,-359,-1.59,21428,23570,1399-11-5
217,شپديس,پتروشيمي پرديس,2595,3146835,298762595840,94800,99540,92900,-1900,-2.0,94940,140,0.15,90710,99540,1399-11-5
218,آپ,آسان پرداخت پرشين,2561,8738139,173626336560,20110,21100,19110,-1000,-4.97,19870,-240,-1.19,19110,21110,1399-11-5
219,شسپا,نفت سپاهان,2549,9698468,248199556990,26050,27350,25500,-550,-2.11,25590,-460,-1.77,24750,27350,1399-11-5
220,زفكا,كشت و دامداري فكا,2493,9863351,129862904521,13562,14000,12884,-678,-5.0,13166,-396,-2.92,12884,14000,1399-11-5
221,وبوعلي,سرمايه‌گذاري‌بوعلي‌,2451,24234489,139063973560,5660,5940,5510,-150,-2.65,5740,80,1.41,5380,5940,1399-11-5
222,غپينو,پارس‌ مينو,2430,23938005,205651959410,9010,8850,8560,-450,-4.99,8590,-420,-4.66,8560,8990,1399-11-5
223,سصوفي,سيمان‌ صوفيان‌,2430,11564508,178415977670,15150,15900,15000,-150,-0.99,15430,280,1.85,14400,15900,1399-11-5
224,خودكفا,اقتصادي و خودكفايي آزادگان,2416,8944204,291128774292,33530,32525,32525,-1005,-3.0,32549,-981,-2.93,32525,33200,1399-11-5
225,زشگزا,شير و گوشت زاگرس شهركرد,2384,12242412,128163276174,10767,10750,10229,-538,-5.0,10469,-298,-2.77,10229,11100,1399-11-5
226,ارفع,شركت آهن و فولاد ارفع,2374,12605994,162254028725,13105,13759,12510,-595,-4.54,12871,-234,-1.79,12450,13759,1399-11-5
227,خمهر,مهركام‌پارس‌,2370,39743149,120760285600,2980,3120,2980,0,0.0,3040,60,2.01,2870,3120,1399-11-5
228,وملل,اعتباري ملل,2332,27550039,449624161456,16559,16980,16300,-259,-1.56,16320,-239,-1.44,15790,17100,1399-11-5
229,ختراك,ريخته‌گري‌ تراكتورسازي‌ ايران‌,2313,12395211,181437959360,15210,14980,14450,-760,-5.0,14640,-570,-3.75,14450,15550,1399-11-5
230,غديس,پاكديس,2293,13416129,160479366203,11551,12128,11600,49,0.42,11962,411,3.56,11200,12128,1399-11-5
231,قصفها,قنداصفهان‌,2281,717350,117198313510,164000,172200,157000,-7000,-4.27,163380,-620,-0.38,155900,172200,1399-11-5
232,بزاگرس,نيروگاه زاگرس كوثر,2274,13137151,106184715668,8245,8595,7833,-412,-5.0,8083,-162,-1.96,7833,8648,1399-11-5
233,حريل,ريل پردازسير,2262,32062004,202025512472,6556,6700,6229,-327,-4.99,6301,-255,-3.89,6229,6700,1399-11-5
234,درهآور,دارويي ره آورد تامين,2258,2886646,116459603696,39834,41490,38720,-1114,-2.8,40344,510,1.28,38010,41825,1399-11-5
235,هرمز,فولاد هرمزگان جنوب,2256,19808585,267537457154,13370,14038,13490,120,0.9,13506,136,1.02,12800,14038,1399-11-5
236,شفارس,صنايع‌ شيميايي‌ فارس‌,2252,5176105,257388936800,49740,52000,47850,-1890,-3.8,49730,-10,-0.02,47260,52220,1399-11-5
237,وايران,ليزينگ ايرانيان,2247,13273498,177192017660,13880,13900,13190,-690,-4.97,13350,-530,-3.82,13190,14100,1399-11-5
238,فسپا,گروه‌صنعتي‌سپاهان‌,2243,8155759,356684578750,42840,44980,41640,-1200,-2.8,43730,890,2.08,40900,44980,1399-11-5
239,بورس,بورس اوراق بهادار تهران,2236,4420248,222312922920,50060,52560,48350,-1710,-3.42,50290,230,0.46,47560,52560,1399-11-5
240,فباهنر,مس‌ شهيدباهنر,2233,3248374,172940397570,52970,55610,52360,-610,-1.15,53240,270,0.51,50330,55610,1399-11-5
241,زنجان,صنايع كشاورزي وكود زنجان,2170,21170833,218943259879,10818,10278,10278,-540,-4.99,10342,-476,-4.4,10278,10708,1399-11-5
242,بپاس,بيمه پاسارگاد,2169,2138201,213453985258,99833,101150,99999,166,0.17,99829,-4,0.0,99000,101150,1399-11-5
243,دارو,كارخانجات‌داروپخش‌,2153,6153470,225817592440,37670,39300,35790,-1880,-4.99,36700,-970,-2.57,35790,39300,1399-11-5
244,ثغرب,شركت سرمايه گذاري مسكن شمالغرب,2147,11660653,94931844862,8422,8220,8001,-421,-5.0,8141,-281,-3.34,8001,8540,1399-11-5
245,فولاي,صنايع فولاد آلياژي يزد,2136,3616583,157555210762,44711,45500,42476,-2235,-5.0,43565,-1146,-2.56,42476,46830,1399-11-5
246,كسعديح,ح . كاشي‌ سعدي‌,2136,7897190,124100422840,16640,16280,15390,-1250,-7.51,15710,-930,-5.59,14980,17210,1399-11-5
247,وسينا,بانك سينا,2102,34093305,126639784910,3790,3950,3610,-180,-4.75,3710,-80,-2.11,3610,3950,1399-11-5
248,افق,فروشگاههاي زنجيره اي افق كوروش,2096,2125288,169488472960,81130,82800,79000,-2130,-2.63,79750,-1380,-1.7,77090,82800,1399-11-5
249,خكاوه,سايپا ديزل,2094,37949625,213124092525,5730,5730,5559,-171,-2.98,5616,-114,-1.99,5559,5900,1399-11-5
250,خشرق,الكتريك‌ خودرو شرق‌,2078,8593256,191564231830,23000,22560,21850,-1150,-5.0,22290,-710,-3.09,21850,23380,1399-11-5
251,افرا,افرانت,2076,3086877,134205294431,44035,45500,41834,-2201,-5.0,43476,-559,-1.27,41834,46000,1399-11-5
252,همراه,شركت ارتباطات سيار ايران,2073,8831626,246692116200,28670,29750,27240,-1430,-4.99,27930,-740,-2.58,27240,29750,1399-11-5
253,ريشمك,توليد و صادرات ريشمك,2063,2585901,144953420669,55846,58638,53660,-2186,-3.91,56055,209,0.37,53054,58638,1399-11-5
254,قشير,قند شيروان قوچان و بجنورد,2034,3993740,116915431355,29990,31000,28491,-1499,-5.0,29275,-715,-2.38,28491,31220,1399-11-5
255,وبهمن,سرمايه‌گذاري‌بهمن‌,2027,18420265,399476254080,22810,21670,21670,-1140,-5.0,21690,-1120,-4.91,21670,22090,1399-11-5
256,توريل,توکاريل,2025,7366126,214933920956,30358,29000,28841,-1517,-5.0,29179,-1179,-3.88,28841,30900,1399-11-5
257,ورازي,بيمه رازي,2023,17358276,148231015257,8631,9062,8300,-331,-3.84,8540,-91,-1.05,8200,9062,1399-11-5
258,رمپنا,گروه مپنا (سهامي عام),2009,15108106,254429578440,16290,17100,16700,410,2.52,16840,550,3.38,15850,17100,1399-11-5
259,فاما,صنعتي‌ آما,2007,8580558,179569082490,21890,21100,20800,-1090,-4.98,20930,-960,-4.39,20800,21960,1399-11-5
260,تكمبا,كمباين‌ سازي‌ ايران‌,2000,12941259,132344343330,10550,10560,10030,-520,-4.93,10230,-320,-3.03,10030,10770,1399-11-5
261,شكلر,نيروكلر,1999,2544576,157303407220,63560,64350,60390,-3170,-4.99,61820,-1740,-2.74,60390,66000,1399-11-5
262,سخواف,سيمان مجد خواف,1988,11198672,250585486280,22026,22686,21500,-526,-2.39,22376,350,1.59,21366,22686,1399-11-5
263,تاصيكو,سرمايه گذاري صدرتامين,1982,23461199,231928250940,9630,10110,9510,-120,-1.25,9890,260,2.7,9210,10110,1399-11-5
264,غمارگ,مارگارين‌,1979,4587005,150802739730,32320,33930,31970,-350,-1.08,32880,560,1.73,31000,33930,1399-11-5
265,ميهن,بيمه ميهن,1948,18868927,102544387891,5587,5810,5308,-279,-4.99,5435,-152,-2.72,5308,5810,1399-11-5
266,سيمرغ,سيمرغ,1931,6617610,110271081490,17030,17700,16180,-850,-4.99,16660,-370,-2.17,16180,17750,1399-11-5
267,سيستم,همكاران سيستم,1918,3959843,148478833950,38090,39200,36190,-1900,-4.99,37500,-590,-1.55,36190,39990,1399-11-5
268,اعتماد,صندوق س.اعتماد آفرين پارسيان-د,1918,51749720,1785502397540,34485,34506,34508,23,0.07,34503,18,0.05,34499,34508,1399-11-5
269,داسوه,داروسازي‌ اسوه‌,1913,5154165,202645882750,37920,37500,39810,1890,4.98,39320,1400,3.69,36910,39810,1399-11-5
270,وآفري,بيمه كارآفرين,1902,15106279,303602465479,19708,20299,19780,72,0.37,20098,390,1.98,19117,20299,1399-11-5
271,غشاذر,پگاه‌آذربايجان‌غربي‌,1893,7609798,200091203600,25530,26800,25760,230,0.9,26290,760,2.98,24500,26800,1399-11-5
272,وبيمه,سرمايه‌ گذاري‌ صنعت‌ بيمه‌,1890,33145333,112381484620,3520,3350,3350,-170,-4.83,3390,-130,-3.69,3350,3540,1399-11-5
273,كوير,توليدي فولاد سپيد فراب كوير,1889,7486932,160806490340,22430,22500,21310,-1120,-4.99,21480,-950,-4.24,21310,22980,1399-11-5
274,دفارا,داروسازي‌ فارابي‌,1876,2790156,160843598090,56070,58570,55500,-570,-1.02,57650,1580,2.82,53710,58870,1399-11-5
275,ولشرق,ليزينگ ايران و شرق,1859,13144431,105529158485,8345,8250,7928,-417,-5.0,8028,-317,-3.8,7928,8372,1399-11-5
276,كهمدا,شيشه‌ همدان‌,1848,9407972,110244632460,12060,12300,11460,-600,-4.98,11720,-340,-2.82,11460,12400,1399-11-5
277,تنوين,تامين سرمايه نوين,1839,28120861,167800760480,5770,6050,5840,70,1.21,5970,200,3.47,5500,6050,1399-11-5
278,بشهاب,لامپ‌  پارس‌ شهاب‌,1836,1399359,137210553340,101160,103000,96110,-5050,-4.99,98050,-3110,-3.07,96110,106000,1399-11-5
279,خاهن,آهنگري‌ تراكتورسازي‌ ايران‌,1826,5337299,213682204760,39300,40700,40560,1260,3.21,40040,740,1.88,38130,40990,1399-11-5
280,وخاور,بانك خاورميانه,1816,19312053,204821075270,11110,10810,10560,-550,-4.95,10610,-500,-4.5,10560,11000,1399-11-5
281,غشوكو,شوكو پارس,1814,2577568,125766807944,48750,50212,47288,-1462,-3.0,48793,43,0.09,47288,50212,1399-11-5
282,آرمان,بيمه آرمان,1801,12842161,117154893097,9312,9033,9120,-192,-2.06,9123,-189,-2.03,9033,9510,1399-11-5
283,ماديرا,صنايع ماشين هاي اداري ايران,1795,9666300,106465430208,11411,11040,10841,-570,-5.0,11014,-397,-3.48,10841,11411,1399-11-5
284,ثعمرا,عمران و توسعه شاهد,1780,10300945,125824639952,12349,12966,11732,-617,-5.0,12215,-134,-1.09,11732,12966,1399-11-5
285,تكشا,گسترش‌صنايع‌وخدمات‌كشاورزي‌,1780,2564648,162955563200,66070,63800,62770,-3300,-4.99,63540,-2530,-3.83,62770,66980,1399-11-5
286,خوساز,محورسازان‌ايران‌خودرو,1767,14954860,125084961750,8570,8700,8160,-410,-4.78,8360,-210,-2.45,8150,8990,1399-11-5
287,فسازان,غلتك سازان سپاهان,1758,12009617,427587164790,34050,35750,35750,1700,4.99,35600,1550,4.55,34100,35750,1399-11-5
288,دسانكو,داروسازي سبحان انكولوژي,1753,6285341,108200582219,17459,17900,16587,-872,-4.99,17215,-244,-1.4,16587,18150,1399-11-5
289,وتوسم,سرمايه‌گذاري‌توسعه‌ملي‌,1746,16728176,193506092920,11050,11600,11600,550,4.98,11570,520,4.71,11070,11600,1399-11-5
290,سپاها,سيمان‌سپاهان‌,1741,11579423,100887569360,8940,9180,8500,-440,-4.92,8710,-230,-2.57,8500,9300,1399-11-5
291,دشيمي,شيمي‌ داروئي‌ داروپخش‌,1713,2036696,107139213180,54310,56000,51600,-2710,-4.99,52600,-1710,-3.15,51600,56000,1399-11-5
292,كشرق,صنعتي و معدني شمال شرق شاهرود,1711,1460537,150024728320,105893,110000,100599,-5294,-5.0,102719,-3174,-3.0,100599,110000,1399-11-5
293,شاوان,پالايش نفت لاوان,1697,2142027,188152522824,87263,91626,83990,-3273,-3.75,87839,576,0.66,82900,91626,1399-11-5
294,سباقر,سيمان باقران,1696,9094835,155548771109,17222,16750,16775,-447,-2.6,17103,-119,-0.69,16706,17738,1399-11-5
295,بموتو,موتوژن‌,1694,3528933,195853226490,54870,56490,53810,-1060,-1.93,55500,630,1.15,52320,57610,1399-11-5
296,ثمسكن,سرمايه‌گذاري‌ مسكن‌,1685,23435186,125699939500,5520,5770,5250,-270,-4.89,5360,-160,-2.9,5250,5790,1399-11-5
297,خچرخش,چرخشگر,1681,6749740,123134522790,18810,19700,17870,-940,-5.0,18240,-570,-3.03,17870,19730,1399-11-5
298,وتوشه,سرمايه‌ گذاري‌ پارس‌ توشه‌,1678,5046932,124257983290,25560,26490,24290,-1270,-4.97,24620,-940,-3.68,24290,26490,1399-11-5
299,شبهرن,نفت‌ بهران‌,1666,2219113,131256662640,58790,61720,59190,400,0.68,59150,360,0.61,57000,61720,1399-11-5
300,ثباغ,شهر سازي و خانه سازي باغميشه,1660,6444636,118503744560,19076,19401,18123,-953,-5.0,18388,-688,-3.61,18123,19500,1399-11-5
301,پلاست,كارخانجات توليدي پلاستيران,1650,2482038,155299259713,61689,63539,63539,1850,3.0,62569,880,1.43,59839,63539,1399-11-5
302,زقيام,كشت و دام قيام اصفهان,1644,3320005,97756329376,30374,31800,28856,-1518,-5.0,29445,-929,-3.06,28856,31800,1399-11-5
303,كمنگنز,معادن‌منگنزايران‌,1640,1162808,119061919790,105620,109000,100340,-5280,-5.0,102390,-3230,-3.06,100340,109000,1399-11-5
304,غگلستا,شير پاستوريزه پگاه گلستان,1635,9143619,244289466906,27743,28300,26356,-1387,-5.0,26717,-1026,-3.7,26356,28300,1399-11-5
305,ودي,بيمه  دي,1634,7313136,184757901752,26071,25200,24768,-1303,-5.0,25264,-807,-3.1,24768,26300,1399-11-5
306,سرچشمه,سرمايه گذاري مس سرچشمه,1628,13017670,100173106198,7855,8200,7490,-365,-4.65,7695,-160,-2.04,7463,8200,1399-11-5
307,حپارسا,توسعه حمل و نقل ريلي پارسيان,1625,3306200,124732282805,37815,39705,36636,-1179,-3.12,37727,-88,-0.23,35925,39705,1399-11-5
308,وتوكا,سرمايه‌گذاري‌توكافولاد(هلدينگ,1623,10908305,137644795700,12720,13350,12270,-450,-3.54,12620,-100,-0.79,12090,13350,1399-11-5
309,تكنو,تكنوتار,1621,4995214,101811016630,20440,21330,19790,-650,-3.18,20380,-60,-0.29,19420,21460,1399-11-5
310,قچار,فراوردههاي غذايي وقند چهارمحال,1609,3059265,220487480554,69010,72460,72460,3450,5.0,72072,3062,4.44,70010,72460,1399-11-5
311,قشرين,قند شيرين خراسان,1609,6442049,110374729380,17638,17210,17109,-529,-3.0,17133,-505,-2.86,17109,17500,1399-11-5
312,شنفت,نفت‌ پارس‌,1608,3782912,223898459800,62050,59150,59420,-2630,-4.24,59190,-2860,-4.61,58950,62900,1399-11-5
313,فسرب,ملي‌ سرب‌وروي‌ ايران‌,1603,1231944,121268777400,101910,102900,96820,-5090,-4.99,98440,-3470,-3.4,96820,104990,1399-11-5
314,حسينا,توسعه خدمات دريايي وبندري سينا,1591,2696350,186395790961,71372,72490,67804,-3568,-5.0,69129,-2243,-3.14,67804,72490,1399-11-5
315,دتوليد,داروسازي توليد دارو,1579,3432273,105620148426,31818,32800,30228,-1590,-5.0,30773,-1045,-3.28,30228,32800,1399-11-5
316,جم,پتروشيمي جم,1573,3173534,133341600590,42830,44440,41220,-1610,-3.76,42020,-810,-1.89,40700,44440,1399-11-5
317,كاريس,صندوق س.سپهر كاريزما-س,1573,16750835,190425900871,11684,11950,10970,-714,-6.11,11368,-316,-2.7,10632,11950,1399-11-5
318,پدرخش,درخشان‌ تهران‌,1569,711762,98109522970,140770,136000,133740,-7030,-4.99,137840,-2930,-2.08,133740,145500,1399-11-5
319,وگردش,بانك گردشگري,1550,7501287,169680368112,23096,22500,22404,-692,-3.0,22620,-476,-2.06,22404,23300,1399-11-5
320,سيلام,سيمان‌ ايلام‌,1544,9489844,78929718870,8520,8920,8100,-420,-4.93,8320,-200,-2.35,8100,8920,1399-11-5
321,غپاك,لبنيات‌ پاك‌,1539,12957422,177902366800,13100,13750,13750,650,4.96,13730,630,4.81,13100,13750,1399-11-5
322,تپمپي,پمپ‌ سازي‌ ايران‌,1526,3863159,98341910980,26250,27340,24940,-1310,-4.99,25460,-790,-3.01,24940,27340,1399-11-5
323,سفانو,سيمان فارس نو,1512,4261752,156615123110,37180,39000,35330,-1850,-4.98,36750,-430,-1.16,35330,39000,1399-11-5
324,فلوله,لوله‌وماشين‌سازي‌ايران‌,1511,6529761,142690324460,22210,22990,21110,-1100,-4.95,21850,-360,-1.62,21100,22990,1399-11-5
325,حاريا,كشتيراني آريا,1492,3131642,115857802448,37243,38360,36870,-373,-1.0,36996,-247,-0.66,36126,38360,1399-11-5
326,پاسا,ايران‌ياساتايرورابر,1481,5161357,136554740520,25800,26900,25440,-360,-1.4,26460,660,2.56,24960,27090,1399-11-5
327,سمازن,سيمان‌مازندران‌,1480,8427225,83143501680,10080,10240,9590,-490,-4.86,9870,-210,-2.08,9580,10500,1399-11-5
328,وكار,بانك‌ كارآفرين‌,1471,24980266,79315863290,3260,3380,3100,-160,-4.91,3180,-80,-2.45,3100,3400,1399-11-5
329,وسين,بيمه سينا,1458,9446868,171652623968,17906,18801,17650,-256,-1.43,18170,264,1.47,17101,18801,1399-11-5
330,سامان,بانك سامان,1452,14607967,161091163918,11070,11402,10738,-332,-3.0,11028,-42,-0.38,10738,11402,1399-11-5
331,شصدف,صنعتي دوده فام,1438,57930,1644922350,27043,28395,28395,1352,5.0,27085,42,0.16,28395,28395,1399-11-5
332,كطبس,ذغال‌سنگ‌ نگين‌ ط‌بس‌,1421,2669882,184914909710,70400,73920,66880,-3520,-5.0,69260,-1140,-1.62,66880,73920,1399-11-5
333,كگهر,سنگ آهن گهرزمين,1401,3165638,140541210253,45442,47709,43920,-1522,-3.35,44396,-1046,-2.3,43170,47709,1399-11-5
334,ولغدر,ليزينگ‌خودروغدير,1396,4838430,124406488910,26270,27290,24960,-1310,-4.99,25710,-560,-2.13,24960,27490,1399-11-5
335,فولاژ,فولاد آلياژي ايران,1388,5875160,102237023240,17830,18720,16940,-890,-4.99,17400,-430,-2.41,16940,18720,1399-11-5
336,اميد,تامين سرمايه اميد,1374,8941631,79608368320,8970,9410,8530,-440,-4.91,8900,-70,-0.78,8530,9410,1399-11-5
337,كپرور,فرآوري زغال سنگ پروده طبس,1370,2000004,85876674243,43969,43620,41771,-2198,-5.0,42938,-1031,-2.34,41771,45600,1399-11-5
338,خكار,ايركا پارت صنعت,1366,4421145,108174341420,25210,24250,23950,-1260,-5.0,24470,-740,-2.94,23950,26190,1399-11-5
339,مبين,مبين انرژي خليج فارس,1362,10882267,145844510990,14000,14070,13300,-700,-5.0,13400,-600,-4.29,13300,14210,1399-11-5
340,ولبهمن,شركت بهمن ليزينگ,1352,12599683,103367513840,8521,8910,8095,-426,-5.0,8204,-317,-3.72,8095,8910,1399-11-5
341,كقزوي,شيشه‌ قزوين‌,1351,12271831,139401235521,11542,11196,11196,-346,-3.0,11359,-183,-1.59,11196,11888,1399-11-5
342,كرماشا,صنايع پتروشيمي كرمانشاه,1350,5556637,199216596750,37170,37490,35340,-1830,-4.92,35850,-1320,-3.55,35320,37530,1399-11-5
343,غفارس,شير پاستوريزه پگاه فارس,1348,5821010,65226437581,11531,11300,10955,-576,-5.0,11205,-326,-2.83,10955,11732,1399-11-5
344,كيان,صندوق س. با درآمد ثابت كيان,1347,33750157,907029523940,26865,26874,26874,9,0.03,26875,10,0.04,26873,26879,1399-11-5
345,پرديس,سرمايه گذاري پرديس,1346,15821452,105359104560,6490,6810,6490,0,0.0,6660,170,2.62,6250,6810,1399-11-5
346,پاكشو,گروه صنعتي پاكشو,1342,1558071,123867512200,78460,79630,78700,240,0.31,79500,1040,1.33,76000,82000,1399-11-5
347,شكف,كف,1338,1683254,138662247096,85602,82178,82178,-3424,-4.0,82377,-3225,-3.77,82178,85050,1399-11-5
348,سخزر,سيمان‌ خزر,1337,2565941,84683617240,33750,34900,32070,-1680,-4.98,33000,-750,-2.22,32070,35300,1399-11-5
349,اتكاي,بيمه اتكايي ايرانيان,1331,9489992,157411148165,16017,16817,16050,33,0.21,16587,570,3.56,16000,16817,1399-11-5
350,سبجنو,سيمان‌ بجنورد,1318,2240657,96645726580,44220,46430,42010,-2210,-5.0,43130,-1090,-2.46,42010,46430,1399-11-5
351,ثامان,سامان‌ گستراصفهان‌,1312,4674378,105695543540,22040,23110,22610,570,2.59,22610,570,2.59,21060,23140,1399-11-5
352,فنوال,نورد آلومينيوم‌,1286,3762693,92478839310,25400,26100,24130,-1270,-5.0,24580,-820,-3.23,24130,26200,1399-11-5
353,سيدكو,سرمايه گذاري توسعه صنايع سيمان,1284,10463243,66167824090,6310,6600,6070,-240,-3.8,6320,10,0.16,6000,6620,1399-11-5
354,غشان,شيرپاستوريزه‌پگاه‌خراسان‌,1278,9148668,66745486340,7520,7720,7150,-370,-4.92,7300,-220,-2.93,7150,7720,1399-11-5
355,ميدكو,هلدينگ صنايع  معدني خاورميانه,1276,11931985,374437794135,31364,31364,31364,0,0.0,31381,17,0.05,31340,31866,1399-11-5
356,سهرمز,سيمان‌هرمزگان‌,1272,3102438,73570446400,24430,24200,23790,-640,-2.62,23710,-720,-2.95,23210,25160,1399-11-5
357,نيرو,نيرو سرمايه,1272,1565635,98145489870,62963,64851,61075,-1888,-3.0,62687,-276,-0.44,61075,64851,1399-11-5
358,تماوند,تامين سرمايه دماوند,1266,10466256,191201879740,18509,19430,18400,-109,-0.59,18268,-241,-1.3,17584,19430,1399-11-5
359,سغرب,سيمان‌غرب‌,1257,2911708,77874451440,27810,29000,26420,-1390,-5.0,26750,-1060,-3.81,26420,29000,1399-11-5
360,فايرا,آلومينيوم‌ايران‌,1256,5525806,118436548270,21700,22780,20910,-790,-3.64,21430,-270,-1.24,20620,22780,1399-11-5
361,شپارس,بين‌ المللي‌ محصولات‌  پارس‌,1254,6320610,128271657350,21280,20470,20220,-1060,-4.98,20290,-990,-4.65,20220,20990,1399-11-5
362,غالبر,لبنيات‌ كالبر,1249,5132290,70599097700,14030,14050,13330,-700,-4.99,13760,-270,-1.92,13330,14350,1399-11-5
363,لسرما,سرما آفرين‌,1235,5074010,145720618980,29910,29910,28420,-1490,-4.98,28720,-1190,-3.98,28420,30500,1399-11-5
364,شبريز,پالايش نفت تبريز,1228,8510724,217448998200,24340,25550,25550,1210,4.97,25550,1210,4.97,25550,25550,1399-11-5
365,وگستر,گسترش سرمايه گذاري ايرانيان,1227,3901854,92114271927,23027,24100,22540,-487,-2.11,23608,581,2.52,22000,24178,1399-11-5
366,شكربن,كربن‌ ايران‌,1224,1042272,112806375820,106550,111700,105000,-1550,-1.45,108230,1680,1.58,102520,111700,1399-11-5
367,كگاز,شيشه‌ و گاز,1223,3032628,55546635660,18730,19000,17800,-930,-4.97,18320,-410,-2.19,17800,19550,1399-11-5
368,آساس,صندوق س.آسمان آرماني سهام-س,1221,1075214,179238345789,170274,174941,161003,-9271,-5.44,166700,-3574,-2.1,153247,177345,1399-11-5
369,حبندر,دريايي و کشتيراني خط دريابندر,1211,3541350,111936734006,30822,31746,31746,924,3.0,31608,786,2.55,29898,31746,1399-11-5
370,سكرد,سيمان كردستان,1210,7093150,61853649130,8880,9100,8440,-440,-4.95,8720,-160,-1.8,8440,9250,1399-11-5
371,اطلس,صندوق س.توسعه اندوخته آينده-س,1205,585834,123610697652,209671,217000,202700,-6971,-3.32,211000,1329,0.63,198000,218400,1399-11-5
372,شپترو,پتروشيمي آبادان,1204,21698799,116297799999,5458,5500,5295,-163,-2.99,5360,-98,-1.8,5295,5609,1399-11-5
373,لوتوس,تامين سرمايه لوتوس پارسيان,1188,7581396,86780984790,11740,12300,11160,-580,-4.94,11450,-290,-2.47,11160,12310,1399-11-5
374,حسير,ريل سير كوثر,1184,3583515,59071693550,17020,17871,16169,-851,-5.0,16484,-536,-3.15,16169,17871,1399-11-5
375,تيپيكو,سرمايه گذاري دارويي تامين,1184,2764180,137918356680,51680,53800,49100,-2580,-4.99,49890,-1790,-3.46,49100,53800,1399-11-5
376,پرداخت,به پرداخت ملت,1181,4324028,153010276210,33910,33910,35600,1690,4.98,35390,1480,4.36,33910,35600,1399-11-5
377,سخاش,سيمان‌خاش‌,1180,680182,91501863820,140520,140700,133500,-7020,-5.0,134530,-5990,-4.26,133500,142340,1399-11-5
378,بساما,بيمه سامان,1179,4387588,105848440305,25144,25480,23887,-1257,-5.0,24125,-1019,-4.05,23887,26154,1399-11-5
379,اتكام,شركت بيمه اتكايي امين,1167,9936260,60444488495,6263,6499,5950,-313,-5.0,6083,-180,-2.87,5950,6499,1399-11-5
380,وثنو,سرمايه گذاري ساختماني نوين,1166,4418375,82083505288,19434,19000,18463,-971,-5.0,18578,-856,-4.4,18463,19250,1399-11-5
381,تايرا,تراكتورسازي‌ايران‌,1163,5839610,174138183590,30980,32520,29440,-1540,-4.97,29820,-1160,-3.74,29440,32520,1399-11-5
382,فخاس,فولاد خراسان,1161,2653970,72321400880,27160,28000,26500,-660,-2.43,27220,60,0.22,25810,28510,1399-11-5
383,دكوثر,داروسازي‌ كوثر,1160,2735547,62773795440,23810,24580,22620,-1190,-5.0,22950,-860,-3.61,22620,24580,1399-11-5
384,چافست,افست‌,1157,4601647,81447570700,18380,18690,17470,-910,-4.95,17700,-680,-3.7,17470,18690,1399-11-5
385,شخارك,پتروشيمي‌ خارك‌,1157,3061757,125215731760,41420,43000,39980,-1440,-3.48,40900,-520,-1.26,39350,43000,1399-11-5
386,غپونه,نوش پونه مشهد,1151,3172090,69385571972,21596,22180,21500,-96,-0.44,21874,278,1.29,20949,22243,1399-11-5
387,وصنا,گروه‌صنايع‌بهشهرايران‌,1146,6888956,48975448120,7210,7540,6850,-360,-4.99,7110,-100,-1.39,6850,7550,1399-11-5
388,وليز,ليزينگ‌ايران‌,1145,8647808,60470712290,7230,7370,6870,-360,-4.98,6990,-240,-3.32,6870,7400,1399-11-5
389,شبصير,توليدات پتروشيمي قائد بصير,1142,938501,95120047365,100171,105179,96400,-3771,-3.76,101353,1182,1.18,95170,105179,1399-11-5
390,غشهد,شهد ايران ‌,1135,9507723,66929311550,7270,7500,6910,-360,-4.95,7040,-230,-3.16,6910,7500,1399-11-5
391,ركيش,كارت اعتباري ايران كيش,1135,4573740,112642758840,24920,25400,23680,-1240,-4.98,24630,-290,-1.16,23680,26000,1399-11-5
392,بخاور,بيمه زندگي خاورميانه,1116,8104665,59012032499,7230,7580,7060,-170,-2.35,7281,51,0.71,6910,7591,1399-11-5
393,كيميا,معدني كيمياي زنجان گستران,1110,2272504,91978136155,42033,42000,39932,-2101,-5.0,40474,-1559,-3.71,39932,42017,1399-11-5
394,پكرمان,گروه‌ صنعتي‌ بارز,1106,5206258,132589584100,26630,26500,25300,-1330,-4.99,25470,-1160,-4.36,25300,27340,1399-11-5
395,سخوز,سيمان خوزستان,1103,4110590,92813062270,23430,24460,22260,-1170,-4.99,22580,-850,-3.63,22260,24460,1399-11-5
396,رتاپ,تجارت الكترونيك  پارسيان,1101,7093790,45810668030,6650,6880,6320,-330,-4.96,6470,-180,-2.71,6320,6880,1399-11-5
397,ثجوان,تامين مسكن جوانان,1090,6208540,80864920553,12771,12391,13154,383,3.0,13025,254,1.99,12388,13154,1399-11-5
398,آتيمس,صندوق س.آرمان آتيه درخشان مس-س,1082,534203,102370360748,198226,200000,183500,-14726,-7.43,191632,-6594,-3.33,180010,202000,1399-11-5
399,وبشهر,توسعه‌ صنايع‌ بهشهر(هلدينگ,1082,6025295,81601781900,14040,14100,13340,-700,-4.99,13540,-500,-3.56,13340,14580,1399-11-5
400,آ س پ,آ.س.پ,1082,4131107,60310498469,15241,14610,14479,-762,-5.0,14599,-642,-4.21,14479,15248,1399-11-5
401,كنور,توسعه معدني و صنعتي صبانور,1069,2860973,125082105650,43830,46020,42640,-1190,-2.72,43720,-110,-0.25,41660,46020,1399-11-5
402,اپرداز,آتيه داده پرداز,1062,3028546,72851024723,24929,25500,23683,-1246,-5.0,24055,-874,-3.51,23683,25890,1399-11-5
403,لخزر,پارس‌ خزر,1060,1078127,173758887970,153650,155140,161330,7680,5.0,161170,7520,4.89,155100,161330,1399-11-5
404,گوهران,سرمايه گذاري توسعه گوهران اميد,1046,5020555,39108848901,7611,7991,7680,69,0.91,7745,134,1.76,7240,7991,1399-11-5
405,غگلپا,شير پاستوريزه پگاه گلپايگان,1043,866634,58878930966,70808,68110,67268,-3540,-5.0,67940,-2868,-4.05,67268,73000,1399-11-5
406,مداران,داده‌پردازي‌ايران‌,1038,5204438,137639599100,25320,26580,26360,1040,4.11,26450,1130,4.46,24900,26580,1399-11-5
407,شكبير,پتروشيمي اميركبير,1031,19654479,1598088801658,78942,81310,81310,2368,3.0,81309,2367,3.0,79500,81310,1399-11-5
408,شپاكسا,پاكسان‌,1028,4005051,131751313980,32260,33870,32690,430,1.33,32900,640,1.98,31000,33870,1399-11-5
409,وحكمت,بيمه حكمت صبا,1024,8428711,42972583125,5224,5080,5068,-156,-2.99,5098,-126,-2.41,5068,5249,1399-11-5
410,كي بي سي,شركت كي بي سي,1020,2008245,62714409803,32198,31680,30589,-1609,-5.0,31228,-970,-3.01,30589,32970,1399-11-5
411,دسبحا,گروه دارويي سبحان,1010,2381620,42555042360,18600,18600,17670,-930,-5.0,17940,-660,-3.55,17670,18790,1399-11-5
412,آريان,سرمايه گذاري پارس آريان,1009,11345320,160100772160,14319,14700,13890,-429,-3.0,14112,-207,-1.45,13890,14700,1399-11-5
413,وپترو,سرمايه‌گذاري صنايع پتروشيمي‌,999,4317167,72358361870,17440,18170,16570,-870,-4.99,16760,-680,-3.9,16570,18170,1399-11-5
414,قشهد,شهد,991,2029203,72001855610,34570,33000,34570,0,0.0,35480,910,2.63,32850,36290,1399-11-5
415,خپويش,سازه‌ پويش‌,984,1091679,53311643240,50440,48550,47920,-2520,-5.0,48830,-1610,-3.19,47920,50800,1399-11-5
416,چكاوهح,ح . صنايع‌كاغذسازي‌كاوه‌,977,6041261,65299550530,11230,11120,10750,-480,-4.27,10810,-420,-3.74,10110,11610,1399-11-5
417,شوينده,مديريت صنعت شوينده ت.ص.بهشهر,966,2541557,89727305570,36050,37350,34500,-1550,-4.3,35300,-750,-2.08,34250,37350,1399-11-5
418,خفناور,مهندسي صنعتي روان فن آور,965,6193604,238119417062,37331,38450,38450,1119,3.0,38446,1115,2.99,37350,38450,1399-11-5
419,كپشير,پشم‌شيشه‌ايران‌,957,2464878,66307307880,27990,27900,26600,-1390,-4.97,26900,-1090,-3.89,26600,28680,1399-11-5
420,پارس,پتروشيمي پارس,952,718825,96512543450,137570,137090,131480,-6090,-4.43,134330,-3240,-2.36,130710,138990,1399-11-5
421,سشمال,سيمان‌ شمال‌,947,7558759,75573732470,10330,10650,9820,-510,-4.94,10000,-330,-3.19,9820,10660,1399-11-5
422,هجرت,پخش هجرت,945,1494368,42764417185,29556,29950,28079,-1477,-5.0,28722,-834,-2.82,28079,30500,1399-11-5
423,وشهر,بانك شهر,945,16094862,104101269692,6433,6597,6473,40,0.62,6468,35,0.54,6201,6690,1399-11-5
424,غبشهر,صنعتي‌ بهشهر,942,4244784,99584872600,24330,25000,23120,-1210,-4.97,23460,-870,-3.58,23120,25000,1399-11-5
425,وصندوق,سرمايه‌گذاري‌صندوق‌بازنشستگي‌,940,9026821,117527423850,12600,13230,13160,560,4.44,12980,380,3.02,12120,13230,1399-11-5
426,شتولي,تولي‌پرس‌,930,2714743,84504185909,30661,30100,31274,613,2.0,31128,467,1.52,30048,31274,1399-11-5
427,دتماد,توليدمواداوليه‌داروپخش‌,927,1714913,91889662580,56070,56110,53270,-2800,-4.99,53580,-2490,-4.44,53270,56110,1399-11-5
428,ساراب,سيمان‌ داراب‌,922,11903157,156472193670,12540,13160,13160,620,4.94,13150,610,4.86,12540,13160,1399-11-5
429,خديزل,بهمن  ديزل,908,2350577,101482441651,43663,45842,41480,-2183,-5.0,43173,-490,-1.12,41480,45842,1399-11-5
430,فبيرا,بسته‌ بندي‌ ايران‌,906,12839577,43586130758,3456,3356,3353,-103,-2.98,3395,-61,-1.77,3353,3540,1399-11-5
431,رتكو,كنترل‌خوردگي‌تكين‌كو,905,3730477,72909485320,20220,21190,19210,-1010,-5.0,19540,-680,-3.36,19210,21190,1399-11-5
432,دامين,داروسازي‌ امين‌,899,2572143,42477051240,17110,16540,16260,-850,-4.97,16580,-530,-3.1,16260,17240,1399-11-5
433,دعبيد,لابراتوارداروسازي‌  دكترعبيدي‌,890,1025824,27512103710,27480,28700,26460,-1020,-3.71,27120,-360,-1.31,26110,28700,1399-11-5
434,آينده,بازرگاني آينده سازان بهشت پارس,890,5388766,125453603458,22186,23295,23295,1109,5.0,23281,1095,4.94,22452,23295,1399-11-5
435,دكپسول,توليد ژلاتين كپسول ايران,882,1321863,58771561382,43649,45690,44978,1329,3.04,44461,812,1.86,41950,45831,1399-11-5
436,واتي,سرمايه‌ گذاري‌ آتيه‌ دماوند,879,6329119,69522805830,11400,11830,10830,-570,-5.0,10980,-420,-3.68,10830,11830,1399-11-5
437,داوه,داروسازي آوه سينا,876,2252474,51188005098,23646,22800,22464,-1182,-5.0,22725,-921,-3.89,22464,23490,1399-11-5
438,دتوزيعح,ح . توزيع دارو پخش,876,1273889,46529693129,37449,38000,35577,-1872,-5.0,36526,-923,-2.46,35577,39000,1399-11-5
439,وآرين,شركت توسعه اقتصادي آرين,872,5504280,26608805621,4926,4990,4779,-147,-2.98,4834,-92,-1.87,4779,5040,1399-11-5
440,سدبير,س. تدبيرگران فارس وخوزستان,870,1893912,135895495174,68368,71786,71786,3418,5.0,71754,3386,4.95,69478,71786,1399-11-5
441,زفكاح,ح . كشت و دامداري فكا,863,6932704,65684459264,9780,9958,9291,-489,-5.0,9475,-305,-3.12,9291,9958,1399-11-5
442,شگل,گلتاش‌,862,2161900,56861741690,27030,27790,25870,-1160,-4.29,26300,-730,-2.7,25680,27800,1399-11-5
443,ما,بيمه  ما,858,8675066,71110783150,8440,8260,8020,-420,-4.98,8200,-240,-2.84,8020,8500,1399-11-5
444,كفرآور,فرآورده هاي سيمان شرق,858,2726993,59854419346,21970,22629,21311,-659,-3.0,21949,-21,-0.1,21311,22629,1399-11-5
445,تسه9908,امتياز تسهيلات مسكن آبان99,848,38088,20900361110,545192,525000,545000,-192,-0.04,548739,3547,0.65,525000,560000,1399-11-5
446,تسه9910,امتياز تسهيلات مسكن دي99,839,32724,17987172182,550008,540222,540000,-10008,-1.82,549663,-345,-0.06,530000,569999,1399-11-5
447,شراز,پالايش نفت شيراز,836,423750,42751504003,101174,106232,98699,-2475,-2.45,100938,-236,-0.23,96117,106232,1399-11-5
448,لبوتان,گروه‌صنعتي‌بوتان‌,827,705463,54436482890,79730,77400,75750,-3980,-4.99,77160,-2570,-3.22,75750,82990,1399-11-5
449,طلا,صندوق س.پشتوانه طلاي لوتوس,825,441604,33667676375,74208,75001,75951,1743,2.35,76240,2032,2.74,75001,76800,1399-11-5
450,داروح,ح . كارخانجات‌داروپخش,821,1491795,45999724570,32860,32990,29570,-3290,-10.01,30840,-2020,-6.15,29570,33990,1399-11-5
451,وسنا,سرمايه گذاري نيروگاهي ايران,814,3962976,82027049044,21718,20750,20633,-1085,-5.0,20698,-1020,-4.7,20633,21449,1399-11-5
452,كمينا,شيشه سازي مينا,811,2236437,72854411258,33660,34790,31977,-1683,-5.0,32576,-1084,-3.22,31977,34800,1399-11-5
453,سكرما,سيمان‌ كرمان‌,810,4759783,80736566500,17740,17100,16860,-880,-4.96,16960,-780,-4.4,16860,17700,1399-11-5
454,خمحور,توليدمحورخودرو,805,1310737,74625679260,59630,59540,56570,-3060,-5.13,56930,-2700,-4.53,56570,59540,1399-11-5
455,پخش,پخش البرز,803,1334799,43519860398,33434,34900,31763,-1671,-5.0,32697,-737,-2.2,31763,34900,1399-11-5
456,وتعاون,بيمه  تعاون,801,7298765,53062299767,7583,7356,7204,-379,-5.0,7270,-313,-4.13,7204,7651,1399-11-5
457,دلقما,دارويي‌ لقمان‌,801,2102317,54592168480,26840,26850,25500,-1340,-4.99,25970,-870,-3.24,25500,27860,1399-11-5
458,سپ,پرداخت الكترونيك سامان كيش,801,3259610,60098334400,18900,19450,18250,-650,-3.44,18440,-460,-2.43,17960,19450,1399-11-5
459,شجم,صنايع پتروشيمي تخت جمشيد,798,7217508,87352081622,12319,11981,11950,-369,-3.0,12103,-216,-1.75,11950,12619,1399-11-5
460,دابور,داروسازي‌ ابوريحان‌,797,1224774,47265077640,39900,41000,37930,-1970,-4.94,38620,-1280,-3.21,37910,41000,1399-11-5
461,ثرود,سرمايه‌گذاري مسكن زاينده رود,793,3005413,41039013064,14310,14290,13595,-715,-5.0,13767,-543,-3.79,13595,14290,1399-11-5
462,غمينوح,ح . شركت صنايع غذايي مينو شرق,790,3069474,31977252507,10864,10970,10321,-543,-5.0,10418,-446,-4.11,10321,10970,1399-11-5
463,دروز,داروسازي‌ روزدارو,790,3215398,69837689310,20800,21840,21840,1040,5.0,21720,920,4.42,21100,21840,1399-11-5
464,اعتلا,شركت سرمايه گذاري اعتلاء البرز,788,5089843,45934902694,9365,9200,8897,-468,-5.0,9033,-332,-3.55,8897,9635,1399-11-5
465,چفيبر,فيبر ايران‌,777,5253201,75031607890,14870,14240,14130,-740,-4.98,14280,-590,-3.97,14130,14630,1399-11-5
466,پارند,صندوق س. پارند پايدار سپهر,774,49157666,555543731051,11296,11300,11301,5,0.04,11301,5,0.04,11300,11315,1399-11-5
467,ضخود2007,اختيارخ خودرو-3000-1400/02/08,768,20416,6699110000,343,353,299,-44,-12.83,328,-15,-4.37,294,385,1399-11-5
468,جهرم,پتروشيمي جهرم,765,9602861,21197620658,2244,2192,2177,-67,-2.99,2207,-37,-1.65,2177,2290,1399-11-5
469,فسا,پتروشيمي فسا,762,13414159,27598164677,2087,2140,2025,-62,-2.97,2057,-30,-1.44,2025,2140,1399-11-5
470,شيراز,پتروشيمي‌شيراز,761,2388404,130648597130,53210,55860,52700,-510,-0.96,54700,1490,2.8,50620,55860,1399-11-5
471,دكيمي,كيميدارو,754,979036,25393652320,26630,27890,25300,-1330,-4.99,26270,-360,-1.35,25300,27890,1399-11-5
472,فپنتا,سپنتا,754,122260,54383420990,458520,458600,435600,-22920,-5.0,444820,-13700,-2.99,435600,465000,1399-11-5
473,قهكمت,قندهكمتان‌,747,966428,44224290520,44560,46700,43970,-590,-1.32,45590,1030,2.31,43010,46780,1399-11-5
474,دسبحان,سبحان دارو,747,2625943,53406978840,21050,21180,20000,-1050,-4.99,20340,-710,-3.37,20000,21300,1399-11-5
475,وزمين,بانك ايران زمين,739,9762023,148083350314,15224,15348,14920,-304,-2.0,15169,-55,-0.36,14920,15420,1399-11-5
476,غصينو,صنعتي مينو,723,1879908,156681418031,87673,83290,83290,-4383,-5.0,83345,-4328,-4.94,83290,87000,1399-11-5
477,دلر,داروسازي‌ اكسير,721,1719691,67360632530,39720,41600,38990,-730,-1.84,39170,-550,-1.38,37740,41600,1399-11-5
478,واميد,گروه مديريت سرمايه گذاري اميد,720,2944127,116865799140,40280,40380,38500,-1780,-4.42,39700,-580,-1.44,38270,40500,1399-11-5
479,اوان,مبين وان كيش,716,801271,42187959997,55010,54010,52260,-2750,-5.0,53015,-1995,-3.63,52260,55010,1399-11-5
480,جم پيلن,پلي پروپيلن جم - جم پيلن,713,933148,67657012480,73100,74890,71150,-1950,-2.67,72500,-600,-0.82,70050,75490,1399-11-5
481,دالبر,البرزدارو,707,1806559,37495282310,21560,22590,20490,-1070,-4.96,20950,-610,-2.83,20490,22590,1399-11-5
482,واعتبار,سرمايه گذاري اعتبار ايران,703,5931037,43881113390,7160,7510,7510,350,4.89,7360,200,2.79,6810,7510,1399-11-5
483,كتوكاح,ح.توليدي وخدمات صنايع نسوزتوكا,670,2783479,60995699640,22868,21725,21725,-1143,-5.0,21913,-955,-4.18,21725,22700,1399-11-5
484,وملت,سرمايه گذاري ملت,669,8532554,34780592995,4152,4069,4069,-83,-2.0,4076,-76,-1.83,4069,4184,1399-11-5
485,پارسيان,بيمه پارسيان,664,3244672,36008506280,11320,11880,11050,-270,-2.39,11160,-160,-1.41,10760,11880,1399-11-5
486,قپيرا,فرآورده‌هاي‌غدايي‌وقندپيرانشهر,661,426880,51268181200,117020,122870,120000,2980,2.55,120050,3030,2.59,113000,122870,1399-11-5
487,تابا,تابان نيرو سپاهان,646,1480492,71040587519,46661,48060,48060,1399,3.0,47984,1323,2.84,45600,48060,1399-11-5
488,آرمانح,ح.بيمه آرمان,645,4202924,32038387151,7588,7361,7677,89,1.17,7623,35,0.46,7361,7781,1399-11-5
489,تسه9909,امتياز تسهيلات مسكن آذر99,644,7393,4099596773,549637,528000,541001,-8636,-1.57,554524,4887,0.89,528000,577118,1399-11-5
490,بهپاك,صنعتي بهپاك,640,1445918,63866247682,45647,47650,43365,-2282,-5.0,44170,-1477,-3.24,43365,47650,1399-11-5
491,عيار,صندوق س. پشتوانه طلاي مفيد,609,893125,23840840480,25966,26220,26485,519,2.0,26694,728,2.8,26220,27020,1399-11-5
492,فلات,گروه صنايع معادن فلات ايرانيان,608,3007595,48145740519,16261,16468,15774,-487,-2.99,16008,-253,-1.56,15774,16580,1399-11-5
493,شپاس,نفت پاسارگاد,601,1775875,40348979629,22628,23660,22400,-228,-1.01,22699,71,0.31,21890,23759,1399-11-5
494,غشصفا,شيرپاستوريزه‌پگاه‌اصفهان‌,600,1161819,36550903820,33000,31370,31350,-1650,-5.0,31780,-1220,-3.7,31350,32970,1399-11-5
495,كخاك,صنايع‌خاك‌چيني‌ايران‌,586,1012435,51455824620,51910,52590,49320,-2590,-4.99,50820,-1090,-2.1,49320,54280,1399-11-5
496,ياقوت,صندوق س ياقوت آگاه-ثابت,585,12874173,151925690326,11792,11787,11800,8,0.07,11801,9,0.08,11786,11806,1399-11-5
497,غمهرا,توليدي‌مهرام‌,574,481402,39277423690,77710,81590,81590,3880,4.99,80600,2890,3.72,81230,81590,1399-11-5
498,بمپنا,توليد برق عسلويه  مپنا,574,532477,44092006417,85514,86592,81239,-4275,-5.0,83070,-2444,-2.86,81239,89000,1399-11-5
499,افق ملت,صندوق س در سهام افق ملت,573,411377,53207629280,131120,133500,125100,-6020,-4.59,129340,-1780,-1.36,120650,133780,1399-11-5
500,سرود,سيمان‌شاهرود,568,1674820,28432859590,17470,18150,16600,-870,-4.98,17190,-280,-1.6,16600,18150,1399-11-5
501,شرانل,نفت ايرانول,564,3559841,142073254310,38010,39910,39910,1900,5.0,39910,1900,5.0,39910,39910,1399-11-5
502,پارتا,مجتمع‌صنعتي‌آرتاويل‌تاير,557,1062055,73052694446,70492,72580,68378,-2114,-3.0,68784,-1708,-2.42,68378,72580,1399-11-5
503,زكشت,كشاورزي مكانيزه اصفهان كشت,553,944197,32446879029,35874,35000,34081,-1793,-5.0,34846,-1028,-2.87,34081,35700,1399-11-5
504,دلرح,ح . داروسازي‌ اكسير,549,1206629,40074050400,34150,35150,32200,-1950,-5.71,33210,-940,-2.75,31000,36490,1399-11-5
505,پسهند,صنايع‌ لاستيكي‌  سهند,547,781488,28376701000,37840,38980,35950,-1890,-4.99,36940,-900,-2.38,35950,38980,1399-11-5
506,قنيشا,قند  نيشابور,545,1232988,80057910840,61840,64930,64930,3090,5.0,64930,3090,5.0,64930,64930,1399-11-5
507,قزوين,كارخانجات‌ قند قزوين‌,543,594053,22931537460,39550,40310,38390,-1160,-2.93,39120,-430,-1.09,37580,41410,1399-11-5
508,بفجر,فجر انرژي خليج فارس,541,1665323,42513306260,26200,27220,24890,-1310,-5.0,25770,-430,-1.64,24890,27220,1399-11-5
509,كمرجان,بازرگاني و توليدي مرجان كار,540,733784,76526333360,99324,104290,104290,4966,5.0,104290,4966,5.0,104290,104290,1399-11-5
510,وسكاب,س.ص.بازنشستگي كاركنان بانكها,529,16393226,103277323800,6000,6300,6300,300,5.0,6300,300,5.0,6300,6300,1399-11-5
511,كفرا,فراورده‌ هاي‌ نسوزايران‌,528,738520,39815161090,55910,56620,53120,-2790,-4.99,54220,-1690,-3.02,53120,56730,1399-11-5
512,دارا,صندوق س. دارا الگوريتم-د,523,16038016,159957865576,9966,9980,9966,0,0.0,9974,8,0.08,9946,9991,1399-11-5
513,سكه0012پ01,سكه تمام بهارتحويلي 1روزه رفاه,520,208000,220796583800,1025236,1050000,1068000,42764,4.17,1061522,36286,3.54,1050000,1069500,1399-11-5
514,وپخش,داروپخش‌ (هلدينگ‌,518,183071,20507402800,116360,116070,110550,-5810,-4.99,114520,-1840,-1.58,110550,116700,1399-11-5
515,ساروج,بين المللي ساروج بوشهر,509,2900459,73783784570,24995,25319,25000,5,0.02,25439,444,1.78,24246,25744,1399-11-5
516,شفا,سرمايه گذاري شفادارو,503,751261,34178382570,46940,47950,44600,-2340,-4.99,45920,-1020,-2.17,44600,48500,1399-11-5
517,مارون,پتروشيمي مارون,502,316310,47334559262,151221,148500,148000,-3221,-2.13,150469,-752,-0.5,143660,152900,1399-11-5
518,امين يكم2,صندوق درآمد ثابت امين يكم فردا,500,50000000,50000000,10121,1,1,-10120,-99.99,1,-10120,-99.99,1,1,1399-11-5
519,خراسان,پتروشيمي خراسان,496,440718,28376902620,66030,66510,63100,-2930,-4.44,65080,-950,-1.44,62730,66690,1399-11-5
520,قمرو,قند مرودشت‌,489,1070251,29164752740,28490,28000,27070,-1420,-4.98,27710,-780,-2.74,27070,28200,1399-11-5
521,وسپه,سرمايه‌گذاري‌ سپه‌,487,2866094,21223569180,7810,7420,7350,-460,-5.89,7500,-310,-3.97,7100,7490,1399-11-5
522,ضخود2006,اختيارخ خودرو-2500-1400/02/08,487,17849,9036269000,518,599,480,-38,-7.34,506,-12,-2.32,460,600,1399-11-5
523,شفارا,پتروشيمي فارابي,483,5638701,29149494204,5310,5180,5151,-159,-2.99,5170,-140,-2.64,5151,5323,1399-11-5
524,قشكر,شكرشاهرود,482,17108454,64705726090,4000,3850,3660,-340,-8.5,3780,-220,-5.5,3660,3850,1399-11-5
525,دجابر,داروسازي‌ جابرابن‌حيان‌,478,778820,16529661720,21300,21700,20370,-930,-4.37,21270,-30,-0.14,20250,22150,1399-11-5
526,تكنار,مجتمع معادن مس تكنار,461,499335,77005575824,150775,146300,155298,4523,3.0,154216,3441,2.28,146300,155298,1399-11-5
527,آكورد,صندوق س. آرمان آتي كوثر-د,447,12911577,392822409741,30408,30423,30423,15,0.05,30424,16,0.05,30420,30430,1399-11-5
528,ولتجار,واسپاري تجارت وسرمايه ايرانيان,447,2349074,21432617443,9393,9150,9112,-281,-2.99,9124,-269,-2.86,9112,9329,1399-11-5
529,مفاخر,توسعه فناوري اطلاعات خوارزمي,439,947441,41094514523,44519,46690,43000,-1519,-3.41,43569,-950,-2.13,42294,46690,1399-11-5
530,حخزر,كشتيراني درياي خزر,438,1646783,40933502736,25613,25640,24333,-1280,-5.0,24976,-637,-2.49,24333,26000,1399-11-5
531,زر,صندوق س.پشتوانه سكه طلاي زر,426,612149,27443256256,43510,45000,44425,915,2.1,44831,1321,3.04,44400,45500,1399-11-5
532,ثنام,س ساختماني ب نام آوران مهندسي,420,1754768,31624428896,18970,18022,18022,-948,-5.0,18022,-948,-5.0,18022,18022,1399-11-5
533,درازك,دارويي‌ رازك‌,414,998501,39544281880,40940,41900,38920,-2020,-4.93,39860,-1080,-2.64,38900,42300,1399-11-5
534,دسينا,داروسازي‌ سينا,411,1466553,42504798280,29960,30560,28470,-1490,-4.97,29110,-850,-2.84,28470,30560,1399-11-5
535,شاراك,پتروشيمي شازند,409,3113569,68249432480,20880,21920,21920,1040,4.98,21880,1000,4.79,21920,21920,1399-11-5
536,شصفها,پتروشيمي‌ اصفهان‌,406,460961,58891755037,127854,130411,126837,-1017,-0.8,127759,-95,-0.07,125297,130411,1399-11-5
537,شساخت,مهندسي و ساختمان صنايع نفت,403,2289355,95244742415,41374,42615,40500,-874,-2.11,41603,229,0.55,40133,42615,1399-11-5
538,سايرا,ايرانيت‌,392,1021032,41465013538,42295,40604,41000,-1295,-3.06,40611,-1684,-3.98,40604,41870,1399-11-5
539,گپارس,امور رفاهي كارگزاران پارس,390,150479,27353633306,176623,181921,181921,5298,3.0,181777,5154,2.92,178623,181921,1399-11-5
540,سهگمت,سيمان‌هگمتان‌,377,746958,16737986380,22540,23650,21730,-810,-3.59,22500,-40,-0.18,21550,23650,1399-11-5
541,زپارس,ملي كشت و صنعت و دامپروري پارس,361,406808,48786989590,125290,123000,119030,-6260,-5.0,119930,-5360,-4.28,119030,123300,1399-11-5
542,فنفت,صنايع تجهيزات نفت,359,1619712,39451276778,25001,25270,24251,-750,-3.0,24357,-644,-2.58,24251,25270,1399-11-5
543,ساينا,صنايع بهداشتي ساينا,355,116588,19882931721,178203,177990,169293,-8910,-5.0,174979,-3224,-1.81,169293,177990,1399-11-5
544,ضخود2005,اختيارخ خودرو-2000-1400/02/08,347,11747,10242233000,860,880,820,-40,-4.65,872,12,1.4,801,930,1399-11-5
545,ضسپا1102,اختيارخ خساپا-2000-1399/11/26,334,15132,3978627000,277,310,227,-50,-18.05,263,-14,-5.05,224,310,1399-11-5
546,فيروزا,صندوق بادرآمد ثابت فيروزه آسيا,334,10712394,233657765848,21799,21818,21880,81,0.37,21812,13,0.06,21721,21900,1399-11-5
547,دپارس,پارس‌ دارو,333,162794,13992211160,88190,89750,84400,-3790,-4.3,87540,-650,-0.74,83800,89750,1399-11-5
548,ثفارس,عمران‌وتوسعه‌فارس‌,331,2762573,33786267790,12870,12230,12230,-640,-4.97,12390,-480,-3.73,12230,12230,1399-11-5
549,ثاباد,توريستي ورفاهي آبادگران ايران,322,1180562,61554502680,49660,52140,52140,2480,4.99,52140,2480,4.99,52140,52140,1399-11-5
550,دفرا,فرآورده‌هاي‌ تزريقي‌ ايران‌,318,702256,19571259460,29110,29990,27660,-1450,-4.98,28610,-500,-1.72,27660,29990,1399-11-5
551,حپترو,حمل و نقل پتروشيمي( سهامي عام,306,949131,34242041700,37380,37500,35520,-1860,-4.98,36450,-930,-2.49,35520,38150,1399-11-5
552,كاسپين,داروسازي كاسپين تامين,306,600910,16023671912,27935,27000,26539,-1396,-5.0,27508,-427,-1.53,26539,27500,1399-11-5
553,ثزاگرس,سرمايه گذاري توسعه عمران زاگرس,288,364140,17839382471,50899,51500,48355,-2544,-5.0,49178,-1721,-3.38,48355,51500,1399-11-5
554,هجرتح,ح . پخش هجرت,280,366768,8791118902,24492,23300,23268,-1224,-5.0,23969,-523,-2.14,23268,25100,1399-11-5
555,قاسم,قاسم ايران,273,1491083,22892597299,16161,15353,15353,-808,-5.0,15766,-395,-2.44,15353,15353,1399-11-5
556,تسه9907,امتياز تسهيلات مسكن مهر99,269,4073,2250296433,547661,520278,542350,-5311,-0.97,552491,4830,0.88,520278,574480,1399-11-5
557,شاملا,معدني‌ املاح‌  ايران‌,268,224599,12358708810,57580,55570,54710,-2870,-4.98,56910,-670,-1.16,54710,57300,1399-11-5
558,ثقزوي,شركت عمران و سازندگي قزوين,262,460558,17256647702,38627,37469,37469,-1158,-3.0,37597,-1030,-2.67,37469,37469,1399-11-5
559,لپيام,گسترش صنايع پيام,253,594832,31461259312,51351,52891,52891,1540,3.0,52891,1540,3.0,52891,52891,1399-11-5
560,كدما,معدني‌ دماوند,246,37269,9816281910,277250,263390,263390,-13860,-5.0,274310,-2940,-1.06,263390,263390,1399-11-5
561,غمينو,شركت صنايع غذايي مينو شرق,246,1027709,16866760108,17275,16412,16412,-863,-5.0,16964,-311,-1.8,16412,16412,1399-11-5
562,وثوق,سرمايه گذاري وثوق امين,243,733567,17555725444,23235,23932,23932,697,3.0,23815,580,2.5,23932,23932,1399-11-5
563,سفار,سيمان‌فارس‌,237,205590,27727923300,141960,134870,134870,-7090,-4.99,137620,-4340,-3.06,134870,134870,1399-11-5
564,بنيرو,نيروترانس‌,235,734728,13728891590,19660,18680,18680,-980,-4.98,19380,-280,-1.42,18680,18900,1399-11-5
565,خموتور,موتورسازان‌تراكتورسازي‌ايران‌,233,1990082,47602761440,25170,23920,23920,-1250,-4.97,23920,-1250,-4.97,23920,23920,1399-11-5
566,وتوصا,گروه س توسعه صنعتي ايران,226,1389478,24246391100,18360,17450,17450,-910,-4.96,17830,-530,-2.89,17450,17450,1399-11-5
567,ثتوسا,س.توسعه و عمران استان اردبيل,226,661095,26622956745,41516,40271,40271,-1245,-3.0,40271,-1245,-3.0,40271,40271,1399-11-5
568,گوهر,صندوق سكه طلاي كيان,220,214093,11249385703,51752,53000,52200,448,0.87,52544,792,1.53,52200,53999,1399-11-5
569,دقاضي,داروسازي شهيد قاضي,219,447853,21941171499,50332,50277,49000,-1332,-2.65,48992,-1340,-2.66,48823,50277,1399-11-5
570,كارين,صندوق س نگين سامان-ثابت,205,8717359,87457378158,10025,10027,10026,1,0.01,10033,8,0.08,10025,10070,1399-11-5
571,ضملي1148,اختيارخ فملي-10140-1399/11/05,205,2776,2928270128,959,1100,500,-459,-47.86,535,-424,-44.21,268,1100,1399-11-5
572,تسه9902,امتياز تسهيلات مسكن ارديبهشت99,204,2603,1414302648,544194,517005,560000,15806,2.9,543336,-858,-0.16,517005,560000,1399-11-5
573,سقاين,سيمان‌ قائن‌,204,540414,38153228400,67240,70600,70600,3360,5.0,69630,2390,3.55,70600,70600,1399-11-5
574,زگلدشت,كشت و دام گلدشت نمونه اصفهان,200,372484,21143309292,59750,56763,56763,-2987,-5.0,58412,-1338,-2.24,56763,56763,1399-11-5
575,پلوله,گازلوله‌,199,533862,9873455200,18572,18943,18255,-317,-1.71,18494,-78,-0.42,18201,18943,1399-11-5
576,سدشت,صنايع سيمان دشتستان,199,284872,12607754050,42200,44310,44310,2110,5.0,42680,480,1.14,43000,44310,1399-11-5
577,سكه9912پ04,سكه تمام بهارتحويل1روزه صادرات,198,74000,78636324600,1024226,1051680,1067000,42774,4.18,1062653,38427,3.75,1051680,1069900,1399-11-5
578,ثنور,سرمايه گذاري كوه نور,198,3637988,49189235748,13939,13521,13521,-418,-3.0,13521,-418,-3.0,13521,13521,1399-11-5
579,نتوس,پشم‌ بافي‌ توس,194,792810,14979352140,18344,18894,18894,550,3.0,18733,389,2.12,18894,18894,1399-11-5
580,بذر,صندوق س بذر اميد آفرين-سهام,191,170993,16931098150,100600,101900,96910,-3690,-3.67,99020,-1580,-1.57,95150,104620,1399-11-5
581,تسه9904,امتياز تسهيلات مسكن تير99,182,2098,1147854989,543330,530810,550000,6670,1.23,547119,3789,0.7,530810,570000,1399-11-5
582,چكاوه,صنايع‌كاغذسازي‌كاوه‌,180,1516907,20584427990,12930,13570,13570,640,4.95,13180,250,1.93,13570,13570,1399-11-5
583,افران,صندوق س افرا نماد پايدار-ثابت,180,3817359,47870720950,12538,12550,12538,0,0.0,12540,2,0.02,12530,12550,1399-11-5
584,وتوس,توسعه‌شهري‌توس‌گستر,180,1386980,28197303400,21390,20330,20330,-1060,-4.96,20740,-650,-3.04,20330,20330,1399-11-5
585,تسه9712,امتياز تسهيلات مسكن اسفند97,177,2266,1218434540,537876,512000,535026,-2850,-0.53,537703,-173,-0.03,512000,550000,1399-11-5
586,سپاس,صندوق س. پاداش سهامداري توسعه1,174,5288456,53387445445,10086,10100,10098,12,0.12,10095,9,0.09,10087,10100,1399-11-5
587,تسه9810,امتياز تسهيلات مسكن دي98,171,2380,1288110742,539676,513510,540000,324,0.06,541223,1547,0.29,513510,550000,1399-11-5
588,تسه9802,امتياز تسهيلات مسكن ارديبهشت98,170,1677,915505692,543911,516718,542058,-1853,-0.34,545919,2008,0.37,516718,559994,1399-11-5
589,تسه9906,امتياز تسهيلات مسكن شهريور99,170,1109,610698099,549332,521900,570000,20668,3.76,550675,1343,0.24,521900,576000,1399-11-5
590,ارمغان,ص سرمايه گذاري ارمغان ايرانيان,163,2252273,22821403809,10120,10143,10120,0,0.0,10133,13,0.13,10120,10146,1399-11-5
591,غدشت,دشت‌ مرغاب‌,162,119411,32935942020,262690,275820,275820,13130,5.0,270740,8050,3.06,275820,275820,1399-11-5
592,تسه9905,امتياز تسهيلات مسكن مرداد99,159,2084,1141915618,549590,522212,570000,20410,3.71,547944,-1646,-0.3,522212,570000,1399-11-5
593,ثعتما,س. ساختماني اعتماد گستر,155,489301,33252895960,65981,67960,67960,1979,3.0,67960,1979,3.0,67960,67960,1399-11-5
594,تسه9711,امتياز تسهيلات مسكن بهمن 97,155,2659,1389230443,504416,495222,529636,25220,5.0,522463,18047,3.58,495222,529636,1399-11-5
595,الماس,صندوق س.امين تدبيرگران فردا-س,155,90616,10427831428,117559,120000,112000,-5559,-4.73,115077,-2482,-2.11,110003,121400,1399-11-5
596,فالوم,آلومتك‌,154,675672,26113371456,39843,38648,38648,-1195,-3.0,38648,-1195,-3.0,38648,38648,1399-11-5
597,خفولا,خدمات فني فولاد يزد,153,462866,34090543766,71506,73651,73651,2145,3.0,73651,2145,3.0,73651,73651,1399-11-5
598,تسه9903,امتياز تسهيلات مسكن خرداد99,153,1293,704988713,542520,516005,540000,-2520,-0.46,545235,2715,0.5,516005,565000,1399-11-5
599,تسه9801,امتياز تسهيلات مسكن فروردين98,152,1777,969979370,548002,523550,543510,-4492,-0.82,545852,-2150,-0.39,523550,559998,1399-11-5
600,فافزا,فولاد افزا سپاهان,151,580097,30535725983,51106,52639,52639,1533,3.0,52639,1533,3.0,52639,52639,1399-11-5
601,فن آوا,گروه فن آوا,151,2011465,34327661690,16569,17066,17066,497,3.0,17066,497,3.0,17066,17066,1399-11-5
602,ثروتم,صندوق س. ثروت آفرين پارسيان-س,148,110900,9176770180,81106,83130,81732,626,0.77,82748,1642,2.02,80130,85000,1399-11-5
603,ثاژن,سخت آژند,143,1348366,12705136297,9579,9400,9388,-191,-1.99,9423,-156,-1.63,9388,9587,1399-11-5
604,كويرح,ح. توليدي فولاد سپيد فراب كوير,140,573204,9749876000,17190,18910,17000,-190,-1.11,17010,-180,-1.05,17000,18910,1399-11-5
605,گدنا,تهيه توزيع غذاي دنا آفرين فدك,138,77261,2592956421,35327,33561,33561,-1766,-5.0,35230,-97,-0.27,33561,33561,1399-11-5
606,خاتم,صندوق س خاتم ايساتيس پويا-ثابت,137,3656115,38162542809,10430,10440,10438,8,0.08,10438,8,0.08,10437,10440,1399-11-5
607,شدوص,دوده‌ صنعتي‌ پارس‌,137,440375,12427382500,29700,28220,28220,-1480,-4.98,29290,-410,-1.38,28220,28220,1399-11-5
608,لخانه,لوازم‌ خانگي‌ پارس‌,137,458376,12307395600,26068,26850,26850,782,3.0,26525,457,1.75,26850,26850,1399-11-5
609,سفارود,كارخانه فارسيت درود,136,609824,10099905088,15925,16562,16562,637,4.0,16536,611,3.84,16562,16562,1399-11-5
610,تصميم,صندوق س با درآمد ثابت تصميم,135,996270,15423859265,15469,15477,15485,16,0.1,15482,13,0.08,15477,15485,1399-11-5
611,آساميد,صندوق س.مشترك آسمان اميد -د,134,4558719,52196025153,11424,11447,11448,24,0.21,11450,26,0.23,11440,11459,1399-11-5
612,تسه9812,امتياز تسهيلات مسكن اسفند98,133,1737,950179704,538697,512600,565631,26934,5.0,547023,8326,1.55,512600,565631,1399-11-5
613,تسه9901,امتياز تسهيلات مسكن فروردين99,131,1010,550913033,541695,520000,568779,27084,5.0,545458,3763,0.69,520000,568779,1399-11-5
614,دشيري,شيرين دارو,131,76764,17634456372,218784,229723,229723,10939,5.0,227924,9140,4.18,229723,229723,1399-11-5
615,كيان2,صندوق س. با درآمد ثابت كيان,130,13000000,13000000,26865,1,1,-26864,-100.0,1,-26864,-100.0,1,1,1399-11-5
616,غدام,خوراك‌  دام‌ پارس‌,129,37054,15104692560,429090,407640,407640,-21450,-5.0,422070,-7020,-1.64,407640,407640,1399-11-5
617,كسرام,پارس‌ سرام‌,128,365463,4027402260,11600,11020,11020,-580,-5.0,11550,-50,-0.43,11020,11020,1399-11-5
618,سمايه,بانك سرمايه,126,1095972,7927165476,7456,7233,7233,-223,-2.99,7364,-92,-1.23,7233,7233,1399-11-5
619,سپر,صندوق س سپر سرمايه بيدار- ثابت,119,464868,5218515748,11286,11198,11255,-31,-0.27,11226,-60,-0.53,11198,11298,1399-11-5
620,ضسپا1101,اختيارخ خساپا-1800-1399/11/26,118,4629,1967683000,408,485,400,-8,-1.96,425,17,4.17,301,490,1399-11-5
621,فنرژي,گسترش صنايع انرژي آذرآب,117,980235,16315031340,16004,16644,16644,640,4.0,16644,640,4.0,16644,16644,1399-11-5
622,ضسپا1100,اختيارخ خساپا-1600-1399/11/26,117,3689,2151781000,571,680,500,-71,-12.43,583,12,2.1,480,688,1399-11-5
623,صايند,صندوق س. گنجينه آينده روشن-د,116,2976160,29844282100,10016,10014,10030,14,0.14,10028,12,0.12,10014,10030,1399-11-5
624,آسام,صندوق س.آرمان سپهر آشنا-م,112,84860,9026138750,106979,107900,104800,-2179,-2.04,106365,-614,-0.57,104000,108900,1399-11-5
625,غگرجي,بيسكويت‌  گرجي‌,110,320762,7602059400,24940,23700,23700,-1240,-4.97,24740,-200,-0.8,23700,23700,1399-11-5
626,سنير,سيمان‌ سفيد ني‌ريز,109,110483,23585910840,203320,213480,213480,10160,5.0,207670,4350,2.14,213480,213480,1399-11-5
627,لابسا,آبسال‌,108,229224,12178671120,55920,53130,53130,-2790,-4.99,55190,-730,-1.31,53130,53130,1399-11-5
628,تسه9803,امتياز تسهيلات مسكن خرداد98,107,497,271132949,538067,520000,543000,4933,0.92,545539,7472,1.39,520000,564970,1399-11-5
629,حتوكا,حمل‌ونقل‌توكا,104,464605,17176446850,38910,36970,36970,-1940,-4.99,38190,-720,-1.85,36970,36970,1399-11-5
630,ضصاد1100,اختيارخ وبصادر-2500-1399/11/12,104,3130,717667000,220,223,190,-30,-13.64,229,9,4.09,166,271,1399-11-5
631,دارا2,صندوق س. دارا الگوريتم-د,100,10000000,10000000,9966,1,1,-9965,-99.99,1,-9965,-99.99,1,1,1399-11-5
632,دمعيار,صندوق س. توازن معيار-د,98,3312357,33222659896,10023,10025,10031,8,0.08,10030,7,0.07,10025,10035,1399-11-5
633,تسه9811,امتياز تسهيلات مسكن بهمن98,97,650,354022160,540879,514200,535000,-5879,-1.09,544649,3770,0.7,514200,567000,1399-11-5
634,شتوكا,توكا رنگ فولاد سپاهان,96,59939,3756497008,65970,62672,62672,-3298,-5.0,65709,-261,-0.4,62672,62672,1399-11-5
635,اخزا902,اسنادخزانه-م2بودجه99-011019,94,220229,153256049212,693509,692500,699999,6490,0.94,695894,2385,0.34,692000,699999,1399-11-5
636,ضشنا2000,اختيارخ شپنا-9000-1400/02/27,92,1055,3496189000,3638,4000,3320,-318,-8.74,3314,-324,-8.91,3000,4000,1399-11-5
637,ضپاس2002,اختيارخ وپارس-3000-1400/02/29,92,2808,1634211000,613,650,570,-43,-7.01,582,-31,-5.06,535,650,1399-11-5
638,واحصا,احياء صنايع خراسان,90,109573,6465793157,57291,59009,59009,1718,3.0,57811,520,0.91,59009,59009,1399-11-5
639,شرنگي,شيميايي رنگين,89,110018,16629660772,146752,151154,151154,4402,3.0,150261,3509,2.39,151154,151154,1399-11-5
640,فمراد,آلومراد,89,17792,3303618560,195450,185680,185680,-9770,-5.0,194760,-690,-0.35,185680,185680,1399-11-5
641,اخزا815,اسنادخزانه-م15بودجه98-010406,86,128868,99851536987,775017,773000,777000,1983,0.26,774836,-181,-0.02,771005,778000,1399-11-5
642,تپولا,مهندسي مرآت پولاد,85,121840,4680361760,39602,38414,38414,-1188,-3.0,39307,-295,-0.74,38414,38414,1399-11-5
643,آكورد2,صندوق س. آرمان آتي كوثر-د,80,8000000,8000000,30408,1,1,-30407,-100.0,1,-30407,-100.0,1,1,1399-11-5
644,سكه0011پ02,سكه تمام بهارتحويلي 1روزه ملت,78,16000,17012663400,1025272,1055001,1068500,43228,4.22,1063291,38019,3.71,1053002,1070000,1399-11-5
645,بكاب,صنايع‌جوشكاب‌يزد,77,12864,5531134080,452600,429970,429970,-22630,-5.0,449930,-2670,-0.59,429970,429970,1399-11-5
646,ضصاد1102,اختيارخ وبصادر-3500-1399/11/12,77,3929,11803000,2,5,3,1,50.0,3,1,50.0,2,5,1399-11-5
647,كهرام,توليدي گرانيت بهسرام,74,94458,8172789534,84003,86523,86523,2520,3.0,84989,986,1.17,86523,86523,1399-11-5
648,اخزا903,اسنادخزانه-م3بودجه99-011110,74,124860,85786389878,686211,683000,689267,3056,0.45,687061,850,0.12,682000,690000,1399-11-5
649,تشتاد,صنايع توليدي اشتاد ايران‌,72,254504,4358126496,17653,17124,17124,-529,-3.0,17530,-123,-0.7,17124,17124,1399-11-5
650,سكارون,سيمان كارون,72,43155,9062679465,216497,210003,210003,-6494,-3.0,213370,-3127,-1.44,210003,210003,1399-11-5
651,ضخود2013,اختيارخ خودرو-7000-1400/02/08,65,3550,122651000,40,48,33,-7,-17.5,35,-5,-12.5,30,49,1399-11-5
652,وثخوز,سرمايه گذاري و توسعه خوزستان,65,189987,12240482436,67818,64428,64428,-3390,-5.0,65634,-2184,-3.22,64428,64428,1399-11-5
653,ضجار2002,اختيارخ وتجارت-2500-1400/02/22,64,1764,1255703000,767,780,700,-67,-8.74,712,-55,-7.17,601,785,1399-11-5
654,ضصاد1101,اختيارخ وبصادر-3000-1399/11/12,64,2765,79150000,38,40,25,-13,-34.21,29,-9,-23.68,20,41,1399-11-5
655,ضملي1156,اختيارخ فملي-9126-1399/11/05,63,2346,7733000800,1855,1901,1710,-145,-7.82,1672,-183,-9.87,1267,2000,1399-11-5
656,تسه9809,امتياز تسهيلات مسكن آذر98,62,388,208447127,539884,530000,542000,2116,0.39,537235,-2649,-0.49,513115,554900,1399-11-5
657,گنجين,صندوق س. گنجينه يكم آويد-د,61,1533810,18519567903,12092,12100,12100,8,0.07,12074,-18,-0.15,12000,12100,1399-11-5
658,ضخود2008,اختيارخ خودرو-3500-1400/02/08,61,1542,345633000,270,250,208,-62,-22.96,224,-46,-17.04,207,270,1399-11-5
659,ضفلا1156,اختيارخ فولاد-16000-1399/11/28,61,3120,215734000,73,180,60,-13,-17.81,69,-4,-5.48,36,180,1399-11-5
660,ضفلا1151,اختيارخ فولاد-8000-1399/11/28,60,1827,6676524000,3497,3850,3200,-297,-8.49,3654,157,4.49,3000,3890,1399-11-5
661,ثپرديس,سرمايه گذاري مسكن پرديس,60,394336,4660657184,12441,11819,11819,-622,-5.0,12379,-62,-0.5,11819,11819,1399-11-5
662,ضپاس2001,اختيارخ وپارس-2500-1400/02/29,57,1423,1264907000,917,930,830,-87,-9.49,889,-28,-3.05,799,940,1399-11-5
663,زعف0008پ16,زعفران0008نگين بيرجند(پ),57,45520,5668800500,124857,124000,124800,-57,-0.05,124534,-323,-0.26,124000,125000,1399-11-5
664,صنوين,صندوق سرمايه‌گذاري صنوين-مختلط,55,72199,7148844180,99700,102500,99990,290,0.29,99020,-680,-0.68,98500,102500,1399-11-5
665,وجامي,سرمايه گذاري جامي,54,370998,5478527466,14337,14767,14767,430,3.0,14449,112,0.78,14767,14767,1399-11-5
666,زعف0008پ11,زعفران0008نگين سحرخيز(پ),53,31630,3970484620,125240,125100,126000,760,0.61,125529,289,0.23,124110,126000,1399-11-5
667,تسه9808,امتياز تسهيلات مسكن آبان98,51,257,137949483,538529,512550,534000,-4529,-0.84,536768,-1761,-0.33,512550,550000,1399-11-5
668,داراب,پتروشيمي داراب,51,785771,1917281240,2515,2440,2440,-75,-2.98,2508,-7,-0.28,2440,2440,1399-11-5
669,كساپا,سايپاشيشه‌,51,129753,5103185490,41390,39330,39330,-2060,-4.98,41170,-220,-0.53,39330,39330,1399-11-5
670,تسه9807,امتياز تسهيلات مسكن مهر98,50,371,203587488,544149,517001,540000,-4149,-0.76,548753,4604,0.85,517000,571356,1399-11-5
671,سكه0112پ03,سكه تمام بهارتحويلي1روزه سامان,49,12700,13497064700,1024818,1057000,1066051,41233,4.02,1062761,37943,3.7,1057000,1069999,1399-11-5
672,تسه9806,امتياز تسهيلات مسكن شهريور98,47,426,229524016,548416,521000,529000,-19416,-3.54,538789,-9627,-1.76,520996,549990,1399-11-5
673,ضشنا2002,اختيارخ شپنا-12000-1400/02/27,45,403,826929000,2149,2200,1950,-199,-9.26,2052,-97,-4.51,1800,2300,1399-11-5
674,ضملت1128,اختيارخ وبملت-6000-1399/11/28,43,1780,20297000,13,20,2,-11,-84.62,11,-2,-15.38,1,21,1399-11-5
675,كصدف,كاشي صدف سرام استقلال آباده,42,478724,13112250360,26593,27390,27390,797,3.0,27097,504,1.9,27390,27390,1399-11-5
676,ومشان,س. فني و مهندسي مشانير,41,26782,2057875316,79214,76838,76838,-2376,-3.0,78960,-254,-0.32,76838,76838,1399-11-5
677,ضفلا1153,اختيارخ فولاد-10000-1399/11/28,41,970,1855408000,1857,2300,1614,-243,-13.09,1913,56,3.02,1200,2300,1399-11-5
678,زعف0008پ05,زعفران0008نگين زرين(پ),40,32700,4089548106,125146,124310,125000,-146,-0.12,125063,-83,-0.07,124310,125400,1399-11-5
679,هبركت912,اختيارف ت بركت-22100-99/12/17,39,203941,197414888,1923,968,968,-955,-49.66,968,-955,-49.66,968,968,1399-11-5
680,اخزا901,اسنادخزانه-م1بودجه99-010621,38,28175,20828138919,738775,738501,739000,225,0.03,739242,467,0.06,738500,740800,1399-11-5
681,ضشنا2001,اختيارخ شپنا-10000-1400/02/27,38,443,1200716000,2861,3001,2700,-161,-5.63,2710,-151,-5.28,2200,3001,1399-11-5
682,وسرمد,بيمه  سرمد,37,181390,1296394330,7368,7147,7147,-221,-3.0,7353,-15,-0.2,7147,7147,1399-11-5
683,اخزا808,اسنادخزانه-م8بودجه98-000817,36,11951,10399330058,870216,870000,871500,1284,0.15,870164,-52,-0.01,868000,871500,1399-11-5
684,اراد64,مرابحه عام دولتي64-ش.خ0111,36,7100000,6699063000000,1000000,943530,943530,-56470,-5.65,943530,-56470,-5.65,943530,943530,1399-11-5
685,تسه9805,امتياز تسهيلات مسكن مرداد98,36,153,81926849,528571,503640,535000,6429,1.22,535470,6899,1.31,503640,554999,1399-11-5
686,دقاضيح,ح . داروسازي شهيد قاضي,35,25617,1056447594,42515,41241,41240,-1275,-3.0,41240,-1275,-3.0,41240,41241,1399-11-5
687,قلرست,قند لرستان‌,35,77767,2532871190,34280,32570,32570,-1710,-4.99,34190,-90,-0.26,32570,32570,1399-11-5
688,داريك,صندوق س.اعتماد داريك-د,35,55423,577710592,10308,10399,10445,137,1.33,10424,116,1.13,10399,10445,1399-11-5
689,وايرا,سرمايه گذاري صنايع ايران,34,530217,6914029680,13443,13040,13040,-403,-3.0,13299,-144,-1.07,13040,13040,1399-11-5
690,ضفلا1155,اختيارخ فولاد-14000-1399/11/28,34,1420,316090000,253,280,200,-53,-20.95,223,-30,-11.86,150,280,1399-11-5
691,تسه9804,امتياز تسهيلات مسكن تير98,33,149,80397663,533827,520000,540000,6173,1.16,539582,5755,1.08,520000,548000,1399-11-5
692,اخزا814,اسنادخزانه-م14بودجه98-010318,33,134273,104976045804,784182,779000,785000,818,0.1,781811,-2371,-0.3,766723,789000,1399-11-5
693,اوصتا,صندوق انديشه ورزان صباتامين -د,33,479903,8506651709,17717,17739,17728,11,0.06,17726,9,0.05,17725,17739,1399-11-5
694,دحاوي,الحاوي,32,101333,1203633374,12503,11878,11878,-625,-5.0,12463,-40,-0.32,11878,11878,1399-11-5
695,اخزا909,اسنادخزانه-م9بودجه99-020316,32,174594,110633604242,632076,632001,636000,3924,0.62,633662,1586,0.25,632000,636000,1399-11-5
696,اخزا908,اسنادخزانه-م8بودجه99-020606,32,105086,63694053417,605529,606000,606000,471,0.08,606114,585,0.1,605500,609000,1399-11-5
697,ضسپا1104,اختيارخ خساپا-3000-1399/11/26,31,988,20766000,43,35,20,-23,-53.49,21,-22,-51.16,5,35,1399-11-5
698,اخزا907,اسنادخزانه-م7بودجه99-020704,31,130132,77565786713,594648,593510,596001,1353,0.23,596055,1407,0.24,593000,597999,1399-11-5
699,ضسپا1106,اختيارخ خساپا-4000-1399/11/26,29,1455,2305000,3,2,1,-2,-66.67,2,-1,-33.33,1,3,1399-11-5
700,حرهشا,رهشاد سپاهان (سهامي عام,29,23231,1498190421,65807,64491,64491,-1316,-2.0,65605,-202,-0.31,64491,64491,1399-11-5
701,زعف0008پ18,زعفران0008نگين بهرامن(پ),28,8158,1020075060,124995,125500,125397,402,0.32,125040,45,0.04,124800,126000,1399-11-5
702,ضغدر1119,اختيارخ وغدير-10000-1399/11/26,28,258,405553000,1763,2100,1500,-263,-14.92,1572,-191,-10.83,800,2100,1399-11-5
703,اخزا809,اسنادخزانه-م9بودجه98-000923,28,36852,31521669353,859412,849109,857998,-1414,-0.16,855358,-4054,-0.47,849109,857998,1399-11-5
704,اخزا818,اسنادخزانه-م18بودجه98-010614,28,19384,14553164119,751824,751999,750505,-1319,-0.18,750782,-1042,-0.14,750453,752000,1399-11-5
705,اخزا813,اسنادخزانه-م13بودجه98-010219,27,60108,47553046915,792920,791000,793500,580,0.07,791127,-1793,-0.23,789000,793500,1399-11-5
706,اخزا905,اسنادخزانه-م5بودجه99-020218,27,124277,79963573182,641601,642001,644001,2400,0.37,643430,1829,0.29,642000,644001,1399-11-5
707,وآتوس,س.آرين توسكا قيمت اسمي 350ريال,26,12499,589002876,48581,47124,47124,-1457,-3.0,48536,-45,-0.09,47124,47124,1399-11-5
708,زعف0008پ10,زعفران0008نگين طلاي سرخ(پ),26,15978,2021354670,127051,126522,125570,-1481,-1.17,126509,-542,-0.43,125540,127400,1399-11-5
709,اخزا806,اسنادخزانه-م6بودجه98-000519,26,32909,29838474861,905922,903604,906600,678,0.07,906696,774,0.09,903604,908000,1399-11-5
710,اطلس2,صندوق س.توسعه اندوخته آينده-س,25,250000,250000,209671,1,1,-209670,-100.0,1,-209670,-100.0,1,1,1399-11-5
711,عيار2,صندوق س. پشتوانه طلاي مفيد,25,250000,250000,25966,1,1,-25965,-100.0,1,-25965,-100.0,1,1,1399-11-5
712,ضخود2009,اختيارخ خودرو-4000-1400/02/08,25,819,142647000,190,210,140,-50,-26.32,174,-16,-8.42,140,210,1399-11-5
713,اخزا820,اسنادخزانه-م20بودجه98-020806,25,114808,68415765985,595478,590100,598999,3521,0.59,595915,437,0.07,590100,599900,1399-11-5
714,اخزا821,اسنادخزانه-م21بودجه98-020906,24,6334,3779909138,611353,590800,592009,-19344,-3.16,596765,-14588,-2.39,590800,600000,1399-11-5
715,ولراز,ليزينگ رازي,24,17831,919509008,53162,51568,51568,-1594,-3.0,53086,-76,-0.14,51568,51568,1399-11-5
716,ضملت1127,اختيارخ وبملت-5000-1399/11/28,24,551,48840000,353,195,80,-273,-77.34,89,-264,-74.79,80,195,1399-11-5
717,اخزا811,اسنادخزانه-م11بودجه98-001013,24,151343,127903086003,844068,844901,845506,1438,0.17,845121,1053,0.12,844901,846000,1399-11-5
718,تملي705,تسهيلات مسكن ب. ملي-مرداد97,24,298,143083870,491359,515926,515926,24567,5.0,480147,-11212,-2.28,466792,515926,1399-11-5
719,اخزا817,اسنادخزانه-م17بودجه98-010512,23,29122,22197302608,761547,758003,766000,4453,0.58,762218,671,0.09,758003,766000,1399-11-5
720,رطب0002پ01,رطب مضافتي0002افشارتعاون بم(پ),22,2081,400357067,201871,191778,210000,8129,4.03,192387,-9484,-4.7,191778,210000,1399-11-5
721,كابگن,توليدي و صنعتي آبگينه‌,22,64220,331439420,5060,5161,5161,101,2.0,5067,7,0.14,5161,5161,1399-11-5
722,ضملت1126,اختيارخ وبملت-4500-1399/11/28,22,611,159711000,246,300,23,-223,-90.65,261,15,6.1,23,300,1399-11-5
723,اخزا716,اسنادخزانه-م16بودجه97-000407,21,12897,11956140930,928615,926490,928590,-25,0.0,927048,-1567,-0.17,926490,928614,1399-11-5
724,ضسپا1103,اختيارخ خساپا-2500-1399/11/26,21,730,60184000,144,149,69,-75,-52.08,82,-62,-43.06,62,149,1399-11-5
725,ضترا3002,اختيارخ شتران-8000-1400/03/09,21,656,1442650000,1907,2100,2200,293,15.36,2199,292,15.31,2100,2380,1399-11-5
726,ضجار2003,اختيارخ وتجارت-3000-1400/02/22,21,1129,625354000,561,600,550,-11,-1.96,554,-7,-1.25,529,600,1399-11-5
727,ضصاد3001,اختيارخ وبصادر-2000-1400/03/12,20,548,499169000,1000,910,881,-119,-11.9,911,-89,-8.9,860,1050,1399-11-5
728,اخزا904,اسنادخزانه-م4بودجه99-011215,19,21987,14895125413,678988,675000,681000,2012,0.3,677451,-1537,-0.23,675000,681000,1399-11-5
729,سخند,صندوق س.سپهرخبرگان نفت-د,19,37560,379516840,10097,10110,10099,2,0.02,10104,7,0.07,10099,10110,1399-11-5
730,غگز,گز سكه,17,780000,17160000000,22000,22000,22000,0,0.0,22000,0,0.0,22000,22000,1399-11-5
731,نگين,ص.س. زمين و ساختمان نگين شهرري,13,2453,118582930,48200,48900,47570,-630,-1.31,48340,140,0.29,47550,48900,1399-11-5
732,تصميم2,صندوق س با درآمد ثابت تصميم,13,13000000,13000000,15469,1,1,-15468,-99.99,1,-15468,-99.99,1,1,1399-11-5
733,وسكرد,شركت س استان كردستان,13,162471,121853250,780,750,750,-30,-3.85,780,0,0.0,750,750,1399-11-5
734,اراد50,مرابحه عام دولت5-ش.خ0302,13,270000,270000140000,1000000,1000000,1000000,0,0.0,1000000,0,0.0,1000000,1000001,1399-11-5
735,اخزا723,اسنادخزانه-م23بودجه97-000824,12,8546,7370990544,861222,864000,861016,-206,-0.02,862508,1286,0.15,861016,864000,1399-11-5
736,ياقوت2,صندوق س ياقوت آگاه-ثابت,12,48610628,48610628,11792,1,1,-11791,-99.99,1,-11791,-99.99,1,1,1399-11-5
737,ضسپا1105,اختيارخ خساپا-3500-1399/11/26,12,1013,3046000,5,5,3,-2,-40.0,3,-2,-40.0,2,5,1399-11-5
738,پست0008پ09,پسته بادامي30-28مه ولات0008(پ),11,178,229824752,1317650,1251768,1290000,-27650,-2.1,1291150,-26500,-2.01,1251768,1335000,1399-11-5
739,زعف0008پ08,زعفران0008نگين روستا(پ),11,6800,850294500,124956,124600,125499,543,0.43,125043,87,0.07,124600,125901,1399-11-5
740,ضفلا1154,اختيارخ فولاد-12000-1399/11/28,11,104,83047000,866,1700,818,-48,-5.54,799,-67,-7.74,600,1700,1399-11-5
741,ضجار2001,اختيارخ وتجارت-2000-1400/02/22,11,254,259011000,1100,1100,1000,-100,-9.09,1020,-80,-7.27,1000,1100,1399-11-5
742,تملي803,تسهيلات مسكن ب. ملي-خرداد98,10,353,284438619,808179,767771,767771,-40408,-5.0,805775,-2404,-0.3,767771,848587,1399-11-5
743,ضملي1155,اختيارخ فملي-8111-1399/11/05,10,119,601755800,2951,2615,2500,-451,-15.28,2564,-387,-13.11,2098,2615,1399-11-5
744,اخزا812,اسنادخزانه-م12بودجه98-001111,10,7722,6443132112,833813,831002,836999,3186,0.38,834386,573,0.07,831002,836999,1399-11-5
745,ضپار1115,اختيارخ خپارس-5000-1399/11/19,10,62,76843000,1450,1500,1048,-402,-27.72,1239,-211,-14.55,1048,1500,1399-11-5
746,وسيزد,شركت س استان يزد,10,58964,71936080,1280,1220,1220,-60,-4.69,1280,0,0.0,1220,1220,1399-11-5
747,شستا991,اجاره تامين اجتماعي-امين991226,9,110,109018505,1008964,1007964,990074,-18890,-1.87,991077,-17887,-1.77,990000,1007964,1399-11-5
748,تملي707,تسهيلات مسكن ب. ملي-مهر97,9,106,107833588,1070840,1017298,1017298,-53542,-5.0,1017298,-53542,-5.0,1017298,1017298,1399-11-5
749,انرژي1,نهادهاي مالي بورس انرژي,9,1276,466569400,384890,365650,365650,-19240,-5.0,384790,-100,-0.03,365650,365650,1399-11-5
750,ضفار1121,اختيارخ فارس-9826-1399/11/07,9,82,29800000,1984,200,200,-1784,-89.92,182,-1802,-90.83,50,200,1399-11-5
751,قنقش,قند نقش جهان,9,2884,209170752,74008,72528,72528,-1480,-2.0,73976,-32,-0.04,72528,72528,1399-11-5
752,ضخود2011,اختيارخ خودرو-5000-1400/02/08,8,571,58205000,107,110,99,-8,-7.48,102,-5,-4.67,99,110,1399-11-5
753,وسلرستا,شركت س استان لرستان,8,217921,187412060,900,860,860,-40,-4.44,900,0,0.0,860,860,1399-11-5
754,ضچاد2004,اختيارخ كچاد-20000-1400/02/05,7,23,55800000,3547,3000,1900,-1647,-46.43,2426,-1121,-31.6,1900,3000,1399-11-5
755,وساشرقي,شركت س استان آذربايجان شرقي,7,41258,39195100,990,950,950,-40,-4.04,990,0,0.0,950,950,1399-11-5
756,ضمخا7070,اختيارخ اخابر-20000-1400/07/28,7,39,114140000,3006,2900,2100,-906,-30.14,2927,-79,-2.63,2100,3000,1399-11-5
757,زعف0008پ19,زعفران0008نگين تروند قاينات(پ),7,20226,2549041758,10000,131953,126010,116010,1160.1,126028,116028,1160.28,125670,131953,1399-11-5
758,ضترا1117,اختيارخ شتران-10000-1399/11/14,7,151,41768000,400,500,201,-199,-49.75,277,-123,-30.75,201,500,1399-11-5
759,ضخود2010,اختيارخ خودرو-4500-1400/02/08,7,122,17035000,159,140,133,-26,-16.35,140,-19,-11.95,133,141,1399-11-5
760,وسيستا,شركت س استان سيستان وبلوچستان,6,58227,44252520,790,760,760,-30,-3.8,790,0,0.0,760,760,1399-11-5
761,اخزا722,اسنادخزانه-م22بودجه97-000428,6,10614,9742689258,910420,908000,916001,5581,0.61,917909,7489,0.82,907002,921000,1399-11-5
762,زعف0008پ09,زعفران0008نگين نوين(پ),6,9239,1150531100,124054,124103,125000,946,0.76,124530,476,0.38,124103,125000,1399-11-5
763,ضملي3002,اختيارخ فملي-10000-1400/03/02,6,44,112200000,2430,3050,1820,-610,-25.1,2550,120,4.94,1800,3100,1399-11-5
764,اخزا721,اسنادخزانه-م21بودجه97-000728,6,5949,5211324340,877170,876000,876000,-1170,-0.13,876000,-1170,-0.13,876000,876001,1399-11-5
765,دسبحاح,ح .گروه دارويي سبحان,6,74500,1218950000,17160,16700,16300,-860,-5.01,16360,-800,-4.66,16300,16700,1399-11-5
766,ضملت1129,اختيارخ وبملت-7000-1399/11/28,6,103,226000,15,5,10,-5,-33.33,2,-13,-86.67,2,10,1399-11-5
767,ضترا1118,اختيارخ شتران-12000-1399/11/14,6,180,750000,20,2,4,-16,-80.0,4,-16,-80.0,2,5,1399-11-5
768,آگاس2,صندوق س.هستي بخش آگاه-س,6,900000,900000,71056,1,1,-71055,-100.0,1,-71055,-100.0,1,1,1399-11-5
769,وسگيلا,شركت س استان گيلان,6,76740,60624600,830,790,790,-40,-4.82,830,0,0.0,790,790,1399-11-5
770,كرونا2,تامين مالي جمعي صرفا اهداي سود,5,1168,11680000,10000,10000,10000,0,0.0,10000,0,0.0,10000,10000,1399-11-5
771,ضمخا7066,اختيارخ اخابر-12000-1400/07/28,5,6,25400000,5000,4000,4500,-500,-10.0,4233,-767,-15.34,4000,4500,1399-11-5
772,اخزا816,اسنادخزانه-م16بودجه98-010503,5,30577,23479187000,767860,767000,768000,140,0.02,767871,11,0.0,767000,768000,1399-11-5
773,اخزا807,اسنادخزانه-م7بودجه98-000719,5,2765,2432874460,880325,880000,880800,475,0.05,879882,-443,-0.05,876501,880800,1399-11-5
774,كشم0001پ01,كشمش سبز0001خليل آباد(پ),5,84,48176856,546223,573534,573534,27311,5.0,573534,27311,5.0,573534,573534,1399-11-5
775,پست0008پ08,پسته فندقي32-30مه ولات0008(پ),4,50,66560000,1352800,1338000,1340000,-12800,-0.95,1331200,-21600,-1.6,1300000,1340000,1399-11-5
776,وسخراج,شركت س استان خراسان جنوبي,4,26768,56480480,2220,2110,2110,-110,-4.95,2220,0,0.0,2110,2110,1399-11-5
777,وسمازن,س.سهام عدالت استان مازندران,4,22314,20975160,980,940,940,-40,-4.08,980,0,0.0,940,940,1399-11-5
778,وسهمدا,شركت س استان همدان,4,25517,21689450,890,850,850,-40,-4.49,890,0,0.0,850,850,1399-11-5
779,ضفلا1157,اختيارخ فولاد-18000-1399/11/28,4,316,3840000,20,40,10,-10,-50.0,12,-8,-40.0,9,40,1399-11-5
780,ضفلا1158,اختيارخ فولاد-20000-1399/11/28,4,250,2950000,44,12,11,-33,-75.0,12,-32,-72.73,11,12,1399-11-5
781,اخزا804,اسنادخزانه-م4بودجه98-000421,4,3800,3496012000,917303,921000,920000,2697,0.29,920003,2700,0.29,920000,921000,1399-11-5
782,اخزا810,اسنادخزانه-م10بودجه98-001006,4,31301,26554267301,850021,848500,849000,-1021,-0.12,848352,-1669,-0.2,848001,849000,1399-11-5
783,آوا2,صندوق س.سهام آواي معيار-س,4,25000000,25000000,8471,1,1,-8470,-99.99,1,-8470,-99.99,1,1,1399-11-5
784,وسيلام,شركت س استان ايلام,4,31198,36813640,1240,1180,1180,-60,-4.84,1240,0,0.0,1180,1180,1399-11-5
785,ضسان2008,اختيارخ پارسان-16750-00/02/15,4,31,154800000,4300,5000,4800,500,11.63,4994,694,16.14,4800,5000,1399-11-5
786,كمند2,صندوق س. با درآمد ثابت كمند,4,350000000,350000000,10106,1,1,-10105,-99.99,1,-10105,-99.99,1,1,1399-11-5
787,اجاد22,اجاره دولتي آپرورش-لوتوس991118,3,1108,1106921108,1005920,990001,1000001,-5919,-0.59,999026,-6894,-0.69,990001,1000001,1399-11-5
788,تملي708,تسهيلات مسكن ب. ملي-آبان97,3,53,35599782,707046,671694,671694,-35352,-5.0,671694,-35352,-5.0,671694,671694,1399-11-5
789,ضگل1142,اختيارخ كگل-16000-1399/11/21,3,51,137600000,2500,2700,2600,100,4.0,2698,198,7.92,2600,2700,1399-11-5
790,ونچر,ص.ج.فيروزه10%تاديه,3,3000,380003000,130000,130000,125001,-4999,-3.85,126668,-3332,-2.56,125001,130000,1399-11-5
791,ضچاد2003,اختيارخ كچاد-18000-1400/02/05,3,71,330099000,4600,4649,4650,50,1.09,4649,49,1.07,4649,4650,1399-11-5
792,تملي701,تسهيلات مسكن ب. ملي-فروردين97,3,33,21146608,643606,658900,611426,-32180,-5.0,640806,-2800,-0.44,611426,658900,1399-11-5
793,ضفار1122,اختيارخ فارس-11826-1399/11/07,3,21,60000,6,10,1,-5,-83.33,1,-5,-83.33,1,10,1399-11-5
794,هصيكو402,اختيارف ت تاصيكو13500-00/02/20,3,10181,35144812,3413,3452,3452,39,1.14,3452,39,1.14,3452,3452,1399-11-5
795,مشهد14122,مشاركت ش مشهد1412-3ماهه18%,3,1290000,1296400000000,1000000,1032000,1000000,0,0.0,1004961,4961,0.5,1000000,1032000,1399-11-5
796,رطب0002پ02,رطب مضافتي0002اتحاديه كرمان(پ),3,111,21792008,201871,191778,211964,10093,5.0,196324,-5547,-2.75,191778,211964,1399-11-5
797,وسزنجان,شركت س استان زنجان,3,19000,25650000,1420,1350,1350,-70,-4.93,1420,0,0.0,1350,1350,1399-11-5
798,اخزا720,اسنادخزانه-م20بودجه97-000324,3,349,325291000,932892,932000,933000,108,0.01,932066,-826,-0.09,932000,933000,1399-11-5
799,خعمرا,توسعه و عمران شهرستان نائين,3,4675,105126725,21833,22487,22487,654,3.0,21836,3,0.01,22487,22487,1399-11-5
800,شستا994,اجاره تامين اجتماعي-نوين991226,3,87,87608913,1006999,1006999,1006999,0,0.0,1006999,0,0.0,1006999,1006999,1399-11-5
801,زعف0008پ15,زعفران0008پوشالمعمول طلاسرخ(پ),2,155,12815500,82815,83000,82100,-715,-0.86,82681,-134,-0.16,82100,83000,1399-11-5
802,ضفار1120,اختيارخ فارس-8826-1399/11/07,2,2,3004000,1940,901,601,-1339,-69.02,751,-1189,-61.29,601,901,1399-11-5
803,شرق1400,مشاركت ليزينگ ايران وشرق140010,2,14,14140000,999900,1010000,1010000,10100,1.01,1010000,10100,1.01,1010000,1010000,1399-11-5
804,ضپاس2003,اختيارخ وپارس-3500-1400/02/29,2,29,18850000,360,650,650,290,80.56,650,290,80.56,650,650,1399-11-5
805,اراد664,مرابحه عام دولت66-ش.خ0310,2,10000000,10000000000000,1000000,1000000,1000000,0,0.0,1000000,0,0.0,1000000,1000000,1399-11-5
806,غنيلي,مجتمع توليدي نيلي صنعت كرمان,2,29000,501700000,17010,17300,17300,290,1.7,17300,290,1.7,17300,17300,1399-11-5
807,سلامت4,مرابحه دولتي تعاون-لوتوس991118,2,2000,2000000000,1002000,1000000,1000000,-2000,-0.2,1000000,-2000,-0.2,1000000,1000000,1399-11-5
808,ضملت1125,اختيارخ وبملت-4000-1399/11/28,2,51,6340000,414,790,111,-303,-73.19,124,-290,-70.05,111,790,1399-11-5
809,ضبدر1159,اختيارخ شبندر-16000-1399/11/19,2,10,61812000,6166,6850,6014,-152,-2.47,6181,15,0.24,6014,6850,1399-11-5
810,زعف0008پ12,زعفران0008پوشالمعمول سحرخيز(پ),2,200,17000000,83995,86000,84000,5,0.01,85000,1005,1.2,84000,86000,1399-11-5
811,ضغدر1121,اختيارخ وغدير-14000-1399/11/26,2,50,12500000,366,250,250,-116,-31.69,250,-116,-31.69,250,250,1399-11-5
812,صبا1401,اجاره مهندسي صبا نفت14010225,2,415,394250000,950000,950000,950000,0,0.0,950000,0,0.0,950000,950000,1399-11-5
813,كايتا,ايتالران‌,2,4060,38801420,9279,9557,9557,278,3.0,9280,1,0.01,9557,9557,1399-11-5
814,وسبوشهر,شركت س استان بوشهر,2,78890,94668000,1260,1200,1200,-60,-4.76,1260,0,0.0,1200,1200,1399-11-5
815,هاباد912,اختيارف ت آبادا-30100-99/12/12,2,9000,122463000,12715,13607,13607,892,7.02,13607,892,7.02,13607,13607,1399-11-5
816,اراد35,مرابحه عام دولت3-ش.خ 0103,2,12000,11460000000,954292,955000,955000,708,0.07,955000,708,0.07,955000,955000,1399-11-5
817,ضغدر1126,اختيارخ وغدير-6000-1399/11/26,2,2,10100000,5339,5300,4800,-539,-10.1,5050,-289,-5.41,4800,5300,1399-11-5
818,شستا993,اجاره ت.اجتماعي-كاردان991226,2,30,30020000,994000,1000000,1004000,10000,1.01,1000667,6667,0.67,1000000,1004000,1399-11-5
819,سپرمي,پرميت‌,2,15900,135372600,8430,8514,8514,84,1.0,8432,2,0.02,8514,8514,1399-11-5
820,زير0003پ01,زيره سبز0003كيميابذر(پ),2,20,9387012,509167,470001,468375,-40792,-8.01,469351,-39816,-7.82,468375,470001,1399-11-5
821,سلامت3,مرابحه دولتي تعاون-اميد991118,2,2861,2875305000,1005000,1005000,1005000,0,0.0,1005000,0,0.0,1005000,1005000,1399-11-5
822,ساذري,آذريت‌,2,753,4601583,5820,6111,6111,291,5.0,5820,0,0.0,6111,6111,1399-11-5
823,ضفار3000,اختيارخ فارس-8000-1400/03/05,2,2,7700000,2807,3700,4000,1193,42.5,3850,1043,37.16,3700,4000,1399-11-5
824,وسقم,شركت س استان قم,2,7735,10364900,1410,1340,1340,-70,-4.96,1410,0,0.0,1340,1340,1399-11-5
825,ضملي3004,اختيارخ فملي-14000-1400/03/02,2,2,1306000,1300,666,640,-660,-50.77,653,-647,-49.77,640,666,1399-11-5
826,تملي805,تسهيلات مسكن ب. ملي-مرداد98,2,43,28378624,628541,659968,659968,31427,5.0,659968,31427,5.0,659968,659968,1399-11-5
827,صخود412,ص مرابحه خودرو412- 3ماهه 18%,2,39,38562020,989900,980001,998000,8100,0.82,988770,-1130,-0.11,980001,998000,1399-11-5
828,هترول911,اختيارف ت پترول-14730-99/11/15,2,1120,5964000,5072,5325,5325,253,4.99,5325,253,4.99,5325,5325,1399-11-5
829,اخزا718,اسنادخزانه-م18بودجه97-000525,1,1000,905500000,905000,905500,905500,500,0.06,905500,500,0.06,905500,905500,1399-11-5
830,ضگل1141,اختيارخ كگل-14000-1399/11/21,1,1,3800000,3988,3800,3800,-188,-4.71,3800,-188,-4.71,3800,3800,1399-11-5
831,ضجار2000,اختيارخ وتجارت-1800-1400/02/22,1,1,1300000,1250,1300,1300,50,4.0,1300,50,4.0,1300,1300,1399-11-5
832,اراد504,مرابحه عام دولت5-ش.خ0302,1,1820000,1820000000000,1000000,1000000,1000000,0,0.0,1000000,0,0.0,1000000,1000000,1399-11-5
833,ضملت1124,اختيارخ وبملت-3500-1399/11/28,1,1,352000,814,352,352,-462,-56.76,352,-462,-56.76,352,352,1399-11-5
834,صگل1411,ص اجاره گل گهر 1411-3 ماهه 17%,1,5,4790000,960000,958000,958000,-2000,-0.21,958000,-2000,-0.21,958000,958000,1399-11-5
835,ضملي1154,اختيارخ فملي-24336-1399/11/05,1,1,1972,1,1,1,0,0.0,1,0,0.0,1,1,1399-11-5
836,ضگل1144,اختيارخ كگل-20000-1399/11/21,1,1,514000,997,514,514,-483,-48.45,514,-483,-48.45,514,514,1399-11-5
837,اخزا713,اسنادخزانه-م13بودجه97-000518,1,90,81329850,903994,903665,903665,-329,-0.04,903665,-329,-0.04,903665,903665,1399-11-5
838,صايپا012,صكوك مرابحه سايپا012-3ماهه 16%,1,12,12000012,1000001,1000001,1000001,0,0.0,1000001,0,0.0,1000001,1000001,1399-11-5
839,اجاد24,اجاره دولتي آپرورش-نوين991118,1,500,505000000,1000000,1010000,1010000,10000,1.0,1010000,10000,1.0,1010000,1010000,1399-11-5
840,وسكرشا,س.سهام عدالت استان كرمانشاه,1,4566,5479200,1260,1200,1200,-60,-4.76,1260,0,0.0,1200,1200,1399-11-5
841,اراد65,مرابحه عام دولتي65-ش.خ0210,1,3800,3517394000,925360,925630,925630,270,0.03,925630,270,0.03,925630,925630,1399-11-5
842,غديس2,پاكديس,1,11650000,141291200000,11551,12128,12128,577,5.0,12128,577,5.0,12128,12128,1399-11-5
843,افران2,صندوق س افرا نماد پايدار-ثابت,1,600000,600000,12538,1,1,-12537,-99.99,1,-12537,-99.99,1,1,1399-11-5
844,ضملت1123,اختيارخ وبملت-3000-1399/11/28,1,1,851000,1111,851,851,-260,-23.4,851,-260,-23.4,851,851,1399-11-5
845,كرمان02,مرابحه كرمان موتور14020306,1,2000,1980000000,1000000,990000,990000,-10000,-1.0,990000,-10000,-1.0,990000,990000,1399-11-5
846,ضبدر1149,اختيارخ شبندر-28000-1399/11/19,1,8,704000,205,88,88,-117,-57.07,88,-117,-57.07,88,88,1399-11-5
847,فولاد2,فولاد مباركه اصفهان,1,50000000,560500000000,11210,11210,11210,0,0.0,11210,0,0.0,11210,11210,1399-11-5
848,ضپيك2010,اختيارخ تاپيكو-12000-00/02/19,1,5,10000000,2313,2000,2000,-313,-13.53,2000,-313,-13.53,2000,2000,1399-11-5
849,ضگل1143,اختيارخ كگل-18000-1399/11/21,1,11,16500000,3500,1500,1500,-2000,-57.14,1500,-2000,-57.14,1500,1500,1399-11-5
850,صخود0004,صكوك رهني خودرو0004- 3ماهه 16%,1,7,6790000,970000,970000,970000,0,0.0,970000,0,0.0,970000,970000,1399-11-5
851,ضصاد1103,اختيارخ وبصادر-4000-1399/11/12,1,10,10000,1,1,1,0,0.0,1,0,0.0,1,1,1399-11-5
852,اخزا9072,اسنادخزانه-م7بودجه99-020704,1,129562,77089390000,594648,595000,595000,352,0.06,595000,352,0.06,595000,595000,1399-11-5
853,كرمان022,مرابحه كرمان موتور14020306,1,143000,141570000000,1000000,990000,990000,-10000,-1.0,990000,-10000,-1.0,990000,990000,1399-11-5
854,ضچاد2002,اختيارخ كچاد-16000-1400/02/05,1,20,80000000,5800,4000,4000,-1800,-31.03,4000,-1800,-31.03,4000,4000,1399-11-5
855,ضفار1123,اختيارخ فارس-13826-1399/11/07,1,10,20000,1,1,1,0,0.0,1,0,0.0,1,1,1399-11-5
856,ضمخا7071,اختيارخ اخابر-24000-1400/07/28,1,1,999000,900,999,999,99,11.0,999,99,11.0,999,999,1399-11-5
857,واعتبار4,سرمايه گذاري اعتبار ايران,1,8000000,58880000000,7160,7360,7360,200,2.79,7360,200,2.79,7360,7360,1399-11-5
858,ضخوز2012,اختيارخ فخوز-10000-1400/02/15,1,2,9002000,2963,4501,4501,1538,51.91,4501,1538,51.91,4501,4501,1399-11-5
859,گواهي ظرفيت,گواهي ظرفيت نقدي,1,4860000,51705540000,10639,10639,10639,0,0.0,10639,0,0.0,10639,10639,1399-11-5
860,اراد364,مرابحه عام دولت3-ش.خ 0104,1,5000000,4740500000000,980000,948100,948100,-31900,-3.26,948100,-31900,-3.26,948100,948100,1399-11-5
861,ضملي3003,اختيارخ فملي-12000-1400/03/02,1,10,11110000,2000,1111,1111,-889,-44.45,1111,-889,-44.45,1111,1111,1399-11-5
862,ضبدر1160,اختيارخ شبندر-18000-1399/11/19,1,5,19750000,3823,3950,3950,127,3.32,3950,127,3.32,3950,3950,1399-11-5
863,ضفار1124,اختيارخ فارس-15826-1399/11/07,1,1,4000,2,2,2,0,0.0,2,0,0.0,2,2,1399-11-5
864,زير0003پ04,زيره سبز0003شركت مينوبذر(پ),1,500,234187500,490000,468375,468375,-21625,-4.41,468375,-21625,-4.41,468375,468375,1399-11-5
865,ضصاد3000,اختيارخ وبصادر-1800-1400/03/12,1,10,11000000,1053,1100,1100,47,4.46,1100,47,4.46,1100,1100,1399-11-5
866,اخزا9032,اسنادخزانه-م3بودجه99-011110,1,693063,478560001500,686211,690500,690500,4289,0.63,690500,4289,0.63,690500,690500,1399-11-5
867,ونيكي2,سرمايه‌گذاري‌ ملي‌ايران‌,1,6000000,79560000000,13690,13260,13260,-430,-3.14,13260,-430,-3.14,13260,13260,1399-11-5
868,ضجار2005,اختيارخ وتجارت-4000-1400/02/22,1,100,24000000,239,240,240,1,0.42,240,1,0.42,240,240,1399-11-5
869,زير0003پ02,زيره سبز0003 دانش(پ),1,11,5152125,500000,468375,468375,-31625,-6.33,468375,-31625,-6.33,468375,468375,1399-11-5
870,ارمغان2,ص سرمايه گذاري ارمغان ايرانيان,1,29612081,29612081,10120,1,1,-10119,-99.99,1,-10119,-99.99,1,1,1399-11-5
871,ضپاس2000,اختيارخ وپارس-2000-1400/02/29,1,10,15000000,1600,1500,1500,-100,-6.25,1500,-100,-6.25,1500,1500,1399-11-5
