,نماد,نام,تعداد,حجم,ارزش,دیروز,اولین,آخرین معامله - مقدار,آخرین معامله - تغییر,آخرین معامله - درصد,قیمت پایانی - مقدار,قیمت پایانی - تغییر,قیمت پایانی - درصد,کمترین,بیشترین,تاریخ
0,چخزر,صنايع چوب خزر كاسپين,4445627,29999925,749998125000,1000,25000,25000,24000,2400.0,25000,24000,2400.0,25000,25000,1399-9-12
1,پالايش,صندوق پالايشي يکم-سهام,412852,80278011,8522905676340,113740,110260,103560,-10180,-8.95,106170,-7570,-6.66,102530,110260,1399-9-12
2,شستا,سرمايه گذاري تامين اجتماعي,118749,263163399,7712930468700,29610,29120,28780,-830,-2.8,29310,-300,-1.01,28300,30480,1399-9-12
3,وتجارت,بانك تجارت,74706,1904476250,7430148719720,4010,3920,3840,-170,-4.24,3900,-110,-2.74,3810,4070,1399-9-12
4,خودرو,ايران‌ خودرو,74616,1571232108,6264354462440,4080,4020,3920,-160,-3.92,3990,-90,-2.21,3880,4150,1399-9-12
5,وسپهر,سرمايه گذاري مالي سپهرصادرات,72461,196625834,2365227249085,11695,12250,11877,182,1.56,12029,334,2.86,11761,12250,1399-9-12
6,دارا يكم,صندوق واسطه گري مالي يكم-سهام,66071,28863733,5804312472650,207410,203100,195750,-11660,-5.62,201090,-6320,-3.05,195010,206010,1399-9-12
7,شپنا,پالايش نفت اصفهان,64252,305776079,5718682643510,19110,19200,18160,-950,-4.97,18700,-410,-2.15,18160,19490,1399-9-12
8,خگستر,گسترش‌سرمايه‌گذاري‌ايران‌خودرو,52102,1264149209,5556002704890,4210,4270,4420,210,4.99,4400,190,4.51,4250,4420,1399-9-12
9,بپيوند,برق و انرژي پيوندگستر پارس,48822,35413363,960858461468,27332,26390,26550,-782,-2.86,27133,-199,-0.73,26100,28000,1399-9-12
10,فولاد,فولاد مباركه اصفهان,44263,188800494,2704206494560,14420,14500,14050,-370,-2.57,14320,-100,-0.69,13830,14750,1399-9-12
11,شتران,پالايش نفت تهران,40781,168377283,2485798972060,15140,15320,14390,-750,-4.95,14760,-380,-2.51,14390,15770,1399-9-12
12,ثاميد,توسعه و عمران اميد,40563,194304426,447503346540,2310,2300,2280,-30,-1.3,2300,-10,-0.43,2250,2380,1399-9-12
13,دي,بانك دي,40224,80529549,4180701057672,50717,49990,53252,2535,5.0,51915,1198,2.36,48502,53252,1399-9-12
14,ولپارس,ليزينگ پارسيان,39177,142332042,928191890860,6290,6370,6600,310,4.93,6520,230,3.66,6350,6600,1399-9-12
15,وبصادر,بانك صادرات ايران,38786,924064389,3326337295960,3730,3620,3560,-170,-4.56,3600,-130,-3.49,3550,3720,1399-9-12
16,آبادا,توليد نيروي برق آبادان,38323,17889652,351642586080,18820,19050,19760,940,4.99,19660,840,4.46,18850,19760,1399-9-12
17,تليسه,دامداري تليسه نمونه,37425,401257577,3512616113320,9140,8683,8740,-400,-4.38,8754,-386,-4.22,8683,9100,1399-9-12
18,زملارد,كشاورزي و دامپروري ملارد شير,36439,2632210,110705297958,41662,41100,41840,178,0.43,42058,396,0.95,39760,42830,1399-9-12
19,امين,تامين سرمايه امين,35806,41455184,516779101190,12610,12200,12630,20,0.16,12470,-140,-1.11,12100,12740,1399-9-12
20,سيتا,سرمايه گذاري سيمان تامين,35456,42345466,740786400890,17650,17400,17290,-360,-2.04,17490,-160,-0.91,17100,17900,1399-9-12
21,گدنا,تهيه توزيع غذاي دنا آفرين فدك,35115,5066896,136072118515,25743,26700,27030,1287,5.0,26855,1112,4.32,25743,27030,1399-9-12
22,شبندر,پالايش نفت بندرعباس,34791,99731928,3011262585620,30900,31300,29360,-1540,-4.98,30190,-710,-2.3,29360,31470,1399-9-12
23,شاروم,پتروشيمي اروميه,33115,10914487,243249178205,21342,22000,22406,1064,4.99,22287,945,4.43,21500,22409,1399-9-12
24,غزر,صنعتي زر ماكارون,32884,6315196,348116764510,54730,53100,55800,1070,1.96,55120,390,0.71,53100,55990,1399-9-12
25,خزاميا,زامياد,32762,252708012,3802539276390,14500,15100,14780,280,1.93,15050,550,3.79,14100,15220,1399-9-12
26,پيزد,مجتمع صنايع لاستيك يزد,31334,3056513,265180772392,86329,85000,87130,801,0.93,86759,430,0.5,83862,89500,1399-9-12
27,ثبهساز,بهساز كاشانه تهران,30207,122220804,343030350580,2820,2800,2780,-40,-1.42,2810,-10,-0.35,2760,2880,1399-9-12
28,حكشتي,كشتيراني جمهوري اسلامي ايران,29941,97962452,3047379499260,29890,29300,31380,1490,4.98,31110,1220,4.08,28720,31380,1399-9-12
29,ذوب,سهامي ذوب آهن  اصفهان,29643,374826164,2082930729905,5391,5500,5517,126,2.34,5557,166,3.08,5390,5660,1399-9-12
30,صباح,ح . سرمايه گذاري صبا تامين,29174,109457139,702256916959,6549,6410,6465,-84,-1.28,6416,-133,-2.03,6250,6648,1399-9-12
31,تاپيكو,س. نفت و گاز و پتروشيمي تأمين,28053,241031453,4080502947770,16250,17060,16700,450,2.77,16930,680,4.18,16300,17060,1399-9-12
32,وپارس,بانك‌پارسيان‌,26446,889278720,3952513462790,4260,4470,4370,110,2.58,4440,180,4.23,4300,4470,1399-9-12
33,شگويا,پتروشيمي تندگويان,26199,113163737,1493667763539,12940,13102,12990,50,0.39,13199,259,2.0,12680,13587,1399-9-12
34,وبملت,بانك ملت,26037,410133005,2288700077900,5760,5630,5480,-280,-4.86,5580,-180,-3.13,5480,5800,1399-9-12
35,وپويا,سرمايه گذاري پويا,24682,34917175,314080727615,9211,9000,8802,-409,-4.44,8995,-216,-2.35,8781,9350,1399-9-12
36,پترول,گروه پتروشيمي س. ايرانيان,23232,114519838,1583488361110,14100,14110,13460,-640,-4.54,13830,-270,-1.91,13450,14300,1399-9-12
37,آريا,پليمر آريا ساسول,20620,3145845,577904623545,182960,182510,182100,-860,-0.47,183704,744,0.41,178000,186497,1399-9-12
38,رافزا,رايان هم افزا,20427,119902,4428820174,35179,36937,36937,1758,5.0,35325,146,0.42,36937,36937,1399-9-12
39,فارس,صنايع پتروشيمي خليج فارس,16567,63409095,882634032250,13900,13890,13970,70,0.5,13920,20,0.14,13550,14150,1399-9-12
40,شبريز,پالايش نفت تبريز,16396,39668929,1273315547560,32130,32650,31000,-1130,-3.52,32100,-30,-0.09,30710,33500,1399-9-12
41,سمايه,بانك سرمايه,16348,112775855,1015226413218,8829,8680,8889,60,0.68,9002,173,1.96,8610,9093,1399-9-12
42,ثشاهد,سرمايه‌ گذاري‌ شاهد,16216,50650914,1261991366490,26060,24810,24760,-1300,-4.99,24920,-1140,-4.37,24760,25750,1399-9-12
43,خمحركه,نيرو محركه‌,15570,116433515,862276261700,7410,7200,7180,-230,-3.1,7410,0,0.0,7110,7760,1399-9-12
44,بركت,گروه دارويي بركت,15498,46643153,837282045820,18180,17800,17580,-600,-3.3,17950,-230,-1.27,17460,18650,1399-9-12
45,ثغرب,شركت سرمايه گذاري مسكن شمالغرب,14385,92398840,1083894107437,11539,11071,12115,576,4.99,11731,192,1.66,10963,12115,1399-9-12
46,خكمك,كمك‌فنرايندامين‌,13639,19854527,1012830482490,50610,51600,49640,-970,-1.92,51010,400,0.79,48080,52900,1399-9-12
47,زدشت,كشت و صنعت دشت خرم دره,13584,29343097,1466848782834,46692,44000,51361,4669,10.0,49990,3298,7.06,44000,51361,1399-9-12
48,لكما,كارخانجات‌مخابراتي‌ايران‌,13561,67281693,645465027532,9690,9900,9400,-290,-2.99,9593,-97,-1.0,9400,9970,1399-9-12
49,قنيشا,قند  نيشابور,12760,16962988,1209108295260,68530,68700,70300,1770,2.58,71280,2750,4.01,68520,71950,1399-9-12
50,وخارزم,سرمايه گذاري خوارزمي,12380,100519693,1067922106760,10180,10300,10680,500,4.91,10620,440,4.32,10180,10680,1399-9-12
51,صبا,سرمايه گذاري صبا تامين,12120,38694476,367271813414,9417,9390,9528,111,1.18,9492,75,0.8,9040,9760,1399-9-12
52,ساوه,سيمان ساوه,11759,9581079,576532798052,59468,62441,58800,-668,-1.12,60174,706,1.19,56495,62441,1399-9-12
53,اخابر,مخابرات ايران,11628,111675485,1807009926300,15510,15510,16270,760,4.9,16180,670,4.32,15060,16280,1399-9-12
54,بجهرم,توسعه مولد نيروگاهي جهرم,11451,113309523,485986813533,4417,4360,4220,-197,-4.46,4289,-128,-2.9,4197,4470,1399-9-12
55,بكهنوج,توليد برق ماهتاب كهنوج,11276,237941091,834651338650,3391,3400,3401,10,0.29,3508,117,3.45,3392,3560,1399-9-12
56,خپارس,پارس‌ خودرو,11067,99365760,764636789600,7790,7650,7620,-170,-2.18,7700,-90,-1.16,7430,7980,1399-9-12
57,كرمان,س. توسعه و عمران استان كرمان,10596,21959021,1815748950423,79486,79500,83460,3974,5.0,82688,3202,4.03,76320,83460,1399-9-12
58,وساپا,سرمايه‌گذاري‌ سايپا,10476,102277274,988151760100,9650,9400,9670,20,0.21,9660,10,0.1,9250,10030,1399-9-12
59,ختوقا,قطعات‌ اتومبيل‌ ايران‌,10206,263364431,1057044063470,3830,4020,4020,190,4.96,4010,180,4.7,3910,4020,1399-9-12
60,بكام,كارخانجات توليدي شهيد قندي,10081,116311005,594258563160,4920,4970,5160,240,4.88,5110,190,3.86,4720,5160,1399-9-12
61,غگل,گلوكوزان‌,10048,82908775,403645194730,5040,4900,4790,-250,-4.96,4870,-170,-3.37,4790,5010,1399-9-12
62,ونوين,بانك‌اقتصادنوين‌,10046,191741334,1063695321480,5490,5370,5480,-10,-0.18,5550,60,1.09,5320,5760,1399-9-12
63,قصفها,قنداصفهان‌,9789,3826238,822158637750,210340,191360,220890,10550,5.02,214870,4530,2.15,191360,227000,1399-9-12
64,كفپارس,فرآورده‌هاي‌ نسوز پارس‌,9683,74595540,625138231280,8770,8370,8340,-430,-4.9,8380,-390,-4.45,8340,8700,1399-9-12
65,ومعادن,توسعه‌معادن‌وفلزات‌,9387,46930691,695655575990,15180,15000,14510,-670,-4.41,14820,-360,-2.37,14430,15350,1399-9-12
66,وملي,گروه‌ صنعتي‌ ملي‌ (هلدينگ‌,9182,4039896,1313601038490,341770,324690,324690,-17080,-5.0,325160,-16610,-4.86,324690,334450,1399-9-12
67,گكوثر,هتل پارسيان كوثر اصفهان,9158,5660504,933092271837,168692,163000,170000,1308,0.78,164843,-3849,-2.28,157295,172500,1399-9-12
68,زبينا,كشاورزي و دامپروري بينالود,9104,17781633,1050161123889,61684,58600,58600,-3084,-5.0,59059,-2625,-4.26,58600,60900,1399-9-12
69,وشهر,بانك شهر,8813,122432170,1010568885984,8145,8145,8399,254,3.12,8254,109,1.34,7930,8470,1399-9-12
70,فاراك,ماشين‌ سازي‌ اراك‌,8772,87171391,705885816240,7920,7800,8000,80,1.01,8100,180,2.27,7550,8310,1399-9-12
71,زقيام,كشت و دام قيام اصفهان,8707,23968657,942607534292,40997,38948,39698,-1299,-3.17,39327,-1670,-4.07,38948,40800,1399-9-12
72,حفاري,حفاري شمال,8563,139333623,2044826035940,14010,14050,14710,700,5.0,14680,670,4.78,14000,14710,1399-9-12
73,حسينا,توسعه خدمات دريايي وبندري سينا,8311,11186199,940592494948,86800,91600,80400,-6400,-7.37,84085,-2715,-3.13,78500,95480,1399-9-12
74,پتاير,ايران‌ تاير,8222,4280051,740448457080,166580,167400,171500,4920,2.95,173000,6420,3.85,167400,178500,1399-9-12
75,سبزوا,سيمان لار سبزوار,8203,64618693,405104603440,6475,6301,6152,-323,-4.99,6269,-206,-3.18,6152,6580,1399-9-12
76,چكاپا,گروه صنايع كاغذ پارس,8144,64128503,450556438680,7000,6840,6970,-30,-0.43,7030,30,0.43,6680,7250,1399-9-12
77,زشگزا,شير و گوشت زاگرس شهركرد,8101,6648200,1069512898179,168914,160469,160469,-8445,-5.0,160873,-8041,-4.76,160469,163624,1399-9-12
78,غگيلا,شيرپاستوريزه پگاه گيلان,8093,122415,2190004350,17039,17890,17890,851,4.99,17074,35,0.21,17890,17890,1399-9-12
79,فرابورس,فرابورس ايران,7843,10506313,570710979390,54728,54795,53100,-1628,-2.97,54321,-407,-0.74,52900,56000,1399-9-12
80,خبهمن,گروه‌بهمن‌,7820,37768322,1061608830240,27990,28250,28000,10,0.04,28110,120,0.43,27000,28900,1399-9-12
81,تملت,تامين سرمايه بانك ملت,7590,43528004,408718391390,9350,9600,9380,30,0.32,9390,40,0.43,9020,9690,1399-9-12
82,شيران,س. صنايع‌شيميايي‌ايران,7393,29640437,1098469997290,35370,37110,37130,1760,4.98,37060,1690,4.78,36050,37130,1399-9-12
83,ونيرو,سرمايه‌گذاري‌نيرو,7331,156184203,698357561010,4290,4250,4500,210,4.9,4470,180,4.2,4200,4500,1399-9-12
84,كحافظ,كاشي‌ وسراميك‌ حافظ‌,7305,27532119,550422180890,19250,18550,20210,960,4.99,19990,740,3.84,18550,20210,1399-9-12
85,فخوز,فولاد  خوزستان,7207,15917534,618392903600,38730,38990,38700,-30,-0.08,38850,120,0.31,37100,40190,1399-9-12
86,غنوش,نوش‌ مازندران‌,6853,10758457,755747172920,67730,68500,71000,3270,4.83,70250,2520,3.72,67720,71110,1399-9-12
87,دماوند,توليد نيروي برق دماوند,6850,7048684,559555180944,79529,80050,77300,-2229,-2.8,79384,-145,-0.18,76060,81482,1399-9-12
88,ودي,بيمه  دي,6779,22789895,639685844680,27429,27429,27900,471,1.72,28069,640,2.33,26500,28800,1399-9-12
89,شغدير,پتروشيمي غدير,6759,14290845,893474306933,63643,63000,64000,357,0.56,62521,-1122,-1.76,61090,64460,1399-9-12
90,ولساپا,ليزينگ رايان‌ سايپا,6484,127530930,586562496040,4400,4400,4620,220,5.0,4600,200,4.55,4290,4620,1399-9-12
91,كالا,بورس كالاي ايران,6134,10760138,460317427360,41220,41500,42210,990,2.4,42780,1560,3.78,40000,43280,1399-9-12
92,لپارس,پارس‌ الكتريك‌,6106,2791986,417433717910,156880,149100,149040,-7840,-5.0,149510,-7370,-4.7,149040,156000,1399-9-12
93,كاوه,فولاد كاوه جنوب كيش,6038,34191915,722364424690,20450,20310,20900,450,2.2,21130,680,3.33,20080,21470,1399-9-12
94,زمگسا,كشاورزي‌ ودامپروي‌ مگسال‌,5928,13350852,562664691450,39830,38000,43810,3980,9.99,42140,2310,5.8,36700,43810,1399-9-12
95,وپست,پست بانك ايران,5908,66445546,1185970431530,17030,17300,17880,850,4.99,17850,820,4.82,17200,17880,1399-9-12
96,كسعدي,كاشي‌ سعدي‌,5751,10816527,381484149670,36680,35350,34900,-1780,-4.85,35270,-1410,-3.84,34850,37070,1399-9-12
97,فاذر,صنايع‌ آذرآب‌,5639,14344464,503560677440,33490,34950,35160,1670,4.99,35100,1610,4.81,33490,35160,1399-9-12
98,وپاسار,بانك  پاسارگاد,5637,89301739,1045623742370,11670,11680,11710,40,0.34,11710,40,0.34,11670,11750,1399-9-12
99,غشهداب,كشت و صنعت شهداب ناب خراسان,5586,57497719,255974793790,4575,4430,4400,-175,-3.83,4452,-123,-2.69,4347,4650,1399-9-12
100,خرينگ,رينگ‌سازي‌مشهد,5556,7064848,435183620700,59140,62090,62090,2950,4.99,61600,2460,4.16,59250,62090,1399-9-12
101,ثاخت,بين‌المللي‌توسعه‌ساختمان,5386,64943074,263280020940,4060,4000,3960,-100,-2.46,4050,-10,-0.25,3920,4150,1399-9-12
102,فنوال,نورد آلومينيوم‌,5254,13921585,436314098650,32780,31150,31150,-1630,-4.97,31340,-1440,-4.39,31150,32480,1399-9-12
103,تپمپي,پمپ‌ سازي‌ ايران‌,5100,10718228,358694864350,34630,34300,32920,-1710,-4.94,33470,-1160,-3.35,32900,35950,1399-9-12
104,وسديد,گروه ‌صنعتي‌سديد,5040,17886800,355748872479,20448,19835,19835,-613,-3.0,19889,-559,-2.73,19835,20495,1399-9-12
105,ثنام,س ساختماني ب نام آوران مهندسي,5038,19436339,390448025927,20243,19700,20170,-73,-0.36,20089,-154,-0.76,19636,20830,1399-9-12
106,غدام,خوراك‌  دام‌ پارس‌,5031,2053425,588215233810,297510,282640,282640,-14870,-5.0,286460,-11050,-3.71,282640,297510,1399-9-12
107,فسرب,ملي‌ سرب‌وروي‌ ايران‌,4981,2672757,391028297970,140590,143000,146600,6010,4.27,146300,5710,4.06,140000,147610,1399-9-12
108,خاذين,سايپاآذين‌,4947,63562523,398065129950,6010,6000,6310,300,4.99,6260,250,4.16,5890,6310,1399-9-12
109,وصنعت,سرمايه گذاري توسعه صنعت وتجارت,4898,29189069,269171096970,9040,9200,9190,150,1.66,9220,180,1.99,8900,9430,1399-9-12
110,تبرك,گروه كارخانجات صنعتي تبرك,4867,9136986,228675935964,25351,25550,24150,-1201,-4.74,25028,-323,-1.27,24130,25890,1399-9-12
111,كگل,معدني و صنعتي گل گهر,4833,12719329,254183248600,20460,20170,19560,-900,-4.4,19980,-480,-2.35,19540,20750,1399-9-12
112,وتوس,توسعه‌شهري‌توس‌گستر,4765,11836234,323501567900,27670,27700,26500,-1170,-4.23,27330,-340,-1.23,26290,28550,1399-9-12
113,ثنظام,س. ساختماني نظام مهندسي ايران,4732,10198915,413816696862,41948,39851,40400,-1548,-3.69,40575,-1373,-3.27,39851,41930,1399-9-12
114,خمهر,مهركام‌پارس‌,4703,53054297,395524216610,7770,7900,7390,-380,-4.89,7460,-310,-3.99,7390,7900,1399-9-12
115,ختور,رادياتور ايران‌,4690,7725658,298033105340,38130,38000,38200,70,0.18,38580,450,1.18,37050,39600,1399-9-12
116,ثقزوي,شركت عمران و سازندگي قزوين,4666,15340821,395687840153,25070,25800,25500,430,1.72,25793,723,2.88,25210,25822,1399-9-12
117,كچاد,معدني‌وصنعتي‌چادرملو,4559,17082652,354116153950,20990,20990,20250,-740,-3.53,20730,-260,-1.24,20140,21490,1399-9-12
118,خريخت,صنايع‌ريخته‌گري‌ايران‌,4495,67838840,278965085300,4240,4120,4070,-170,-4.01,4110,-130,-3.07,4030,4370,1399-9-12
119,غبهنوش,بهنوش‌ ايران‌,4472,6358525,538497021780,84370,84000,81010,-3360,-3.98,84690,320,0.38,77710,92790,1399-9-12
120,نوين,بيمه نوين,4409,27931816,235769472721,8419,8500,8240,-179,-2.13,8441,22,0.26,8150,8800,1399-9-12
121,وتوصا,گروه س توسعه صنعتي ايران,4382,35076408,516076993920,14140,14400,14840,700,4.95,14710,570,4.03,13700,14840,1399-9-12
122,ماديرا,صنايع ماشين هاي اداري ايران,4360,9045225,267174023062,29892,29580,29200,-692,-2.32,29538,-354,-1.18,28399,30676,1399-9-12
123,شكلر,نيروكلر,4323,6450944,389642779510,58070,59990,59520,1450,2.5,60400,2330,4.01,58490,60970,1399-9-12
124,كرازي,كارخانجات‌توليدي‌شيشه‌رازي‌,4308,11959606,262948448880,21220,21800,22280,1060,5.0,21990,770,3.63,21220,22280,1399-9-12
125,غپينو,پارس‌ مينو,4250,36950886,285376689330,7400,7480,7770,370,5.0,7720,320,4.32,7400,7770,1399-9-12
126,آگاس,صندوق س.هستي بخش آگاه-س,4202,3977006,297360520970,75876,74430,73570,-2306,-3.04,74770,-1106,-1.46,73159,76190,1399-9-12
127,خشرق,الكتريك‌ خودرو شرق‌,4182,17240682,342550012770,20800,19770,19760,-1040,-5.0,19870,-930,-4.47,19760,20650,1399-9-12
128,فولاي,صنايع فولاد آلياژي يزد,4172,6205811,226503200089,35848,35480,35620,-228,-0.64,36499,651,1.82,34790,37588,1399-9-12
129,كگاز,شيشه‌ و گاز,4142,10585320,269912698290,24420,25000,25640,1220,5.0,25500,1080,4.42,24420,25640,1399-9-12
130,كمند,صندوق س. با درآمد ثابت كمند,4081,193341726,1963135907907,10143,10152,10155,12,0.12,10154,11,0.11,10150,10159,1399-9-12
131,غسالم,سالمين‌,4029,28668947,138521250090,4910,4800,4730,-180,-3.67,4830,-80,-1.63,4700,5010,1399-9-12
132,زكوثر,سرمايه گذاري كشاورزي كوثر,4016,13527289,321843250440,22910,22500,24050,1140,4.98,23790,880,3.84,22500,24050,1399-9-12
133,پلاسك,پلاسكوكار,3851,32361874,270719219820,8050,8050,8450,400,4.97,8370,320,3.98,7750,8450,1399-9-12
134,وسين,بيمه سينا,3850,20116292,534247068114,26787,27300,25780,-1007,-3.76,26558,-229,-0.85,25448,28126,1399-9-12
135,وساخت,سرمايه‌ گذاري‌ ساختمان‌ايران‌,3825,4292730,312530440380,71420,71300,71830,410,0.57,72800,1380,1.93,69000,74180,1399-9-12
136,ثنوسا,نوسازي‌وساختمان‌تهران‌,3748,51306368,595123068090,11100,11310,11650,550,4.95,11600,500,4.5,11200,11650,1399-9-12
137,انرژي3,سايراشخاص بورس انرژي,3740,1102260,334326907720,292420,300000,307040,14620,5.0,303310,10890,3.72,280010,307040,1399-9-12
138,ولغدر,ليزينگ‌خودروغدير,3727,13898143,335188282310,23160,24000,24310,1150,4.97,24120,960,4.15,23250,24310,1399-9-12
139,سيلام,سيمان‌ ايلام‌,3703,17297023,171152987030,10100,9740,9900,-200,-1.98,9890,-210,-2.08,9600,10260,1399-9-12
140,تنوينح,ح . تامين سرمايه نوين,3680,15320213,81231099904,5531,5530,5300,-231,-4.18,5302,-229,-4.14,5030,5650,1399-9-12
141,بزاگرس,نيروگاه زاگرس كوثر,3636,17162759,231376440485,14118,13500,13413,-705,-4.99,13481,-637,-4.51,13413,14000,1399-9-12
142,پارسان,گسترش نفت و گاز پارسيان,3590,16966663,404908571650,24270,23550,23400,-870,-3.58,23860,-410,-1.69,23300,24700,1399-9-12
143,سپح,ح . پرداخت الكترونيك سامان كيش,3537,8826523,143329833340,14880,14160,16370,1490,10.01,16240,1360,9.14,14160,16370,1399-9-12
144,بالاس,مهندسي ساختمان تاسيسات راه آهن,3504,8397733,499692191987,57019,59800,59869,2850,5.0,59503,2484,4.36,55111,59869,1399-9-12
145,خاور,ايران خودرو ديزل,3489,60585386,352821832285,5567,5845,5845,278,4.99,5824,257,4.62,5620,5845,1399-9-12
146,سفارود,كارخانه فارسيت درود,3478,20061353,192034916224,9835,9442,9730,-105,-1.07,9572,-263,-2.67,9442,10030,1399-9-12
147,ستران,سيمان‌ تهران‌,3453,5740257,209536706690,37680,36400,35800,-1880,-4.99,36500,-1180,-3.13,35800,38110,1399-9-12
148,كروي,توسعه‌ معادن‌ روي‌ ايران‌,3442,9755337,338475216290,34790,36200,34440,-350,-1.01,34700,-90,-0.26,33200,36200,1399-9-12
149,قاسم,قاسم ايران,3406,17221318,209649743043,12337,11750,12178,-159,-1.29,12174,-163,-1.32,11721,12555,1399-9-12
150,شفارس,صنايع‌ شيميايي‌ فارس‌,3369,8312355,442288145190,51650,52510,54230,2580,5.0,53210,1560,3.02,50210,54230,1399-9-12
151,وليز,ليزينگ‌ايران‌,3365,22325874,208172073700,9020,9200,9180,160,1.77,9320,300,3.33,9000,9470,1399-9-12
152,چكارن,كارتن‌ ايران‌,3345,31147539,124191686800,3950,3940,3940,-10,-0.25,3990,40,1.01,3790,4100,1399-9-12
153,قرن,پديده شيمي قرن,3333,3381354,199237369220,59710,60000,58170,-1540,-2.58,58920,-790,-1.32,57510,60500,1399-9-12
154,اپرداز,آتيه داده پرداز,3325,7725774,239752666923,31286,31300,30900,-386,-1.23,31033,-253,-0.81,30080,32128,1399-9-12
155,مرقام,ايران‌ارقام‌,3276,10392111,263575859640,24400,23600,25620,1220,5.0,25360,960,3.93,23600,25620,1399-9-12
156,وآوا,سرمايه گذاري آوا نوين,3275,9716212,154061433628,15962,16499,15930,-32,-0.2,15856,-106,-0.66,15170,16650,1399-9-12
157,سرو,صندوق س سروسودمند مدبران-سهام,3274,3245503,231358641930,71100,71000,70500,-600,-0.84,71290,190,0.27,70000,72000,1399-9-12
158,دانا,بيمه دانا,3232,43607064,312702852290,6900,7240,7110,210,3.04,7170,270,3.91,6900,7240,1399-9-12
159,دزهراوي,داروسازي‌زهراوي‌,3191,10856164,131229417170,12550,12250,11930,-620,-4.94,12090,-460,-3.67,11930,12500,1399-9-12
160,كسرا,سراميك‌هاي‌صنعتي‌اردكان‌,3164,9449163,278135148550,29390,28500,28510,-880,-2.99,29430,40,0.14,28000,30640,1399-9-12
161,وبوعلي,سرمايه‌گذاري‌بوعلي‌,3097,17362471,131986900460,7480,7660,7420,-60,-0.8,7600,120,1.6,7300,7800,1399-9-12
162,كلر,كلر پارس,3088,2797992,186837218357,64665,64989,67898,3233,5.0,66775,2110,3.26,61510,67898,1399-9-12
163,ثرود,سرمايه‌گذاري مسكن زاينده رود,3081,22085332,246814203470,10693,10801,11227,534,4.99,11175,482,4.51,10400,11227,1399-9-12
164,بكاب,صنايع‌جوشكاب‌يزد,3043,897057,245441818590,266630,270010,279900,13270,4.98,273610,6980,2.62,254200,279960,1399-9-12
165,بپاس,بيمه پاسارگاد,3004,6718105,590153980325,87398,87600,88150,752,0.86,87845,447,0.51,87398,88300,1399-9-12
166,كرماشا,صنايع پتروشيمي كرمانشاه,2986,10592361,483151625030,47240,48000,44880,-2360,-5.0,45610,-1630,-3.45,44880,48100,1399-9-12
167,ومعلم,بيمه معلم,2983,17328107,135646726304,7806,7999,7689,-117,-1.5,7828,22,0.28,7450,8130,1399-9-12
168,سفارس,سيمان فارس و خوزستان,2974,15060910,268649932820,18270,17920,17620,-650,-3.56,17840,-430,-2.35,17360,18800,1399-9-12
169,ثباغ,شهر سازي و خانه سازي باغميشه,2972,8985058,224141555439,25251,25251,24550,-701,-2.78,24946,-305,-1.21,23989,26400,1399-9-12
170,شصدف,صنعتي دوده فام,2929,133134,3348453234,23954,25151,25151,1197,5.0,24029,75,0.31,25151,25151,1399-9-12
171,خكار,ايركا پارت صنعت,2921,6069123,200288594290,31680,32800,33260,1580,4.99,33000,1320,4.17,31300,33260,1399-9-12
172,رنيك,جنرال مكانيك,2890,8082390,227028613589,28449,29490,27027,-1422,-5.0,28089,-360,-1.27,27027,29490,1399-9-12
173,مدير,ص.س.مديريت ثروت ص.بازنشستگي-س,2888,23039589,247829459310,10711,10710,10689,-22,-0.21,10757,46,0.43,10565,10870,1399-9-12
174,شسپا,نفت سپاهان,2887,10622528,269963536870,25710,24500,25000,-710,-2.76,25410,-300,-1.17,24500,26190,1399-9-12
175,سشرق,سيمان‌ شرق‌,2883,22248872,148721490500,6860,6890,6590,-270,-3.94,6680,-180,-2.62,6520,6980,1399-9-12
176,ما,بيمه  ما,2876,27265842,261342279050,9170,9500,9620,450,4.91,9580,410,4.47,9300,9620,1399-9-12
177,قجام,فرآوردههاي غذايي وقندتربت‌جام‌,2875,25174004,293725304177,12144,11537,11700,-444,-3.66,11668,-476,-3.92,11537,12300,1399-9-12
178,خچرخش,چرخشگر,2864,10057914,185071296360,17980,18000,17860,-120,-0.67,18400,420,2.34,17700,18860,1399-9-12
179,وايران,ليزينگ ايرانيان,2848,20113426,247115819900,11730,12080,12310,580,4.94,12290,560,4.77,11930,12310,1399-9-12
180,ومهان,گروه توسعه مالي مهر آيندگان,2818,12987959,220886453811,17172,16430,16729,-443,-2.58,17007,-165,-0.96,16430,17400,1399-9-12
181,شتوكا,توكا رنگ فولاد سپاهان,2806,3420401,138941504951,41719,41860,39634,-2085,-5.0,40621,-1098,-2.63,39634,43000,1399-9-12
182,كپارس,كاشي‌ پارس‌,2792,1561272,235224719200,148980,149990,151150,2170,1.46,150660,1680,1.13,143140,156000,1399-9-12
183,غمينو,شركت صنايع غذايي مينو شرق,2768,9076958,114436669882,12287,12390,12040,-247,-2.01,12607,320,2.6,11780,12901,1399-9-12
184,رمپنا,گروه مپنا (سهامي عام),2759,12749579,243551672120,19740,19420,19110,-630,-3.19,19100,-640,-3.24,18760,19900,1399-9-12
185,كبافق,معادن‌ بافق‌,2755,3980247,169653518800,40710,42550,42740,2030,4.99,42620,1910,4.69,41250,42740,1399-9-12
186,وبانك,سرمايه گذاري گروه توسعه ملي,2754,12895690,144841931380,11080,11240,11170,90,0.81,11230,150,1.35,11010,11450,1399-9-12
187,تسه9908,امتياز تسهيلات مسكن آبان99,2733,80831,51876620631,623096,654250,647000,23904,3.84,641791,18695,3.0,623096,654250,1399-9-12
188,ثاباد,توريستي ورفاهي آبادگران ايران,2690,5261595,160951359760,31230,32000,29670,-1560,-5.0,30590,-640,-2.05,29670,32100,1399-9-12
189,فسازان,غلتك سازان سپاهان,2676,14353310,453044512160,30260,30700,31500,1240,4.1,31560,1300,4.3,29700,31770,1399-9-12
190,ارفع,شركت آهن و فولاد ارفع,2671,9512628,137509836084,14506,14200,14150,-356,-2.45,14456,-50,-0.34,13920,14970,1399-9-12
191,غصينو,صنعتي مينو,2648,5782427,416654797323,68755,71900,72192,3437,5.0,72055,3300,4.8,69760,72192,1399-9-12
192,افق,فروشگاههاي زنجيره اي افق كوروش,2646,1778304,147201487960,83420,80120,81870,-1550,-1.86,82780,-640,-0.77,80120,85000,1399-9-12
193,كگازح,ح . شيشه‌ و گاز,2646,5567226,118867375790,22640,22000,20380,-2260,-9.98,21350,-1290,-5.7,20380,23630,1399-9-12
194,حسير,ريل سير كوثر,2631,8908968,157362810603,17993,18250,17094,-899,-5.0,17663,-330,-1.83,17094,18500,1399-9-12
195,لسرما,سرما آفرين‌,2608,4647281,146752562750,30560,31500,32020,1460,4.78,31580,1020,3.34,30610,32020,1399-9-12
196,رانفور,خدمات‌انفورماتيك‌,2606,7539158,280968475050,37360,37480,37900,540,1.45,37270,-90,-0.24,35710,38850,1399-9-12
197,شپاكسا,پاكسان‌,2595,8420490,265769095050,30640,30000,31000,360,1.17,31560,920,3.0,29700,32170,1399-9-12
198,توريل,توکاريل,2591,6350174,143162328408,21991,22800,23010,1019,4.63,22545,554,2.52,21404,23090,1399-9-12
199,بورس,بورس اوراق بهادار تهران,2552,3074304,173826857850,55740,55740,55350,-390,-0.7,56540,800,1.44,55160,57860,1399-9-12
200,دتوليد,داروسازي توليد دارو,2544,4720322,151405175534,33272,31609,31609,-1663,-5.0,32075,-1197,-3.6,31609,33449,1399-9-12
201,ثعمرا,عمران و توسعه شاهد,2535,9241868,134130890469,14943,14500,14390,-553,-3.7,14513,-430,-2.88,14196,15200,1399-9-12
202,آپ,آسان پرداخت پرشين,2535,10019697,189996271240,18490,18370,18620,130,0.7,18960,470,2.54,18100,19410,1399-9-12
203,خفنر,فنرسازي‌خاور,2505,9227530,184376552170,19650,20000,19030,-620,-3.16,19980,330,1.68,18900,20630,1399-9-12
204,چكاوه,صنايع‌كاغذسازي‌كاوه‌,2488,5818302,161859444470,28870,28690,27430,-1440,-4.99,27820,-1050,-3.64,27430,28990,1399-9-12
205,كترام,توليدي‌ كاشي‌ تكسرام‌,2485,3938845,154464806140,38790,39500,37910,-880,-2.27,39220,430,1.11,37010,40500,1399-9-12
206,غبهار,كشت وصنعت بهاران گلبهار خراسان,2477,10641441,405638408451,37051,38162,38162,1111,3.0,38119,1068,2.88,36100,38162,1399-9-12
207,وبيمه,سرمايه‌ گذاري‌ صنعت‌ بيمه‌,2457,26779111,92276009560,3320,3360,3430,110,3.31,3450,130,3.92,3300,3480,1399-9-12
208,والبر,سرمايه‌ گذاري‌ البرز(هلدينگ‌,2456,8765666,169947047370,19240,19210,19000,-240,-1.25,19390,150,0.78,18450,20000,1399-9-12
209,غويتا,ويتانا,2453,4001579,179900292200,46876,44810,44533,-2343,-5.0,44957,-1919,-4.09,44533,46690,1399-9-12
210,فلوله,لوله‌وماشين‌سازي‌ايران‌,2452,13141323,308626776200,22520,23640,23640,1120,4.97,23490,970,4.31,22500,23640,1399-9-12
211,ملت,بيمه ملت,2440,12694533,223961639890,16830,17590,17200,370,2.2,17640,810,4.81,17020,17670,1399-9-12
212,سيدكو,سرمايه گذاري توسعه صنايع سيمان,2425,27965485,239735040330,8300,8340,8710,410,4.94,8570,270,3.25,8060,8710,1399-9-12
213,ثپرديس,سرمايه گذاري مسكن پرديس,2416,11482571,131799025366,11714,11600,11270,-444,-3.79,11478,-236,-2.01,11129,12080,1399-9-12
214,همراه,شركت ارتباطات سيار ايران,2392,4736637,178677437640,37010,36740,37390,380,1.03,37720,710,1.92,36000,38550,1399-9-12
215,وگردش,بانك گردشگري,2390,13832600,292829607879,20557,21173,21173,616,3.0,21170,613,2.98,20977,21173,1399-9-12
216,وبهمن,سرمايه‌گذاري‌بهمن‌,2372,17325789,337157208610,18600,19530,19530,930,5.0,19460,860,4.62,18650,19530,1399-9-12
217,وپسا,س. پتروشيمي ساختمان  خليج فارس,2371,46892449,181192551483,3970,3851,3900,-70,-1.76,3864,-106,-2.67,3851,3940,1399-9-12
218,فلامي,لاميران‌,2365,3620365,150198584680,41440,43400,42720,1280,3.09,41490,50,0.12,39370,43400,1399-9-12
219,تابا,تابان نيرو سپاهان,2357,3711450,114304096074,30612,29694,30570,-42,-0.14,30798,186,0.61,29694,31499,1399-9-12
220,ميهن,بيمه ميهن,2355,21679878,131410511959,6290,6200,5976,-314,-4.99,6061,-229,-3.64,5976,6260,1399-9-12
221,وهور,مديريت انرژي اميد  تابان هور,2352,5167852,214745003986,41669,41700,41691,22,0.05,41554,-115,-0.28,39660,42550,1399-9-12
222,شكربن,كربن‌ ايران‌,2338,2527624,229157339540,87080,91200,91430,4350,5.0,90660,3580,4.11,87100,91430,1399-9-12
223,خوساز,محورسازان‌ايران‌خودرو,2335,24282173,180513163080,7790,7450,7410,-380,-4.88,7430,-360,-4.62,7410,7650,1399-9-12
224,زاگرس,پتروشيمي زاگرس,2295,1300845,239994048617,185845,186690,183600,-2245,-1.21,184491,-1354,-0.73,181000,186690,1399-9-12
225,خكاوه,سايپا ديزل,2281,36719923,173992251814,4606,4697,4744,138,3.0,4738,132,2.87,4660,4744,1399-9-12
226,زفكا,كشت و دامداري فكا,2278,2816437,145678143044,50598,48150,52150,1552,3.07,51724,1126,2.23,48150,53000,1399-9-12
227,سدور,سيمان‌ دورود,2250,24181089,227628602090,8990,9430,9430,440,4.89,9410,420,4.67,9140,9430,1399-9-12
228,وصندوق,سرمايه‌گذاري‌صندوق‌بازنشستگي‌,2250,19381720,311868264670,16190,15810,16000,-190,-1.17,16090,-100,-0.62,15580,16350,1399-9-12
229,هرمز,فولاد هرمزگان جنوب,2250,12411146,161938790788,12997,13050,12713,-284,-2.19,13048,51,0.39,12600,13399,1399-9-12
230,سپ,پرداخت الكترونيك سامان كيش,2183,7763800,134537217090,16610,16930,17440,830,5.0,17330,720,4.33,15950,17440,1399-9-12
231,فجر,فولاد اميركبيركاشان,2182,2306739,149302083910,66170,67940,63250,-2920,-4.41,64720,-1450,-2.19,62910,67940,1399-9-12
232,كمينا,شيشه سازي مينا,2173,4744642,178155614986,36308,37950,37580,1272,3.5,37549,1241,3.42,36456,38123,1399-9-12
233,غشان,شيرپاستوريزه‌پگاه‌خراسان‌,2172,11154850,96560538460,8560,8800,8400,-160,-1.87,8660,100,1.17,8180,8870,1399-9-12
234,ارزش,صندوق س ارزش آفرين بيدار-سهام,2156,14877953,159674780800,10840,10770,10580,-260,-2.4,10730,-110,-1.01,10530,10950,1399-9-12
235,چدن,توليدي چدن سازان,2132,11028918,380450517980,33000,33990,34650,1650,5.0,34500,1500,4.55,32670,34650,1399-9-12
236,حفارس,حمل و نقل بين المللي خليج فارس,2103,20251321,86066288920,4290,4110,4180,-110,-2.56,4250,-40,-0.93,4110,4390,1399-9-12
237,پاكشو,گروه صنعتي پاكشو,2068,1253731,119897562390,95420,97330,94970,-450,-0.47,95630,210,0.22,93400,97350,1399-9-12
238,حآسا,آسيا سير ارس,2067,5366507,125061901856,23284,22201,23560,276,1.19,23304,20,0.09,22201,24098,1399-9-12
239,وسكاب,س.ص.بازنشستگي كاركنان بانكها,2067,20335710,140647373330,7060,7090,6850,-210,-2.97,6920,-140,-1.98,6820,7090,1399-9-12
240,تايرا,تراكتورسازي‌ايران‌,2048,12685873,390311699640,29780,31260,31260,1480,4.97,30770,990,3.32,28300,31260,1399-9-12
241,كهمداح,ح . شيشه‌ همدان‌,2030,9062925,100083668180,10920,11390,10790,-130,-1.19,11040,120,1.1,10230,11620,1399-9-12
242,حريل,ريل پردازسير,2018,19890931,81952867118,4152,4007,4070,-82,-1.97,4120,-32,-0.77,3980,4280,1399-9-12
243,كهمدا,شيشه‌ همدان‌,2010,7438979,92297287390,12590,12990,12120,-470,-3.73,12410,-180,-1.43,11970,12990,1399-9-12
244,ولصنم,ليزينگ‌صنعت‌ومعدن‌,2005,10869303,109062820250,9620,9950,10100,480,4.99,10030,410,4.26,9700,10100,1399-9-12
245,خزر,فنرسازي‌زر,1995,7843767,188945428240,23120,23500,24270,1150,4.97,24090,970,4.2,23200,24270,1399-9-12
246,امين يكم,صندوق درآمد ثابت امين يكم فردا,1978,66720472,678050410702,10145,10150,10185,40,0.39,10163,18,0.18,10133,10190,1399-9-12
247,شاراك,پتروشيمي شازند,1962,8341195,201404565240,24230,24560,23790,-440,-1.82,24150,-80,-0.33,23250,24890,1399-9-12
248,تنوين,تامين سرمايه نوين,1958,15552898,110219531990,7340,7390,6980,-360,-4.9,7090,-250,-3.41,6980,7500,1399-9-12
249,غاذر,كشت‌وصنعت‌پياذر,1921,2545550,214358052590,81270,80000,85310,4040,4.97,84210,2940,3.62,77700,85330,1399-9-12
250,فمراد,آلومراد,1918,1906065,253341775450,126870,132900,133210,6340,5.0,132910,6040,4.76,128000,133210,1399-9-12
251,ثنور,سرمايه گذاري كوه نور,1918,14696034,100546505115,7001,6810,6791,-210,-3.0,6842,-159,-2.27,6791,7000,1399-9-12
252,سدبير,س. تدبيرگران فارس وخوزستان,1914,5644182,226088728197,38806,40746,39350,544,1.4,40057,1251,3.22,38500,40746,1399-9-12
253,شمواد,توليد مواداوليه الياف مصنوعي,1901,2026592,122334564936,62157,60700,60293,-1864,-3.0,60365,-1792,-2.88,60293,61687,1399-9-12
254,وپترو,سرمايه‌گذاري صنايع پتروشيمي‌,1885,13551737,265755595820,18700,19630,19630,930,4.97,19610,910,4.87,19000,19630,1399-9-12
255,غبشهر,صنعتي‌ بهشهر,1883,8489867,241409605220,27530,28500,27820,290,1.05,28440,910,3.31,27540,28900,1399-9-12
256,پكرمان,گروه‌ صنعتي‌ بارز,1868,4081198,133011000630,33240,32500,32000,-1240,-3.73,32590,-650,-1.96,31790,33570,1399-9-12
257,فايرا,آلومينيوم‌ايران‌,1865,7553119,190399890380,24250,23850,25460,1210,4.99,25210,960,3.96,23040,25460,1399-9-12
258,خاهن,آهنگري‌ تراكتورسازي‌ ايران‌,1804,4738284,179573775270,37460,38490,37900,440,1.17,37900,440,1.17,37000,38490,1399-9-12
259,غشصفا,شيرپاستوريزه‌پگاه‌اصفهان‌,1801,5726716,184983930810,31040,32590,31200,160,0.52,32300,1260,4.06,30710,32590,1399-9-12
260,خفناور,مهندسي صنعتي روان فن آور,1789,4888578,126224827058,25545,26200,26277,732,2.87,25820,275,1.08,24779,26311,1399-9-12
261,قثابت,قند ثابت‌ خراسان‌,1787,2086128,179731804190,82330,86000,86440,4110,4.99,86160,3830,4.65,83000,86440,1399-9-12
262,دشيمي,شيمي‌ داروئي‌ داروپخش‌,1777,1852626,104448629320,55650,55500,56000,350,0.63,56380,730,1.31,53660,58000,1399-9-12
263,دلقما,دارويي‌ لقمان‌,1775,3566492,111633729370,32400,31300,30780,-1620,-5.0,31300,-1100,-3.4,30780,32400,1399-9-12
264,قشرين,قند شيرين خراسان,1774,7366105,159995700389,21163,21790,21797,634,3.0,21721,558,2.64,20800,21797,1399-9-12
265,ميدكو,هلدينگ صنايع  معدني خاورميانه,1768,12772403,341038951512,26668,26710,26700,32,0.12,26701,33,0.12,26300,26800,1399-9-12
266,آ س پ,آ.س.پ,1754,6823591,77837646755,11825,11370,11234,-591,-5.0,11407,-418,-3.53,11234,11780,1399-9-12
267,كلوند,كاشي‌ الوند,1750,5409049,140086089580,24880,25240,26120,1240,4.98,25900,1020,4.1,24860,26120,1399-9-12
268,دكوثر,داروسازي‌ كوثر,1738,4258217,95216225170,22890,21870,22090,-800,-3.49,22360,-530,-2.32,21790,23130,1399-9-12
269,تاصيكو,سرمايه گذاري صدرتامين,1733,9015935,101619963140,11330,11280,11040,-290,-2.56,11290,-40,-0.35,10900,11630,1399-9-12
270,ثامان,سامان‌ گستراصفهان‌,1732,3684347,76480710200,21340,20300,20280,-1060,-4.97,20760,-580,-2.72,20280,22000,1399-9-12
271,پكوير,كوير تاير,1727,4379714,84395782260,19460,19100,18760,-700,-3.6,19270,-190,-0.98,18490,19700,1399-9-12
272,فرآور,فرآوري‌موادمعدني‌ايران‌,1727,6971845,162334513290,22280,22990,23390,1110,4.98,23280,1000,4.49,21550,23390,1399-9-12
273,شبهرن,نفت‌ بهران‌,1719,1851161,114992634960,63360,62380,62000,-1360,-2.15,62120,-1240,-1.96,61500,63360,1399-9-12
274,سنير,سيمان‌ سفيد ني‌ريز,1684,831697,77956519500,97230,97370,92370,-4860,-5.0,93730,-3500,-3.6,92370,99500,1399-9-12
275,كسرام,پارس‌ سرام‌,1681,12559264,106070884660,8110,8320,8510,400,4.93,8450,340,4.19,8130,8510,1399-9-12
276,وآذر,سرمايه‌گذاري‌توسعه‌آذربايجان‌,1674,1094391,136831946320,124460,125100,127530,3070,2.47,125030,570,0.46,118240,128400,1399-9-12
277,حتوكا,حمل‌ونقل‌توكا,1673,5315425,99518268960,18760,18390,18900,140,0.75,18720,-40,-0.21,18130,19290,1399-9-12
278,فنورد,نوردوقطعات‌ فولادي‌,1672,885309,154257820400,182600,179000,173470,-9130,-5.0,174240,-8360,-4.58,173470,181500,1399-9-12
279,واتي,سرمايه‌ گذاري‌ آتيه‌ دماوند,1668,20016172,281775042170,13470,13780,14140,670,4.97,14080,610,4.53,13520,14140,1399-9-12
280,دبالك,مواد اوليه دارويي البرز بالك,1666,5897611,105239445545,17118,17680,17973,855,4.99,17844,726,4.24,17200,17973,1399-9-12
281,زكشت,كشاورزي مكانيزه اصفهان كشت,1641,3106693,94091468507,31319,29754,30390,-929,-2.97,30287,-1032,-3.3,29754,31900,1399-9-12
282,كساپا,سايپاشيشه‌,1618,5415877,145614700940,26670,27600,25640,-1030,-3.86,26890,220,0.82,25450,28000,1399-9-12
283,قزوين,كارخانجات‌ قند قزوين‌,1600,2588096,102667688530,41120,40000,40500,-620,-1.51,39670,-1450,-3.53,39070,41050,1399-9-12
284,شدوص,دوده‌ صنعتي‌ پارس‌,1598,5972365,140444138950,22780,22100,23910,1130,4.96,23520,740,3.25,22100,23910,1399-9-12
285,سكرد,سيمان كردستان,1593,6672080,61636611000,9090,9450,8940,-150,-1.65,9240,150,1.65,8940,9470,1399-9-12
286,غچين,كشت‌ و صنعت‌ چين‌ چين,1582,1591528,83323088060,52000,53550,51020,-980,-1.88,52350,350,0.67,50000,54600,1399-9-12
287,بخاور,بيمه زندگي خاورميانه,1570,14038504,128161939116,8717,8946,9152,435,4.99,9129,412,4.73,8717,9152,1399-9-12
288,شرانل,نفت ايرانول,1565,2884896,101370776475,36511,35100,34700,-1811,-4.96,35138,-1373,-3.76,34686,36500,1399-9-12
289,اميد,تامين سرمايه اميد,1564,21977886,277679509840,12040,12640,12640,600,4.98,12630,590,4.9,12070,12640,1399-9-12
290,غگرجي,بيسكويت‌  گرجي‌,1549,3938299,141223180460,35790,35790,35620,-170,-0.47,35860,70,0.2,34760,36550,1399-9-12
291,حاريا,كشتيراني آريا,1549,3466893,94390080337,27626,28000,26245,-1381,-5.0,27226,-400,-1.45,26245,28600,1399-9-12
292,سرچشمه,سرمايه گذاري مس سرچشمه,1537,8730957,74975471206,8749,8800,8580,-169,-1.93,8587,-162,-1.85,8316,8990,1399-9-12
293,طلا,صندوق س.پشتوانه طلاي لوتوس,1529,955668,80764512524,87646,86600,84320,-3326,-3.79,84511,-3135,-3.58,83110,86600,1399-9-12
294,چافست,افست‌,1523,3335418,78689436920,23330,23330,23380,50,0.21,23590,260,1.11,22800,24140,1399-9-12
295,آريان,سرمايه گذاري پارس آريان,1520,31244989,509971153274,16433,16500,15941,-492,-2.99,16322,-111,-0.68,15941,16500,1399-9-12
296,زگلدشت,كشت و دام گلدشت نمونه اصفهان,1520,2758249,115436583248,40275,40500,42288,2013,5.0,41851,1576,3.91,40500,42288,1399-9-12
297,سپاها,سيمان‌سپاهان‌,1514,7517149,70024396520,9210,9570,9180,-30,-0.33,9320,110,1.19,9020,9570,1399-9-12
298,خموتور,موتورسازان‌تراكتورسازي‌ايران‌,1512,7769637,79477578110,10630,10120,10100,-530,-4.99,10230,-400,-3.76,10100,10630,1399-9-12
299,سخوز,سيمان خوزستان,1509,7922433,190602938390,23090,22990,24240,1150,4.98,24060,970,4.2,22450,24240,1399-9-12
300,اعتماد,صندوق س.اعتماد آفرين پارسيان-د,1506,35031700,1177792959290,33599,33616,33626,27,0.08,33621,22,0.07,33615,33627,1399-9-12
301,پارسيان,بيمه پارسيان,1499,6116472,93902097450,15210,15690,15290,80,0.53,15350,140,0.92,14450,15800,1399-9-12
302,سمگا,گروه سرمايه گذاري ميراث فرهنگي,1477,12293605,277282260775,21481,22555,22555,1074,5.0,22555,1074,5.0,22555,22555,1399-9-12
303,ختراكح,ح . ريخته‌گري‌ تراكتورسازي‌,1475,3346607,45168662500,12440,13600,13680,1240,9.97,13500,1060,8.52,12440,13680,1399-9-12
304,هاي وب,داده گسترعصرنوين-هاي وب,1473,22999975,683099257500,28290,29700,29700,1410,4.98,29700,1410,4.98,29700,29700,1399-9-12
305,ثمسكن,سرمايه‌گذاري‌ مسكن‌,1473,13522260,85977382780,6420,6470,6270,-150,-2.34,6360,-60,-0.93,6210,6550,1399-9-12
306,تكشا,گسترش‌صنايع‌وخدمات‌كشاورزي‌,1469,1154856,71798648730,64730,62320,61500,-3230,-4.99,62170,-2560,-3.95,61500,63500,1399-9-12
307,حبندر,دريايي و کشتيراني خط دريابندر,1461,3478836,104034555825,29244,28700,30121,877,3.0,29905,661,2.26,28700,30121,1399-9-12
308,شپارس,بين‌ المللي‌ محصولات‌  پارس‌,1458,5645832,83320505220,15360,15000,14790,-570,-3.71,14760,-600,-3.91,14600,15160,1399-9-12
309,وكار,بانك‌ كارآفرين‌,1457,20164625,83481101730,4230,4240,4050,-180,-4.26,4140,-90,-2.13,4020,4270,1399-9-12
310,تيپيكو,سرمايه گذاري دارويي تامين,1457,2445552,142313683450,59450,57560,58100,-1350,-2.27,58190,-1260,-2.12,57010,60430,1399-9-12
311,بهپاك,صنعتي بهپاك,1455,4233585,176982332323,39931,38300,41927,1996,5.0,41804,1873,4.69,38300,41927,1399-9-12
312,ددام,داروسازي زاگرس فارمد پارس,1454,6871408,100100498020,14860,14970,14470,-390,-2.62,14570,-290,-1.95,14120,15370,1399-9-12
313,زپارس,ملي كشت و صنعت و دامپروري پارس,1435,3059459,232010171090,72510,76130,74160,1650,2.28,75830,3320,4.58,74010,76130,1399-9-12
314,وسپه,سرمايه‌گذاري‌ سپه‌,1419,5287656,75857997050,14580,14580,14100,-480,-3.29,14350,-230,-1.58,14000,14880,1399-9-12
315,شوينده,مديريت صنعت شوينده ت.ص.بهشهر,1412,3014692,127694968170,41110,41000,42280,1170,2.85,42360,1250,3.04,40750,42950,1399-9-12
316,وآرين,شركت توسعه اقتصادي آرين,1410,6873060,42723545852,6301,6300,6168,-133,-2.11,6216,-85,-1.35,6112,6400,1399-9-12
317,پسهند,صنايع‌ لاستيكي‌  سهند,1390,2413535,106558359840,42410,42660,44530,2120,5.0,44150,1740,4.1,42430,44530,1399-9-12
318,ثتران,سرمايه گذاري مسكن تهران,1389,19431826,96687716761,5151,5310,4894,-257,-4.99,4976,-175,-3.4,4894,5407,1399-9-12
319,كپشيرح,ح . پشم‌شيشه‌ايران‌,1375,5201737,70026208084,13614,13300,13100,-514,-3.78,13462,-152,-1.12,12810,13948,1399-9-12
320,رتاپح,ح.تجارت الكترونيك پارسيان,1371,8181819,40657402410,5030,4900,4960,-70,-1.39,4970,-60,-1.19,4540,5170,1399-9-12
321,كاذر,فرآورده‌هاي‌نسوزآذر,1367,3773873,71868945510,18840,19550,18930,90,0.48,19040,200,1.06,18840,19690,1399-9-12
322,غپاك,لبنيات‌ پاك‌,1353,6075507,88577683320,14710,14200,14890,180,1.22,14580,-130,-0.88,14100,14930,1399-9-12
323,قهكمت,قندهكمتان‌,1338,5391217,278931251370,54090,51390,52500,-1590,-2.94,51740,-2350,-4.34,51390,55150,1399-9-12
324,فباهنر,مس‌ شهيدباهنر,1319,2079549,116155348560,54660,52860,55110,450,0.82,55860,1200,2.2,52860,57300,1399-9-12
325,جم,پتروشيمي جم,1313,3748856,174942301480,47710,46950,45330,-2380,-4.99,46670,-1040,-2.18,45330,48200,1399-9-12
326,تكنو,تكنوتار,1304,5243642,71559488620,13930,13780,13240,-690,-4.95,13650,-280,-2.01,13240,14140,1399-9-12
327,رتاپ,تجارت الكترونيك  پارسيان,1301,5297823,37341746920,7000,7030,7020,20,0.29,7030,30,0.43,6850,7210,1399-9-12
328,وگستر,گسترش سرمايه گذاري ايرانيان,1286,2448618,59136820990,24076,24076,23500,-576,-2.39,24151,75,0.31,22873,25000,1399-9-12
329,كساوه,صنايع‌ كاشي‌ و سراميك‌ سينا,1285,1471642,121064358080,80000,80800,80650,650,0.81,82260,2260,2.83,80650,82980,1399-9-12
330,وايرا,سرمايه گذاري صنايع ايران,1274,7559252,60139209354,8104,8250,7900,-204,-2.52,7956,-148,-1.83,7861,8250,1399-9-12
331,پخش,پخش البرز,1272,4044002,174296355467,41400,41000,43470,2070,5.0,43100,1700,4.11,40400,43470,1399-9-12
332,وتوسم,سرمايه‌گذاري‌توسعه‌ملي‌,1262,4601578,59987327490,13220,13000,12900,-320,-2.42,13040,-180,-1.36,12820,13370,1399-9-12
333,وآيند,بانك  آينده,1251,4954564,114896339160,23663,23190,23190,-473,-2.0,23190,-473,-2.0,23190,23190,1399-9-12
334,فيروزه,صندوق شاخص30 شركت فيروزه- سهام,1243,414295,75035793790,183850,182990,178000,-5850,-3.18,181120,-2730,-1.48,175000,189000,1399-9-12
335,زشريف,كشت وصنعت شريف آباد,1232,2660532,64525617270,23744,23101,24730,986,4.15,24253,509,2.14,23000,24760,1399-9-12
336,بفجر,فجر انرژي خليج فارس,1223,4500287,139570975990,30530,29630,30250,-280,-0.92,31010,480,1.57,29630,32050,1399-9-12
337,افرا,افرانت,1221,3737721,178185633446,49851,49230,47359,-2492,-5.0,47672,-2179,-4.37,47359,50430,1399-9-12
338,وثخوز,سرمايه گذاري و توسعه خوزستان,1215,1839469,73729432885,40707,39600,38672,-2035,-5.0,40082,-625,-1.54,38672,42742,1399-9-12
339,ولشرق,ليزينگ ايران و شرق,1209,10640645,68684129162,6495,6516,6360,-135,-2.08,6455,-40,-0.62,6175,6750,1399-9-12
340,شاوان,پالايش نفت لاوان,1200,1024891,120777946611,121278,123540,115215,-6063,-5.0,117845,-3433,-2.83,115215,123540,1399-9-12
341,سمازن,سيمان‌مازندران‌,1192,6450858,66698730280,10400,10150,10420,20,0.19,10340,-60,-0.58,10100,10620,1399-9-12
342,وسبحان,سرمايه گذاري سبحان,1180,5454263,48702746151,8971,9000,8880,-91,-1.01,8933,-38,-0.42,8750,9100,1399-9-12
343,دتماد,توليدمواداوليه‌داروپخش‌,1174,2952413,157698188280,54670,54070,52000,-2670,-4.88,53410,-1260,-2.3,51940,54960,1399-9-12
344,قچار,فراوردههاي غذايي وقند چهارمحال,1174,1938791,107528245826,52822,55463,55463,2641,5.0,55461,2639,5.0,55000,55463,1399-9-12
345,غگلستا,شير پاستوريزه پگاه گلستان,1174,4016238,67421488474,16172,16500,16980,808,5.0,16787,615,3.8,15600,16980,1399-9-12
346,غدشت,دشت‌ مرغاب‌,1171,253530,67438902390,269430,275000,259990,-9440,-3.5,266000,-3430,-1.27,255960,280000,1399-9-12
347,شپديس,پتروشيمي پرديس,1143,1144229,128291312570,112670,112000,112000,-670,-0.59,112120,-550,-0.49,109500,113790,1399-9-12
348,غشاذر,پگاه‌آذربايجان‌غربي‌,1141,3467152,71573873030,19700,20300,20680,980,4.97,20640,940,4.77,20000,20680,1399-9-12
349,لخزر,پارس‌ خزر,1134,557398,100904069620,190200,180690,180690,-9510,-5.0,181030,-9170,-4.82,180690,187100,1399-9-12
350,شخارك,پتروشيمي‌ خارك‌,1128,2309814,105930159160,46670,46000,45870,-800,-1.71,45890,-780,-1.67,44630,47410,1399-9-12
351,بشهاب,لامپ‌  پارس‌ شهاب‌,1120,698407,45211937650,66850,64800,63510,-3340,-5.0,64900,-1950,-2.92,63510,68000,1399-9-12
352,ساروم,سيمان‌اروميه‌,1119,2379078,62538834100,25840,25940,26650,810,3.13,26290,450,1.74,25030,26800,1399-9-12
353,اتكام,شركت بيمه اتكايي امين,1103,6643211,45969462888,6753,6980,6843,90,1.33,6891,138,2.04,6770,7080,1399-9-12
354,فاما,صنعتي‌ آما,1102,2605939,69401560580,27680,27000,26600,-1080,-3.9,26630,-1050,-3.79,26300,27500,1399-9-12
355,وصنا,گروه‌صنايع‌بهشهرايران‌,1080,4691534,66508942880,14520,14690,13990,-530,-3.65,14180,-340,-2.34,13960,14800,1399-9-12
356,زنگان,صنعت روي زنگان,1077,991094,109101686647,104923,109500,110169,5246,5.0,110082,5159,4.92,106200,110169,1399-9-12
357,آوا,صندوق س.سهام آواي معيار-س,1076,5504467,51102640199,9396,9301,9141,-255,-2.71,9284,-112,-1.19,9102,9497,1399-9-12
358,فسپا,گروه‌صنعتي‌سپاهان‌,1076,1683875,75147299870,45590,43700,45000,-590,-1.29,44630,-960,-2.11,43510,45800,1399-9-12
359,كطبس,ذغال‌سنگ‌ نگين‌ ط‌بس‌,1074,3328485,220749993680,63520,63500,66690,3170,4.99,66320,2800,4.41,63500,66690,1399-9-12
360,فپنتا,سپنتا,1072,186999,60672614290,323840,327000,319000,-4840,-1.49,324450,610,0.19,311800,331100,1399-9-12
361,گكيش,توريستي ورفاهي آبادگران كيش,1063,2058162,127342570158,59279,57500,62242,2963,5.0,61872,2593,4.37,57500,62242,1399-9-12
362,خصدرا,صنعتي‌ دريايي‌ ايران‌,1059,6254531,36107407463,5951,5773,5773,-178,-2.99,5845,-106,-1.78,5773,5773,1399-9-12
363,ثشرق,سرمايه گذاري مسكن شمال شرق,1053,11407893,61098410820,5480,5480,5300,-180,-3.28,5360,-120,-2.19,5220,5580,1399-9-12
364,وخاور,بانك خاورميانه,1053,6839969,74051860580,11040,10520,10730,-310,-2.81,10830,-210,-1.9,10520,11000,1399-9-12
365,وبشهر,توسعه‌ صنايع‌ بهشهر(هلدينگ,1043,3955047,68730366130,17590,16970,17140,-450,-2.56,17380,-210,-1.19,16970,17900,1399-9-12
366,ضخود1044,اختيارخ خودرو-4000-1399/10/07,1038,42487,19612212000,478,480,449,-29,-6.07,462,-16,-3.35,420,490,1399-9-12
367,غشهد,شهد ايران ‌,1036,4664943,30729180250,6650,6390,6500,-150,-2.26,6610,-40,-0.6,6390,6780,1399-9-12
368,ثاژن,سخت آژند,1034,7823546,61488806645,7962,8110,7803,-159,-2.0,7859,-103,-1.29,7803,8110,1399-9-12
369,غگلپا,شير پاستوريزه پگاه گلپايگان,1025,719788,51218412669,73660,74000,70040,-3620,-4.91,71158,-2502,-3.4,69977,74800,1399-9-12
370,فولاژ,فولاد آلياژي ايران,1024,2285023,61582894450,26530,27300,26300,-230,-0.87,26930,400,1.51,26030,27700,1399-9-12
371,دفارا,داروسازي‌ فارابي‌,1024,1030807,70385238930,66830,70000,66820,-10,-0.01,68280,1450,2.17,66300,70000,1399-9-12
372,ثالوند,سرمايه گذاري مسكن الوند,1016,5064064,76784275459,14555,14940,15282,727,4.99,15163,608,4.18,14600,15282,1399-9-12
373,وتوشه,سرمايه‌ گذاري‌ پارس‌ توشه‌,1012,6372668,146993566800,22110,21500,23210,1100,4.98,23070,960,4.34,21220,23210,1399-9-12
374,شبصير,توليدات پتروشيمي قائد بصير,1004,2410475,259319456500,102460,107583,107583,5123,5.0,107580,5120,5.0,106001,107583,1399-9-12
375,دجابر,داروسازي‌ جابرابن‌حيان‌,1004,1658311,67519885520,39850,41780,40190,340,0.85,40720,870,2.18,39850,41780,1399-9-12
376,خودكفا,اقتصادي و خودكفايي آزادگان,1001,8932255,272773203190,29084,30538,30538,1454,5.0,30538,1454,5.0,30538,30538,1399-9-12
377,درهآور,دارويي ره آورد تامين,988,4927322,193979100847,37542,39419,39419,1877,5.0,39368,1826,4.86,37553,39419,1399-9-12
378,وسلرستا,شركت س استان لرستان,987,28726612,27307224350,920,960,960,40,4.35,940,20,2.17,930,960,1399-9-12
379,سفانو,سيمان فارس نو,981,2467526,84721802310,33510,31850,33250,-260,-0.78,34330,820,2.45,31840,35180,1399-9-12
380,كاردان,صندوق س تجارت شاخصي كاردان,979,368682,67790844270,184410,185520,180220,-4190,-2.27,183870,-540,-0.29,180220,187900,1399-9-12
381,خپويش,سازه‌ پويش‌,978,1022973,36984228440,37140,35300,35290,-1850,-4.98,36360,-780,-2.1,35290,37490,1399-9-12
382,فلات,گروه صنايع معادن فلات ايرانيان,976,9069639,142251088606,15202,15962,15011,-191,-1.26,15684,482,3.17,14600,15962,1399-9-12
383,پارند,صندوق س. پارند پايدار سپهر,973,33429952,381203216613,11400,11401,11400,0,0.0,11403,3,0.03,11395,11430,1399-9-12
384,پارس,پتروشيمي پارس,967,722235,120486741440,167820,162200,165400,-2420,-1.44,166820,-1000,-0.6,162200,170000,1399-9-12
385,كاذرح,ح . فرآورده‌هاي‌نسوزآذر,957,2228777,37181727400,16120,16290,16400,280,1.74,16680,560,3.47,16160,17200,1399-9-12
386,دالبر,البرزدارو,955,1860995,42880559830,23380,23600,22780,-600,-2.57,23120,-260,-1.11,22510,23600,1399-9-12
387,سكارون,سيمان كارون,952,1313656,195161320500,147225,142809,151641,4416,3.0,148563,1338,0.91,142809,151641,1399-9-12
388,لبوتان,گروه‌صنعتي‌بوتان‌,948,790098,56498127740,68310,69180,71720,3410,4.99,71510,3200,4.68,67170,71720,1399-9-12
389,غمهراح,ح . توليدي‌مهرام‌,929,1537568,87297553780,55730,57900,56570,840,1.51,56780,1050,1.88,50160,61300,1399-9-12
390,فنرژي,گسترش صنايع انرژي آذرآب,921,3992441,40698730830,10501,10081,10081,-420,-4.0,10194,-307,-2.92,10081,10700,1399-9-12
391,مبين,مبين انرژي خليج فارس,919,5001212,120994700990,23970,24800,24000,30,0.13,24190,220,0.92,23000,25140,1399-9-12
392,وزمين,بانك ايران زمين,917,8855235,111121573180,12437,12190,12685,248,1.99,12549,112,0.9,12189,12685,1399-9-12
393,پرديس,سرمايه گذاري پرديس,912,6409470,48099417310,7580,7560,7410,-170,-2.24,7510,-70,-0.92,7400,7700,1399-9-12
394,دسانكو,داروسازي سبحان انكولوژي,906,2288674,40216128271,17185,16361,17290,105,0.61,17461,276,1.61,16361,17990,1399-9-12
395,لوتوس,تامين سرمايه لوتوس پارسيان,905,3847201,60168179260,16330,16020,15520,-810,-4.96,15640,-690,-4.23,15520,16020,1399-9-12
396,كقزوي,شيشه‌ قزوين‌,902,7716076,61731451361,7792,7560,8025,233,2.99,8000,208,2.67,7560,8025,1399-9-12
397,شگل,گلتاش‌,902,3060067,83987596090,26370,26680,27500,1130,4.29,27450,1080,4.1,26010,27680,1399-9-12
398,عيار,صندوق س. پشتوانه طلاي مفيد,894,1492049,42607830559,29437,28501,28499,-938,-3.19,28557,-880,-2.99,28414,28880,1399-9-12
399,بالبر,كابل‌ البرز,894,1904922,45245392090,23490,22710,24050,560,2.38,23710,220,0.94,22710,24460,1399-9-12
400,دامين,داروسازي‌ امين‌,891,2741069,38968159330,14210,13720,13830,-380,-2.67,14210,0,0.0,13720,14520,1399-9-12
401,دعبيد,لابراتوارداروسازي‌  دكترعبيدي‌,881,834862,26016675130,31800,30360,30870,-930,-2.92,31500,-300,-0.94,30360,32400,1399-9-12
402,شلعاب,لعابيران‌,876,4323508,35635306560,8160,8170,8350,190,2.33,8210,50,0.61,7800,8490,1399-9-12
403,كنور,توسعه معدني و صنعتي صبانور,876,954330,44235038250,47110,46900,45340,-1770,-3.76,46500,-610,-1.29,45010,47750,1399-9-12
404,فخاس,فولاد خراسان,876,1492330,47792771660,32570,32400,32950,380,1.17,32330,-240,-0.74,31000,33200,1399-9-12
405,واعتبار,سرمايه گذاري اعتبار ايران,873,10338944,62621240440,5830,6090,6120,290,4.97,6060,230,3.95,5900,6120,1399-9-12
406,كمنگنز,معادن‌منگنزايران‌,870,550090,55656020200,97850,99400,101000,3150,3.22,101160,3310,3.38,98000,102700,1399-9-12
407,رتكو,كنترل‌خوردگي‌تكين‌كو,862,5437125,95908050660,16900,16850,17740,840,4.97,17640,740,4.38,16850,17740,1399-9-12
408,كشرق,صنعتي و معدني شمال شرق شاهرود,840,786380,63252574564,77265,80000,81128,3863,5.0,80435,3170,4.1,77270,81128,1399-9-12
409,شراز,پالايش نفت شيراز,832,544422,56360931980,107190,107200,101831,-5359,-5.0,103524,-3666,-3.42,101831,109990,1399-9-12
410,دكيمي,كيميدارو,826,2228798,58234750160,27330,26500,25970,-1360,-4.98,26130,-1200,-4.39,25970,27850,1399-9-12
411,حپارسا,توسعه حمل و نقل ريلي پارسيان,821,1709415,59643483649,36320,34620,34504,-1816,-5.0,34891,-1429,-3.93,34504,35970,1399-9-12
412,داسوه,داروسازي‌ اسوه‌,808,836986,24703026400,28370,29770,29600,1230,4.34,28870,500,1.76,28920,29770,1399-9-12
413,گوهران,سرمايه گذاري توسعه گوهران اميد,804,2702659,23832847035,8679,8540,8750,71,0.82,8740,61,0.7,8540,9030,1399-9-12
414,غفارس,شير پاستوريزه پگاه فارس,798,3113773,28554547569,9519,9140,9044,-475,-4.99,9319,-200,-2.1,9044,9420,1399-9-12
415,بميلا,توسعه بازرگاني آهن وفولادميلاد,797,3521749,78430801292,22843,22902,22250,-593,-2.6,22270,-573,-2.51,21701,23255,1399-9-12
416,خديزل,بهمن  ديزل,797,1765651,87712806337,49105,48000,49997,892,1.82,49677,572,1.16,48000,51390,1399-9-12
417,ولانا,شركت ليزينگ آريا دانا,797,2494675,48034884377,18865,19270,19200,335,1.78,19255,390,2.07,18300,19430,1399-9-12
418,شيراز,پتروشيمي‌شيراز,794,4181016,245252445370,58970,58970,58000,-970,-1.64,58660,-310,-0.53,56600,59480,1399-9-12
419,كيان,صندوق س. با درآمد ثابت كيان,789,21129694,552622024315,26136,26153,26155,19,0.07,26154,18,0.07,26152,26159,1399-9-12
420,سبهان,سيمان‌ بهبهان‌,779,549417,30868213450,58140,60000,55800,-2340,-4.02,57010,-1130,-1.94,55240,60000,1399-9-12
421,فالوم,آلومتك‌,774,1512727,35704565771,23080,23772,23200,120,0.52,23603,523,2.27,23000,23772,1399-9-12
422,شفن,پتروشيمي فناوران,773,210573,61306125190,298550,293390,289850,-8700,-2.91,294190,-4360,-1.46,285000,299890,1399-9-12
423,قشكر,شكرشاهرود,771,1170774,52089763630,42620,43990,44750,2130,5.0,44490,1870,4.39,42410,44750,1399-9-12
424,سخزر,سيمان‌ خزر,770,1805909,49597032580,26350,27000,27660,1310,4.97,27320,970,3.68,27000,27660,1399-9-12
425,شنفت,نفت‌ پارس‌,760,763920,48315259600,65110,65000,62030,-3080,-4.73,63690,-1420,-2.18,61900,65000,1399-9-12
426,اطلس,صندوق س.توسعه اندوخته آينده-س,758,201452,41890913500,207919,201200,206800,-1119,-0.54,207945,26,0.01,201200,209999,1399-9-12
427,سخاش,سيمان‌خاش‌,758,201915,18494771520,88240,92540,92000,3760,4.26,89380,1140,1.29,89900,92600,1399-9-12
428,ساربيل,سيمان آرتا اردبيل,757,800517,40973594230,53850,51160,51160,-2690,-5.0,51220,-2630,-4.88,51160,52000,1399-9-12
429,شكف,كف,756,829534,53453475168,65566,64255,64255,-1311,-2.0,64438,-1128,-1.72,64255,66790,1399-9-12
430,كپرور,فرآوري زغال سنگ پروده طبس,754,1346467,62441055469,46607,45000,45612,-995,-2.13,46374,-233,-0.5,45000,48000,1399-9-12
431,مارون,پتروشيمي مارون,752,302441,41874840543,137654,138000,137610,-44,-0.03,137961,307,0.22,137001,140591,1399-9-12
432,سشمال,سيمان‌ شمال‌,750,3291202,28938017110,8890,9200,8730,-160,-1.8,8840,-50,-0.56,8600,9200,1399-9-12
433,سرود,سيمان‌شاهرود,748,3257961,48422791030,14330,13810,15040,710,4.95,14810,480,3.35,13810,15040,1399-9-12
434,مفاخر,توسعه فناوري اطلاعات خوارزمي,745,1218956,53620516950,41977,44075,44075,2098,5.0,43888,1911,4.55,43300,44075,1399-9-12
435,كپشير,پشم‌شيشه‌ايران‌,745,3041254,57767520940,18350,19190,18900,550,3.0,18990,640,3.49,18350,19260,1399-9-12
436,كفرآور,فرآورده هاي سيمان شرق,737,2739818,50892556403,19116,18543,18543,-573,-3.0,18575,-541,-2.83,18543,18900,1399-9-12
437,آرمان,بيمه آرمان,731,6927589,68088606849,9554,9830,9840,286,2.99,9829,275,2.88,9554,9840,1399-9-12
438,درازك,دارويي‌ رازك‌,729,1185567,50920696810,42180,42800,42160,-20,-0.05,42920,740,1.75,41500,44280,1399-9-12
439,واميد,گروه مديريت سرمايه گذاري اميد,723,1048026,39502119560,38300,38760,37500,-800,-2.09,38100,-200,-0.52,36500,38760,1399-9-12
440,دسبحان,سبحان دارو,720,1449767,31739226160,22200,21180,21740,-460,-2.07,22020,-180,-0.81,21180,22450,1399-9-12
441,زر,صندوق س.پشتوانه سكه طلاي زر,709,713092,35042919326,51199,50800,49000,-2199,-4.3,49142,-2057,-4.02,48100,50800,1399-9-12
442,غمارگ,مارگارين‌,701,2145491,79653661850,35420,37000,37190,1770,5.0,37130,1710,4.83,35500,37190,1399-9-12
443,سيستم,همكاران سيستم,700,789731,26208821270,34170,32750,33700,-470,-1.38,33700,-470,-1.38,32640,34010,1399-9-12
444,دكپسول,توليد ژلاتين كپسول ايران,696,867254,32931908874,38652,40400,37402,-1250,-3.23,38230,-422,-1.09,36730,40400,1399-9-12
445,دابور,داروسازي‌ ابوريحان‌,692,663301,31494568680,46970,47000,47060,90,0.19,47290,320,0.68,46100,48800,1399-9-12
446,دروز,داروسازي‌ روزدارو,677,1100735,20097967960,17450,18320,18320,870,4.99,17740,290,1.66,17800,18320,1399-9-12
447,دسبحا,گروه دارويي سبحان,672,2005990,39547784830,20130,19680,19140,-990,-4.92,19830,-300,-1.49,19130,20080,1399-9-12
448,شساخت,مهندسي و ساختمان صنايع نفت,664,3155968,125427855872,38614,39772,39772,1158,3.0,39743,1129,2.92,38301,39772,1399-9-12
449,كاريس,صندوق س.سپهر كاريزما-س,664,360619,75320200898,211857,210997,206000,-5857,-2.76,208864,-2993,-1.41,205500,213535,1399-9-12
450,جم پيلن,پلي پروپيلن جم - جم پيلن,654,883561,77194386480,87650,88000,87310,-340,-0.39,87370,-280,-0.32,85000,89000,1399-9-12
451,سكه0012پ01,سكه تمام بهارتحويلي 1روزه رفاه,648,198900,228030716400,1153589,1153500,1145000,-8589,-0.74,1146459,-7130,-0.62,1135010,1153500,1399-9-12
452,وسرضوي,س.سهام عدالت استان خراسان رضوي,640,14296010,14290223680,1030,1070,990,-40,-3.88,1030,0,0.0,980,1070,1399-9-12
453,بساما,بيمه سامان,639,17890025,565521580275,30106,31611,31611,1505,5.0,31611,1505,5.0,31611,31611,1399-9-12
454,كفرا,فراورده‌ هاي‌ نسوزايران‌,629,808494,42058383200,51990,53000,51880,-110,-0.21,52010,20,0.04,51290,53000,1399-9-12
455,تكنار,مجتمع معادن مس تكنار,622,536253,54363335438,98709,99716,101670,2961,3.0,101376,2667,2.7,95801,101670,1399-9-12
456,سهگمت,سيمان‌هگمتان‌,609,1490919,35028863860,22630,23000,23590,960,4.24,23210,580,2.56,22950,24140,1399-9-12
457,وكادو,تكادو,604,2756689,53837370535,18694,19628,19628,934,5.0,19530,836,4.47,19000,19628,1399-9-12
458,چفيبر,فيبر ايران‌,597,4364902,29698958550,6830,7030,6510,-320,-4.69,6810,-20,-0.29,6490,7030,1399-9-12
459,خمحور,توليدمحورخودرو,592,517716,33740257020,64200,63670,67100,2900,4.52,65770,1570,2.45,63640,67250,1399-9-12
460,زماهان,مجتمع توليد گوشت مرغ ماهان,592,1201310,31413584180,24905,26150,26150,1245,5.0,25595,690,2.77,25900,26150,1399-9-12
461,پرداخت,به پرداخت ملت,589,465844,21784906600,47270,47460,46900,-370,-0.78,47060,-210,-0.44,45000,48900,1399-9-12
462,بسويچ,پارس‌سويچ‌,588,433949,18555377000,44390,42300,42850,-1540,-3.47,43790,-600,-1.35,42180,44000,1399-9-12
463,زعف0008پ10,زعفران0008نگين طلاي سرخ(پ),584,465074,61995211620,132480,130407,134150,1670,1.26,133302,822,0.62,130407,134229,1399-9-12
464,سبجنو,سيمان‌ بجنورد,581,745505,26209675120,33600,35250,35280,1680,5.0,34330,730,2.17,33860,35280,1399-9-12
465,وارس,سرمايه گذاري ارس صبا,579,490996,47264760529,98871,99890,95905,-2966,-3.0,96263,-2608,-2.64,95905,99890,1399-9-12
466,ساراب,سيمان‌ داراب‌,579,2040797,25219947770,12380,12790,12400,20,0.16,12370,-10,-0.08,12010,12870,1399-9-12
467,ركيش,كارت اعتباري ايران كيش,577,2551962,42995954000,16600,17100,16590,-10,-0.06,16800,200,1.2,16590,17100,1399-9-12
468,وحافظ,بيمه حافظ,559,1464366,84841758276,56263,57950,57950,1687,3.0,57938,1675,2.98,57000,57950,1399-9-12
469,آساميد,صندوق س.مشترك آسمان اميد -د,555,35432245,394208344368,11113,11126,11126,13,0.12,11126,13,0.12,11120,11131,1399-9-12
470,اتكاي,بيمه اتكايي ايرانيان,552,7155572,108428339626,14467,14600,15190,723,5.0,15153,686,4.74,14500,15190,1399-9-12
471,دفرا,فرآورده‌هاي‌ تزريقي‌ ايران‌,552,1846741,49841532490,25930,26470,27220,1290,4.97,26880,950,3.66,25400,27220,1399-9-12
472,هجرت,پخش هجرت,543,440107,28805311433,65327,65300,63592,-1735,-2.66,65396,69,0.11,63003,67500,1399-9-12
473,دپارس,پارس‌ دارو,537,393632,40502743060,107800,107000,102410,-5390,-5.0,103640,-4160,-3.86,102410,107000,1399-9-12
474,ولملت,واسپاري ملت,531,2841151,31825975530,10950,11430,11220,270,2.47,11090,140,1.28,10500,11430,1399-9-12
475,نتوس,پشم‌ بافي‌ توس,526,1464236,14420176741,10149,9845,9845,-304,-3.0,9915,-234,-2.31,9845,9865,1399-9-12
476,اوان,مبين وان كيش,526,927013,63644219476,66976,68644,68290,1314,1.96,68655,1679,2.51,66976,69990,1399-9-12
477,غپونه,نوش پونه مشهد,525,2335178,39357782022,17348,16830,16828,-520,-3.0,16854,-494,-2.85,16828,17210,1399-9-12
478,قشهد,شهد,518,1491162,44948804270,29480,28150,30950,1470,4.99,30050,570,1.93,28010,30950,1399-9-12
479,وسنا,سرمايه گذاري نيروگاهي ايران,513,1987440,29609289610,14236,14940,14947,711,4.99,14898,662,4.65,14400,14947,1399-9-12
480,ثزاگرس,سرمايه گذاري توسعه عمران زاگرس,508,931540,35112634878,36411,36040,38231,1820,5.0,37693,1282,3.52,35200,38231,1399-9-12
481,افق ملت,صندوق س در سهام افق ملت,505,165630,23086498770,139750,139000,137900,-1850,-1.32,139390,-360,-0.26,137900,141500,1399-9-12
482,گوهر,صندوق سكه طلاي كيان,503,1562656,89052665842,58329,57150,57000,-1329,-2.28,56988,-1341,-2.3,56102,58000,1399-9-12
483,سباقر,سيمان باقران,486,1724137,25101380805,14803,15129,14499,-304,-2.05,14559,-244,-1.65,14359,15129,1399-9-12
484,لپيام,گسترش صنايع پيام,478,866436,23653347187,26597,27300,27394,797,3.0,27300,703,2.64,25900,27394,1399-9-12
485,وآتوس,س.آرين توسكا قيمت اسمي 350ريال,477,1248028,43863236691,33479,35152,35152,1673,5.0,35146,1667,4.98,33680,35152,1399-9-12
486,آتيمس,صندوق س.آرمان آتيه درخشان مس-س,475,114173,25312950512,224200,220010,218000,-6200,-2.77,221707,-2493,-1.11,210000,225000,1399-9-12
487,سصوفي,سيمان‌ صوفيان‌,466,2907977,45007821020,14750,15480,15480,730,4.95,15320,570,3.86,15040,15480,1399-9-12
488,حخزر,كشتيراني درياي خزر,465,820603,22676929450,26578,27800,26980,402,1.51,27008,430,1.62,26500,27906,1399-9-12
489,خراسان,پتروشيمي خراسان,465,770722,58764639670,76460,75600,76540,80,0.1,76250,-210,-0.27,74000,78000,1399-9-12
490,خلنت,لنت‌ ترمزايران‌,453,239667,18572065420,78460,75000,78400,-60,-0.08,78090,-370,-0.47,74540,80500,1399-9-12
491,شاملا,معدني‌ املاح‌  ايران‌,452,454867,29415570640,62640,65770,64170,1530,2.44,63760,1120,1.79,63210,65770,1399-9-12
492,سپاس,صندوق س. پاداش سهامداري توسعه1,450,18883200,191862424913,10144,10156,10154,10,0.1,10160,16,0.16,10148,10200,1399-9-12
493,گشان,توسعه بين المللي پديده شانديز,450,127202,9536461142,76501,74971,74971,-1530,-2.0,76173,-328,-0.43,74971,74971,1399-9-12
494,پارتا,مجتمع‌صنعتي‌آرتاويل‌تاير,443,565170,31791396887,57953,58010,56215,-1738,-3.0,56251,-1702,-2.94,56215,58010,1399-9-12
495,شفا,سرمايه گذاري شفادارو,443,286015,16074707980,58660,58000,55830,-2830,-4.82,57890,-770,-1.31,55730,58000,1399-9-12
496,قمرو,قند مرودشت‌,439,591735,15678192660,27030,27030,26330,-700,-2.59,26860,-170,-0.63,26200,27030,1399-9-12
497,شپلي,پلي اكريل ايران,439,3862970,31243701360,7853,8088,8088,235,2.99,8088,235,2.99,8088,8088,1399-9-12
498,سكرما,سيمان‌ كرمان‌,437,1718104,26034768150,15030,14530,14980,-50,-0.33,15090,60,0.4,14320,15500,1399-9-12
499,تسه9907,امتياز تسهيلات مسكن مهر99,435,4851,3169137683,628494,604500,659918,31424,5.0,653296,24802,3.95,604500,659918,1399-9-12
500,آسيا,بيمه آسيا,432,1019975,36708900250,34280,35990,35990,1710,4.99,35310,1030,3.0,35990,35990,1399-9-12
501,قلرست,قند لرستان‌,428,1443623,40950095370,27100,28240,28450,1350,4.98,27980,880,3.25,27510,28450,1399-9-12
502,وسفارس,شركت س استان فارس,428,6601275,6851255970,1030,1080,1000,-30,-2.91,1030,0,0.0,980,1080,1399-9-12
503,زنجان,صنايع كشاورزي وكود زنجان,426,2803735,25600904285,8866,9131,9131,265,2.99,9131,265,2.99,9131,9131,1399-9-12
504,فاسمين,كالسيمين‌,424,3355440,60431474400,17160,18010,18010,850,4.95,18000,840,4.9,18010,18010,1399-9-12
505,سكه9912پ04,سكه تمام بهارتحويل1روزه صادرات,419,198900,227423514800,1153589,1153600,1142999,-10590,-0.92,1143406,-10183,-0.88,1130000,1153600,1399-9-12
506,ثفارس,عمران‌وتوسعه‌فارس‌,407,4300328,36122755200,8000,8400,8400,400,5.0,8250,250,3.13,8400,8400,1399-9-12
507,ثعتما,س. ساختماني اعتماد گستر,402,1072633,43243401943,39190,38400,40365,1175,3.0,40315,1125,2.87,38400,40365,1399-9-12
508,كي بي سي,شركت كي بي سي,401,674032,20626928382,31576,30200,30400,-1176,-3.72,31198,-378,-1.2,30089,31410,1399-9-12
509,ضجار1016,اختيارخ وتجارت-4000-1399/10/21,399,17244,7448077000,459,449,412,-47,-10.24,432,-27,-5.88,380,473,1399-9-12
510,قپيرا,فرآورده‌هاي‌غدايي‌وقندپيرانشهر,396,172570,14722032680,88040,87000,87200,-840,-0.95,87210,-830,-0.94,83700,87370,1399-9-12
511,سهرمز,سيمان‌هرمزگان‌,390,1332600,25361671830,18930,19000,18900,-30,-0.16,18980,50,0.26,18210,19400,1399-9-12
512,ثجوان,تامين مسكن جوانان,389,4233923,35092105332,7910,8300,8305,395,4.99,8288,378,4.78,8000,8305,1399-9-12
513,كدما,معدني‌ دماوند,388,299371,79692560200,253530,266200,266200,12670,5.0,266200,12670,5.0,266200,266200,1399-9-12
514,وهنر,گروه توسعه هنر ايران,385,9793571,44041220067,4385,4260,4516,131,2.99,4497,112,2.55,4256,4516,1399-9-12
515,آساس,صندوق س.آسمان آرماني سهام-س,377,227646,39337998268,172055,172000,170339,-1716,-1.0,172803,748,0.43,170200,174449,1399-9-12
516,تسه9902,امتياز تسهيلات مسكن ارديبهشت99,376,5505,3559339221,633314,620000,645002,11688,1.85,646565,13251,2.09,620000,664979,1399-9-12
517,ولتجار,واسپاري تجارت وسرمايه ايرانيان,375,2954160,18990143217,6253,6390,6440,187,2.99,6404,151,2.41,6172,6440,1399-9-12
518,گپارس,امور رفاهي كارگزاران پارس,364,172752,23165940782,130347,134257,134257,3910,3.0,134099,3752,2.88,131500,134257,1399-9-12
519,سغرب,سيمان‌غرب‌,363,1874933,36690350870,18640,19570,19570,930,4.99,19260,620,3.33,19480,19570,1399-9-12
520,كيسون,شركت كيسون,361,3872374,58008162520,14544,14980,14980,436,3.0,14980,436,3.0,14980,14980,1399-9-12
521,دسينا,داروسازي‌ سينا,361,778807,21661445610,28120,28120,27890,-230,-0.82,27990,-130,-0.46,27500,28200,1399-9-12
522,تملتح,ح . تامين سرمايه بانك ملت,360,8147899,65183192000,8000,8000,8000,0,0.0,8000,0,0.0,8000,8000,1399-9-12
523,ونفت,سرمايه‌گذاري‌ صنعت‌ نفت‌,358,1677284,27556441830,15950,16590,16360,410,2.57,16170,220,1.38,16000,16600,1399-9-12
524,سجام,مجتمع سيمان غرب آسيا,355,2196268,32132363013,14571,14571,14600,29,0.2,14630,59,0.4,14300,14890,1399-9-12
525,ضپاس1002,اختيارخ وپارس-3000-1399/10/30,355,11068,16343085000,1398,1400,1420,22,1.57,1477,79,5.65,1350,1550,1399-9-12
526,شلرد,كود شيميايي اوره لردگان,353,4252613,42789792006,9769,10062,10062,293,3.0,10062,293,3.0,10062,10062,1399-9-12
527,دارا,صندوق س. دارا الگوريتم-د,338,9831075,98516544501,10022,10035,10026,4,0.04,10021,-1,-0.01,10007,10035,1399-9-12
528,ولراز,ليزينگ رازي,337,465098,16570954799,34674,35714,35714,1040,3.0,35368,694,2.0,35100,35714,1399-9-12
529,غمهرا,توليدي‌مهرام‌,334,318477,18475284060,55360,58120,58110,2750,4.97,56230,870,1.57,55910,58120,1399-9-12
530,ساينا,صنايع بهداشتي ساينا,331,58868,10909564200,189017,190000,185250,-3767,-1.99,188199,-818,-0.43,182500,190000,1399-9-12
531,دارو,كارخانجات‌داروپخش‌,327,208695,11560492950,55350,53350,55190,-160,-0.29,55360,10,0.02,53350,56500,1399-9-12
532,سامان,بانك سامان,327,1105846,13044559416,11453,11796,11796,343,2.99,11535,82,0.72,11796,11796,1399-9-12
533,دلر,داروسازي‌ اكسير,326,163302,18035062170,112390,109010,111010,-1380,-1.23,111660,-730,-0.65,109010,113780,1399-9-12
534,فنفت,صنايع تجهيزات نفت,323,3619455,51330881950,14314,14699,14400,86,0.6,14182,-132,-0.92,14000,14730,1399-9-12
535,حپترو,حمل و نقل پتروشيمي( سهامي عام,319,674583,17513273840,26510,25630,25880,-630,-2.38,26320,-190,-0.72,25630,26670,1399-9-12
536,خكرمان,گروه اقتصادي كرمان خودرو,319,4301984,23389887008,5279,5437,5437,158,2.99,5437,158,2.99,5437,5437,1399-9-12
537,وتعاون,بيمه  تعاون,317,1727040,12090562964,7011,7000,6976,-35,-0.5,7005,-6,-0.09,6820,7120,1399-9-12
538,سكه0011پ02,سكه تمام بهارتحويلي 1روزه ملت,310,112600,128823864400,1153589,1155000,1146000,-7589,-0.66,1144084,-9505,-0.82,1120000,1156000,1399-9-12
539,خنصير,مهندسي‌نصيرماشين‌,309,912555,41439122550,47790,45410,45410,-2380,-4.98,45720,-2070,-4.33,45410,45410,1399-9-12
540,سيمرغ,سيمرغ,297,1768250,31333390000,16880,17720,17720,840,4.98,17350,470,2.78,17720,17720,1399-9-12
541,سفاسي,شركت فارسيت اهواز,291,1840170,23416163250,12355,12725,12725,370,2.99,12725,370,2.99,12725,12725,1399-9-12
542,ونيكي,سرمايه‌گذاري‌ ملي‌ايران‌,289,1322085,21761519100,15680,16460,16460,780,4.97,15840,160,1.02,16460,16460,1399-9-12
543,كوثر,بيمه كوثر,285,3274971,57223568283,16641,17473,17473,832,5.0,17473,832,5.0,17473,17473,1399-9-12
544,لابسا,آبسال‌,282,692571,26293313400,36210,38010,38020,1810,5.0,37010,800,2.21,36800,38020,1399-9-12
545,غديس,پاكديس,279,774526,10245429928,13924,13228,13228,-696,-5.0,13767,-157,-1.13,13228,13228,1399-9-12
546,وساغربي,شركت س استان آذربايجان غربي,278,10673451,9441528480,890,880,890,0,0.0,890,0,0.0,870,910,1399-9-12
547,وسكرمان,س.سهام عدالت استان كرمان,276,13279706,13357097310,990,990,1030,40,4.04,990,0,0.0,970,1030,1399-9-12
548,بمپنا,توليد برق عسلويه  مپنا,274,90001,8483410869,95635,95635,91900,-3735,-3.91,95415,-220,-0.23,90854,96700,1399-9-12
549,تسه9709,امتياز تسهيلات مسكن آذر97,273,5326,3045807327,553498,538000,581172,27674,5.0,571875,18377,3.32,538000,581172,1399-9-12
550,وثوق,سرمايه گذاري وثوق امين,273,968305,11371773920,11402,11744,11744,342,3.0,11577,175,1.53,11744,11744,1399-9-12
551,ضپاس1005,اختيارخ وپارس-4500-1399/10/30,272,14005,6678081000,450,580,470,20,4.44,477,27,6.0,404,580,1399-9-12
552,شكبير,پتروشيمي اميركبير,268,366853,20877383116,55388,55600,57040,1652,2.98,55776,388,0.7,55071,57049,1399-9-12
553,سفار,سيمان‌فارس‌,268,117079,9704575260,83470,81100,82300,-1170,-1.4,83360,-110,-0.13,80200,85800,1399-9-12
554,آكورد,صندوق س. آرمان آتي كوثر-د,266,7896664,233278054092,29531,29545,29553,22,0.07,29541,10,0.03,29500,29600,1399-9-12
555,تسه9906,امتياز تسهيلات مسكن شهريور99,266,3997,2634374238,643996,630000,640000,-3996,-0.62,659088,15092,2.34,621000,676195,1399-9-12
556,صايند,صندوق س. گنجينه آينده روشن-د,262,6307640,63042943820,9962,9991,9980,18,0.18,9995,33,0.33,9962,10000,1399-9-12
557,بايكا,كارخانجات كابلسازي ‌ايران‌,261,401561,21377501396,50701,53236,53236,2535,5.0,53025,2324,4.58,53236,53236,1399-9-12
558,ولبهمن,شركت بهمن ليزينگ,260,6932598,69007080492,9480,9954,9954,474,5.0,9954,474,5.0,9954,9954,1399-9-12
559,نيرو,نيرو سرمايه,254,268512,12465818462,45084,46436,46436,1352,3.0,45870,786,1.74,44510,46436,1399-9-12
560,تشتاد,صنايع توليدي اشتاد ايران‌,250,787811,12474907314,15446,14988,15909,463,3.0,15674,228,1.48,14988,15909,1399-9-12
561,ضصاد1102,اختيارخ وبصادر-3500-1399/11/12,248,8252,4946912000,620,600,580,-40,-6.45,599,-21,-3.39,571,639,1399-9-12
562,شپترو,پتروشيمي آبادان,246,4073542,19304515538,4601,4739,4739,138,3.0,4718,117,2.54,4739,4739,1399-9-12
563,كيميا,معدني كيمياي زنجان گستران,241,819801,25858613578,30846,32000,31400,554,1.8,31142,296,0.96,30846,32000,1399-9-12
564,قشير,قند شيروان قوچان و بجنورد,235,737734,25553630292,36461,34638,34638,-1823,-5.0,35404,-1057,-2.9,34638,34638,1399-9-12
565,تپولا,مهندسي مرآت پولاد,230,749312,22700407040,29413,30295,30295,882,3.0,30295,882,3.0,30295,30295,1399-9-12
566,ياقوت,صندوق س ياقوت آگاه-ثابت,227,6348724,72746755734,11454,11453,11485,31,0.27,11458,4,0.03,11453,11487,1399-9-12
567,اميدح,ح . تامين سرمايه اميد,221,3811792,40057121440,10500,10500,10500,0,0.0,10510,10,0.1,10500,11550,1399-9-12
568,شفارا,پتروشيمي فارابي,220,1363239,6529914810,4938,4790,4790,-148,-3.0,4886,-52,-1.05,4790,4790,1399-9-12
569,كاسپين,داروسازي كاسپين تامين,213,264736,7203511321,27363,28000,26374,-989,-3.61,27343,-20,-0.07,26070,28000,1399-9-12
570,ثاصفا,شركت‌ ساختمان‌ اصفهان‌,206,598947,21678886665,35141,36195,36195,1054,3.0,36130,989,2.81,36195,36195,1399-9-12
571,ضپاس1003,اختيارخ وپارس-3500-1399/10/30,205,6745,6922419000,1077,1100,980,-97,-9.01,1026,-51,-4.74,701,1199,1399-9-12
572,تسه9905,امتياز تسهيلات مسكن مرداد99,202,2242,1472435542,632920,611155,630000,-2920,-0.46,656751,23831,3.77,611155,664566,1399-9-12
573,پارند2,صندوق س. پارند پايدار سپهر,200,20000000,20000000,11400,1,1,-11399,-99.99,1,-11399,-99.99,1,1,1399-9-12
574,سصفها,سيمان‌اصفهان‌,199,420364,91433373640,207160,217510,217510,10350,5.0,217510,10350,5.0,217510,217510,1399-9-12
575,داوه,داروسازي آوه سينا,197,706218,12143418510,16377,17195,17195,818,4.99,16557,180,1.1,17195,17195,1399-9-12
576,اعتلا,شركت سرمايه گذاري اعتلاء البرز,195,3396735,31569255090,8852,9294,9294,442,4.99,9093,241,2.72,9294,9294,1399-9-12
577,تسه9904,امتياز تسهيلات مسكن تير99,191,1536,1004578872,629793,636500,640000,10207,1.62,654023,24230,3.85,636500,661282,1399-9-12
578,وپخش,داروپخش‌ (هلدينگ‌,184,61058,8254227990,136150,135000,133910,-2240,-1.65,136000,-150,-0.11,130200,137500,1399-9-12
579,غپآذر,شير پگاه آذربايجان شرقي,182,244344,13877273136,59783,56794,56794,-2989,-5.0,59049,-734,-1.23,56794,56794,1399-9-12
580,وملت,سرمايه گذاري ملت,179,1837662,7874381670,4372,4285,4285,-87,-1.99,4302,-70,-1.6,4285,4285,1399-9-12
581,تسه9810,امتياز تسهيلات مسكن دي98,173,3137,2014356218,625256,620000,656000,30744,4.92,642128,16872,2.7,595000,656518,1399-9-12
582,دقاضي,داروسازي شهيد قاضي,173,93697,8386258450,87114,89727,89727,2613,3.0,88064,950,1.09,87800,89727,1399-9-12
583,سمتاز,سيمان ممتازان كرمان,172,368765,7803152804,21066,20435,21389,323,1.53,21104,38,0.18,20435,21500,1399-9-12
584,افران,صندوق س افرا نماد پايدار-ثابت,168,5017983,61356540811,12230,12230,12210,-20,-0.16,12227,-3,-0.02,12210,12241,1399-9-12
585,ضخود1042,اختيارخ خودرو-3000-1399/10/07,163,3803,4204097000,1154,1083,1051,-103,-8.93,1105,-49,-4.25,1041,1190,1399-9-12
586,ختراك,ريخته‌گري‌ تراكتورسازي‌ ايران‌,160,1306572,14960249400,10910,11450,11450,540,4.95,11050,140,1.28,11450,11450,1399-9-12
587,وسگيلا,شركت س استان گيلان,159,6323446,5623677720,900,880,880,-20,-2.22,900,0,0.0,870,910,1399-9-12
588,زعف0008پ11,زعفران0008نگين سحرخيز(پ),156,71562,9036849136,127838,126200,126303,-1535,-1.2,126280,-1558,-1.22,125130,129900,1399-9-12
589,شپاس,نفت پاسارگاد,155,823547,17461667041,20194,21203,21203,1009,5.0,20501,307,1.52,21203,21203,1399-9-12
590,آبين,كشت و صنعت آبشيرين,154,3094424,12612872224,3958,4076,4076,118,2.98,4022,64,1.62,4076,4076,1399-9-12
591,بنو,بيمه تجارت نو,154,1974698,51877291158,25020,26271,26271,1251,5.0,26117,1097,4.38,26271,26271,1399-9-12
592,وتوكا,سرمايه‌گذاري‌توكافولاد(هلدينگ,154,1283872,14597624640,10830,11370,11370,540,4.99,10970,140,1.29,11370,11370,1399-9-12
593,دشيري,شيرين دارو,152,41713,6590103021,158657,155600,157200,-1457,-0.92,158439,-218,-0.14,155600,160210,1399-9-12
594,وسرمد,بيمه  سرمد,150,2496164,16634436896,6470,6664,6664,194,3.0,6620,150,2.32,6664,6664,1399-9-12
595,نمرينو,ايران‌ مرينوس‌,150,110486,6031336190,57330,54470,54470,-2860,-4.99,56980,-350,-0.61,54470,55600,1399-9-12
596,ساذريح,ح . آذريت‌,148,967189,5132328898,5423,5265,5261,-162,-2.99,5306,-117,-2.16,5261,5440,1399-9-12
597,ضجار1014,اختيارخ وتجارت-3000-1399/10/21,147,3617,3863908000,1088,1140,992,-96,-8.82,1068,-20,-1.84,989,1140,1399-9-12
598,ضخود1045,اختيارخ خودرو-4500-1399/10/07,147,5332,1498102000,306,297,270,-36,-11.76,281,-25,-8.17,250,318,1399-9-12
599,بنيرو,نيروترانس‌,145,526180,28782046000,52100,54700,54700,2600,4.99,53390,1290,2.48,54700,54700,1399-9-12
600,ضصاد1104,اختيارخ وبصادر-4500-1399/11/12,143,7522,1695137000,240,230,221,-19,-7.92,225,-15,-6.25,210,239,1399-9-12
601,سقاين,سيمان‌ قائن‌,143,517621,23261887740,42800,44940,44940,2140,5.0,43680,880,2.06,44940,44940,1399-9-12
602,مداران,داده‌پردازي‌ايران‌,143,581545,14201328900,23260,24420,24420,1160,4.99,23550,290,1.25,24420,24420,1399-9-12
603,واحصا,احياء صنايع خراسان,142,590000,15038510000,24747,25489,25489,742,3.0,25247,500,2.02,25489,25489,1399-9-12
604,تسه9903,امتياز تسهيلات مسكن خرداد99,132,849,554600326,638217,607323,611223,-26994,-4.23,653239,15022,2.35,607323,670127,1399-9-12
605,ضخود1043,اختيارخ خودرو-3500-1399/10/07,132,3992,3089863000,780,794,683,-97,-12.44,774,-6,-0.77,652,836,1399-9-12
606,تسه9811,امتياز تسهيلات مسكن بهمن98,130,1484,971143410,644802,640226,644802,0,0.0,654409,9607,1.49,614155,677042,1399-9-12
607,كخاك,صنايع‌خاك‌چيني‌ايران‌,130,667150,30949088500,44190,46390,46390,2200,4.98,45400,1210,2.74,46390,46390,1399-9-12
608,بذر,صندوق س بذر اميد آفرين-سهام,127,38407,4349336680,112540,112090,111170,-1370,-1.22,113240,700,0.62,111100,114800,1399-9-12
609,الماس,صندوق س.امين تدبيرگران فردا-س,127,28990,3688019492,125942,129998,127000,1058,0.84,127217,1275,1.01,125300,129998,1399-9-12
610,تسه9710,امتياز تسهيلات مسكن دي 97,125,1210,823746630,651820,624000,684411,32591,5.0,680782,28962,4.44,624000,684411,1399-9-12
611,فاهواز,نورد و لوله اهواز,124,329208,6199974264,19617,18833,18833,-784,-4.0,19503,-114,-0.58,18833,18833,1399-9-12
612,ارمغان,ص سرمايه گذاري ارمغان ايرانيان,123,3110486,31575580875,10149,10165,10151,2,0.02,10151,2,0.02,10149,10165,1399-9-12
613,ضفلا1155,اختيارخ فولاد-14000-1399/11/28,122,1989,4849510000,2573,2799,2430,-143,-5.56,2438,-135,-5.25,2000,2799,1399-9-12
614,ضملت1128,اختيارخ وبملت-6000-1399/11/28,122,6335,5543191000,895,850,870,-25,-2.79,875,-20,-2.23,850,959,1399-9-12
615,اوصتا,صندوق انديشه ورزان صباتامين -د,119,5018771,86413250064,17204,17211,17224,20,0.12,17218,14,0.08,17210,17224,1399-9-12
616,ضصاد1103,اختيارخ وبصادر-4000-1399/11/12,118,4985,1938805000,413,410,370,-43,-10.41,389,-24,-5.81,345,420,1399-9-12
617,ساروج,بين المللي ساروج بوشهر,117,255738,4708317810,18399,18189,18900,501,2.72,18402,3,0.02,17848,18950,1399-9-12
618,ضخود1048,اختيارخ خودرو-7000-1399/10/07,117,6070,159120000,31,31,25,-6,-19.35,26,-5,-16.13,23,32,1399-9-12
619,تصميم,صندوق س با درآمد ثابت تصميم,116,1641461,24573361279,14960,14980,15000,40,0.27,14970,10,0.07,14723,15010,1399-9-12
620,صنوين,صندوق سرمايه‌گذاري صنوين-مختلط,116,33315,3458221630,104160,104500,103100,-1060,-1.02,103800,-360,-0.35,103020,104900,1399-9-12
621,خفولا,خدمات فني فولاد يزد,108,299687,10576253917,34264,35291,35291,1027,3.0,34751,487,1.42,35291,35291,1399-9-12
622,سكه0112پ03,سكه تمام بهارتحويلي1روزه سامان,107,26800,30728111800,1153589,1153589,1146000,-7589,-0.66,1146571,-7018,-0.61,1135001,1153589,1399-9-12
623,شجم,صنايع پتروشيمي تخت جمشيد,106,1490106,13224690750,8617,8875,8875,258,2.99,8765,148,1.72,8875,8875,1399-9-12
624,سلار,شركت سيمان لارستان,103,459824,15504805456,32737,33719,33719,982,3.0,33406,669,2.04,33719,33719,1399-9-12
625,وسيستا,شركت س استان سيستان وبلوچستان,103,3784692,3352466260,890,880,890,0,0.0,890,0,0.0,870,900,1399-9-12
626,بموتو,موتوژن‌,103,179106,8389325040,44610,46840,46840,2230,5.0,44950,340,0.76,46840,46840,1399-9-12
627,وحكمت,بيمه حكمت صبا,102,584178,3119510520,5621,5340,5340,-281,-5.0,5573,-48,-0.85,5340,5340,1399-9-12
628,ضجار1015,اختيارخ وتجارت-3500-1399/10/21,101,2936,2094652000,759,656,682,-77,-10.14,713,-46,-6.06,656,776,1399-9-12
629,كگهر,سنگ آهن گهرزمين,101,125280,5620812480,42730,44866,44866,2136,5.0,42823,93,0.22,44866,44866,1399-9-12
630,كصدف,كاشي صدف سرام استقلال آباده,100,806071,16496243015,19869,20465,20465,596,3.0,20332,463,2.33,20465,20465,1399-9-12
631,تماوند,تامين سرمايه دماوند,100,5299685,74725558500,13033,14100,14100,1067,8.19,14100,1067,8.19,14100,14100,1399-9-12
632,گوهر2,صندوق سكه طلاي كيان,100,1000000,1000000,58329,1,1,-58328,-100.0,1,-58328,-100.0,1,1,1399-9-12
633,وثنو,سرمايه گذاري ساختماني نوين,100,945072,15130602720,15248,16010,16010,762,5.0,15735,487,3.19,16010,16010,1399-9-12
634,تسه9812,امتياز تسهيلات مسكن اسفند98,99,1493,946323214,615233,591000,620000,4767,0.77,633840,18607,3.02,591000,645994,1399-9-12
635,سدشت,صنايع سيمان دشتستان,99,228969,8629661370,38290,37330,38190,-100,-0.26,38190,-100,-0.26,37330,38930,1399-9-12
636,فيروزا,صندوق بادرآمد ثابت فيروزه آسيا,98,446042,9566211665,21397,21400,21580,183,0.86,21447,50,0.23,21400,21600,1399-9-12
637,ضفلا1156,اختيارخ فولاد-16000-1399/11/28,97,2037,3200650000,1659,1690,1590,-69,-4.16,1571,-88,-5.3,1400,1790,1399-9-12
638,ضپاس1001,اختيارخ وپارس-2500-1399/10/30,94,3503,6729813000,1605,1900,1901,296,18.44,1921,316,19.69,1704,1998,1399-9-12
639,تسه9711,امتياز تسهيلات مسكن بهمن 97,93,671,460853810,654353,625700,687070,32717,5.0,686816,32463,4.96,625700,687070,1399-9-12
640,سپر,صندوق س سپر سرمايه بيدار- ثابت,92,264938,2842871668,10742,11000,10650,-92,-0.86,10730,-12,-0.11,10611,11000,1399-9-12
641,زعف0008پ05,زعفران0008نگين زرين(پ),86,81471,10262021239,127691,127500,126300,-1391,-1.09,125959,-1732,-1.36,125200,127500,1399-9-12
642,تسه9712,امتياز تسهيلات مسكن اسفند97,85,847,593838714,668849,637032,702291,33442,5.0,701108,32259,4.82,637032,702291,1399-9-12
643,ورازي,بيمه رازي,85,628664,7680388088,12859,12217,12217,-642,-4.99,12566,-293,-2.28,12217,12217,1399-9-12
644,وسهمدا,شركت س استان همدان,83,1604148,1426552570,900,900,890,-10,-1.11,900,0,0.0,880,910,1399-9-12
645,تسه9901,امتياز تسهيلات مسكن فروردين99,82,650,423431968,631502,601122,650001,18499,2.93,651434,19932,3.16,601122,663077,1399-9-12
646,ضفار1125,اختيارخ فارس-17826-1399/11/07,80,1746,2729530000,706,964,694,-12,-1.7,782,76,10.76,570,1000,1399-9-12
647,ثروتم,صندوق س. ثروت آفرين پارسيان-س,79,40860,4116124910,102910,101500,100150,-2760,-2.68,100737,-2173,-2.11,100000,102980,1399-9-12
648,كيان2,صندوق س. با درآمد ثابت كيان,77,7700000,7700000,26136,1,1,-26135,-100.0,1,-26135,-100.0,1,1,1399-9-12
649,وسخوز,شركت س استان خوزستان,77,1327782,1234837260,970,930,930,-40,-4.12,970,0,0.0,930,930,1399-9-12
650,شتولي,تولي‌پرس‌,73,102987,2560063522,24422,24910,24910,488,2.0,24528,106,0.43,24422,24910,1399-9-12
651,دمعيار,صندوق س. توازن معيار-د,71,2522204,25352375774,10049,10055,10054,5,0.05,10052,3,0.03,10045,10064,1399-9-12
652,سنوين,سرمايه گذاري اقتصاد نوين,70,693979,6927500680,9878,10075,10070,192,1.94,9945,67,0.68,9975,10075,1399-9-12
653,وجامي,سرمايه گذاري جامي,69,463457,4422770151,9266,9543,9543,277,2.99,9322,56,0.6,9543,9543,1399-9-12
654,ضشنا1036,اختيارخ شپنا-16000-1399/10/23,68,616,2407956000,4244,4000,3790,-454,-10.7,3909,-335,-7.89,3550,4690,1399-9-12
655,شصفها,پتروشيمي‌ اصفهان‌,65,79319,7946494696,98220,100184,100184,1964,2.0,99518,1298,1.32,100184,100184,1399-9-12
656,تسه9803,امتياز تسهيلات مسكن خرداد98,64,554,355587437,614398,600500,620000,5602,0.91,641855,27457,4.47,600500,645117,1399-9-12
657,ضخود1046,اختيارخ خودرو-5000-1399/10/07,64,2014,300000000,160,189,160,0,0.0,149,-11,-6.88,131,189,1399-9-12
658,زعف0008پ08,زعفران0008نگين روستا(پ),64,51529,6346818731,10000,123101,125000,115000,1150.0,123170,113170,1131.7,122000,126000,1399-9-12
659,ضصاد1101,اختيارخ وبصادر-3000-1399/11/12,64,2124,1766824000,946,744,821,-125,-13.21,832,-114,-12.05,744,955,1399-9-12
660,اراد59,مرابحه عام دولتي5-ش.خ 0309,63,12500000,12500000000000,1000000,1000000,1000000,0,0.0,1000000,0,0.0,1000000,1000000,1399-9-12
661,غشوكو,شوكو پارس,63,106394,4468335212,44208,41998,41998,-2210,-5.0,43683,-525,-1.19,41998,41998,1399-9-12
662,تسه9801,امتياز تسهيلات مسكن فروردين98,62,479,330565815,658153,629555,691060,32907,5.0,690116,31963,4.86,629555,691060,1399-9-12
663,شزنگ,تجهيزنيروي‌زنگان‌,61,55324,9474843564,166273,171261,171261,4988,3.0,168354,2081,1.25,171261,171261,1399-9-12
664,تسه9802,امتياز تسهيلات مسكن ارديبهشت98,60,399,259338626,620678,590000,651711,31033,5.0,649971,29293,4.72,590000,651711,1399-9-12
665,اخزا903,اسنادخزانه-م3بودجه99-011110,59,122863,81850263662,662733,662733,664001,1268,0.19,666191,3458,0.52,662733,668001,1399-9-12
666,هفارس912,اختيارف ت فارس-14576-99/12/13,59,1000000,1000000,116,1,1,-115,-99.14,1,-115,-99.14,1,1,1399-9-12
667,تسه9807,امتياز تسهيلات مسكن مهر98,58,347,227843341,667243,633884,652000,-15243,-2.28,656609,-10634,-1.59,633881,698970,1399-9-12
668,غشوكوح,ح . شوكو پارس,56,92165,3245892460,36664,38300,34465,-2199,-6.0,35218,-1446,-3.94,34465,38300,1399-9-12
669,تسه9809,امتياز تسهيلات مسكن آذر98,53,430,277414864,630403,600011,639980,9577,1.52,645151,14748,2.34,600011,661923,1399-9-12
670,زعف0008پ16,زعفران0008نگين بيرجند(پ),52,34805,4328426734,10000,121448,123611,113611,1136.11,124362,114362,1143.62,121448,126000,1399-9-12
671,ضجار1017,اختيارخ وتجارت-4500-1399/10/21,51,2509,600325000,265,265,241,-24,-9.06,239,-26,-9.81,165,275,1399-9-12
672,آسام,صندوق س.آرمان سپهر آشنا-م,51,9340,1002514620,106463,104340,107060,597,0.56,107336,873,0.82,104340,108500,1399-9-12
673,اخزا815,اسنادخزانه-م15بودجه98-010406,50,42738,32315410451,755973,755900,756500,527,0.07,756128,155,0.02,755900,756900,1399-9-12
674,تسه9808,امتياز تسهيلات مسكن آبان98,50,456,299397321,630332,630000,661848,31516,5.0,656573,26241,4.16,630000,661848,1399-9-12
675,وآفري,بيمه كارآفرين,49,1407079,22226219884,15044,15796,15796,752,5.0,15789,745,4.95,15796,15796,1399-9-12
676,ضملت1130,اختيارخ وبملت-8000-1399/11/28,48,1576,463101000,311,311,290,-21,-6.75,294,-17,-5.47,180,311,1399-9-12
677,وبرق,س.کارکنان صنعت برق زنجان وقزوي,46,20323,3877120325,185219,190775,190775,5556,3.0,186193,974,0.53,190775,190775,1399-9-12
678,تسه9805,امتياز تسهيلات مسكن مرداد98,46,626,442384024,730142,693635,693635,-36507,-5.0,706684,-23458,-3.21,693635,750000,1399-9-12
679,جوين,كشت و صنعت جوين,46,278500,6448110500,22479,23153,23153,674,3.0,22684,205,0.91,23153,23153,1399-9-12
680,اخزا902,اسنادخزانه-م2بودجه99-011019,44,58527,39399987950,669828,670000,673000,3172,0.47,673193,3365,0.5,668000,675000,1399-9-12
681,فسا,پتروشيمي فسا,44,287036,817191492,2935,2847,2847,-88,-3.0,2931,-4,-0.14,2847,2847,1399-9-12
682,تسه9806,امتياز تسهيلات مسكن شهريور98,44,760,491378664,620114,620000,651119,31005,5.0,646551,26437,4.26,620000,651119,1399-9-12
683,ضپيك1020,اختيارخ تاپيكو-14000-99/10/16,41,322,1284338000,4346,4350,3799,-547,-12.59,3989,-357,-8.21,3790,4400,1399-9-12
684,سخند,صندوق س.سپهرخبرگان نفت-د,41,363660,3672297100,10091,10119,10096,5,0.05,10098,7,0.07,10089,10120,1399-9-12
685,پست0008پ04,پسته فندقي32-30سبزدانه0008(پ),40,7888,13518379560,100000,1700000,1800000,1700000,1700.0,1713790,1613790,1613.79,1692895,1800000,1399-9-12
686,اخزا818,اسنادخزانه-م18بودجه98-010614,39,26257,18971479826,721920,719800,723000,1080,0.15,722530,610,0.08,719700,724920,1399-9-12
687,فافزا,فولاد افزا سپاهان,38,113525,4871017175,44234,42907,42907,-1327,-3.0,43891,-343,-0.78,42907,42907,1399-9-12
688,ضچاد1015,اختيارخ كچاد-16000-1399/10/02,37,362,1893596000,5585,5150,4951,-634,-11.35,5231,-354,-6.34,4799,6048,1399-9-12
689,اخزا808,اسنادخزانه-م8بودجه98-000817,37,18032,15466100128,859510,853001,860000,490,0.06,857703,-1807,-0.21,853001,862990,1399-9-12
690,ومعادنح,ح . توسعه‌معادن‌وفلزات‌,36,27947,416503100,14480,15930,14500,20,0.14,14900,420,2.9,14500,15930,1399-9-12
691,اخزا809,اسنادخزانه-م9بودجه98-000923,35,57097,48150382492,843659,840001,843500,-159,-0.02,843308,-351,-0.04,830107,845000,1399-9-12
692,ضپيك1019,اختيارخ تاپيكو-12000-99/10/16,33,243,1339933000,4355,6000,5490,1135,26.06,5514,1159,26.61,5199,6000,1399-9-12
693,پدرخش,درخشان‌ تهران‌,33,4118,851931840,217760,206880,206880,-10880,-5.0,217560,-200,-0.09,206880,206880,1399-9-12
694,اخزا817,اسنادخزانه-م17بودجه98-010512,33,34356,25506348314,741053,740000,743001,1948,0.26,742413,1360,0.18,740000,743010,1399-9-12
695,اخزا704,اسنادخزانه-م4بودجه97-991022,32,39343,38827149478,980551,979000,995010,14459,1.47,986888,6337,0.65,979000,995010,1399-9-12
696,داريك,صندوق س.اعتماد داريك-د,32,532800,5425992000,10164,10200,10180,16,0.16,10184,20,0.2,10180,10200,1399-9-12
697,ضپاس1004,اختيارخ وپارس-4000-1399/10/30,32,886,651894000,595,800,710,115,19.33,736,141,23.7,620,800,1399-9-12
698,هترول911,اختيارف ت پترول-14730-99/11/15,30,417820,57659160,231,138,138,-93,-40.26,138,-93,-40.26,138,138,1399-9-12
699,پست0008پ08,پسته فندقي32-30مه ولات0008(پ),28,1838,3254524520,1781994,1840000,1829990,47996,2.69,1770688,-11306,-0.63,1710000,1840000,1399-9-12
700,ضپار1117,اختيارخ خپارس-7000-1399/11/19,28,634,1238590000,2150,1851,1800,-350,-16.28,1954,-196,-9.12,1800,2300,1399-9-12
701,دعبيدح,ح . داروسازي‌ دكترعبيدي‌,27,10079,289275000,29910,29500,28000,-1910,-6.39,28700,-1210,-4.05,28000,29500,1399-9-12
702,معيار,سرمايه گذاري معيار صنعت پارس,26,156474,4414131540,28785,28210,28210,-575,-2.0,28523,-262,-0.91,28210,28210,1399-9-12
703,اخزا811,اسنادخزانه-م11بودجه98-001013,25,84612,70774012197,835497,833112,832750,-2747,-0.33,836454,957,0.11,820005,837300,1399-9-12
704,تسه9804,امتياز تسهيلات مسكن تير98,25,405,259050960,609601,629384,640081,30480,5.0,639632,30031,4.93,629384,640081,1399-9-12
705,وشمال,س. چشم انداز توسعه شمال,24,7432,740732576,102750,99668,99668,-3082,-3.0,102629,-121,-0.12,99668,99668,1399-9-12
706,پست0008پ02,پسته فندقي32-30طلاسبززرند0008,24,776,1332813257,100000,1700000,1840000,1740000,1740.0,1717543,1617543,1617.54,1700000,1871089,1399-9-12
707,ضمخا7070,اختيارخ اخابر-20000-1400/07/28,24,307,1142958000,3034,3400,3780,746,24.59,3723,689,22.71,3400,3780,1399-9-12
708,ضشنا1035,اختيارخ شپنا-14000-1399/10/23,23,126,695078000,5655,5890,5400,-255,-4.51,5516,-139,-2.46,5300,6000,1399-9-12
709,ضفار1126,اختيارخ فارس-19826-1399/11/07,23,292,262280000,380,444,445,65,17.11,449,69,18.16,444,500,1399-9-12
710,شستا991,اجاره تامين اجتماعي-امين991226,22,392,390339413,997156,992243,1006999,9843,0.99,995764,-1392,-0.14,992242,1009970,1399-9-12
711,اخزا806,اسنادخزانه-م6بودجه98-000519,22,40281,36062706926,891113,883215,895000,3887,0.44,895278,4165,0.47,883215,900000,1399-9-12
712,ضبدر1150,اختيارخ شبندر-32000-1399/11/19,22,100,335913000,4145,1020,3300,-845,-20.39,3359,-786,-18.96,1020,4300,1399-9-12
713,اخزا821,اسنادخزانه-م21بودجه98-020906,22,7886,4517314730,574246,570243,572361,-1885,-0.33,572827,-1419,-0.25,570243,577000,1399-9-12
714,وسمازن,س.سهام عدالت استان مازندران,22,258740,243215600,980,940,940,-40,-4.08,980,0,0.0,940,940,1399-9-12
715,اخزا812,اسنادخزانه-م12بودجه98-001111,22,104976,86563426282,826967,825001,825000,-1967,-0.24,824602,-2365,-0.29,824100,833988,1399-9-12
716,فن آوا,گروه فن آوا,21,40036,551776152,14507,13782,13782,-725,-5.0,14486,-21,-0.14,13782,13782,1399-9-12
717,ضترا1118,اختيارخ شتران-12000-1399/11/14,21,117,415523000,4084,3653,3506,-578,-14.15,3551,-533,-13.05,3400,3700,1399-9-12
718,جهرم,پتروشيمي جهرم,20,62967,190412208,3117,3024,3024,-93,-2.98,3116,-1,-0.03,3024,3024,1399-9-12
719,ضچاد1014,اختيارخ كچاد-14000-1399/10/02,20,195,1241144000,7359,7400,6001,-1358,-18.45,6365,-994,-13.51,6000,7400,1399-9-12
720,عيار2,صندوق س. پشتوانه طلاي مفيد,20,200000,200000,29437,1,1,-29436,-100.0,1,-29436,-100.0,1,1,1399-9-12
721,ضچاد1017,اختيارخ كچاد-20000-1399/10/02,19,163,366492000,2637,2849,2150,-487,-18.47,2248,-389,-14.75,2010,2850,1399-9-12
722,خعمرا,توسعه و عمران شهرستان نائين,19,70940,1220877400,16709,17210,17210,501,3.0,16739,30,0.18,17210,17210,1399-9-12
723,ضصاد1100,اختيارخ وبصادر-2500-1399/11/12,19,469,584399000,1378,1430,1130,-248,-18.0,1246,-132,-9.58,1127,1430,1399-9-12
724,فوكا,فولاد كاويان,19,10176,202085184,20473,19859,19859,-614,-3.0,20470,-3,-0.01,19859,19859,1399-9-12
725,سايرا,ايرانيت‌,18,20991,732687942,35507,35321,34797,-710,-2.0,35461,-46,-0.13,34797,35321,1399-9-12
726,فسديد,لوله‌وتجهيزات‌ سديد - ورشكسته,18,27892,3044523368,110256,109154,109154,-1102,-1.0,109576,-680,-0.62,109154,109154,1399-9-12
727,آينده,بازرگاني آينده سازان بهشت پارس,18,27655,593338025,22118,21455,21455,-663,-3.0,22097,-21,-0.09,21455,21455,1399-9-12
728,ضخود1041,اختيارخ خودرو-2500-1399/10/07,17,284,444981000,1612,1558,1461,-151,-9.37,1567,-45,-2.79,1420,1600,1399-9-12
729,داراب,پتروشيمي داراب,17,60282,182413332,3119,3026,3026,-93,-2.98,3118,-1,-0.03,3026,3026,1399-9-12
730,ضپيك1021,اختيارخ تاپيكو-16000-99/10/16,17,182,399879000,2982,3000,2500,-482,-16.16,2197,-785,-26.32,1999,3000,1399-9-12
731,اخزا814,اسنادخزانه-م14بودجه98-010318,17,13326,10187062204,765387,763500,763655,-1732,-0.23,764450,-937,-0.12,763500,766994,1399-9-12
732,ضفار1122,اختيارخ فارس-11826-1399/11/07,17,72,495042000,3530,3550,3500,-30,-0.85,3438,-92,-2.61,3250,3580,1399-9-12
733,ضجار1018,اختيارخ وتجارت-5000-1399/10/21,17,383,84604000,145,125,141,-4,-2.76,221,76,52.41,125,500,1399-9-12
734,پلاست,كارخانجات توليدي پلاستيران,16,13598,553044258,42811,40671,40671,-2140,-5.0,42748,-63,-0.15,40671,40671,1399-9-12
735,اخزا721,اسنادخزانه-م21بودجه97-000728,16,26375,22770976977,864003,864001,865000,997,0.12,863355,-648,-0.07,860711,866000,1399-9-12
736,پلوله,گازلوله‌,16,33293,604068192,18327,18144,18144,-183,-1.0,18304,-23,-0.13,18144,18144,1399-9-12
737,نگين,ص.س. زمين و ساختمان نگين شهرري,16,11833,575757000,48590,48500,49420,830,1.71,48660,70,0.14,48500,49500,1399-9-12
738,هبركت912,اختيارف ت بركت-22100-99/12/17,16,45924,115682556,2585,2519,2519,-66,-2.55,2519,-66,-2.55,2519,2519,1399-9-12
739,اخزا804,اسنادخزانه-م4بودجه98-000421,15,22064,19967831259,904711,896000,928410,23699,2.62,904996,285,0.03,896000,928410,1399-9-12
740,ثتوسا,س.توسعه و عمران استان اردبيل,15,4168,258345144,63899,61983,61983,-1916,-3.0,63873,-26,-0.04,61983,61983,1399-9-12
741,ضخود1047,اختيارخ خودرو-6000-1399/10/07,15,688,54041000,90,80,73,-17,-18.89,79,-11,-12.22,73,100,1399-9-12
742,ضمخا7066,اختيارخ اخابر-12000-1400/07/28,14,35,282224000,6775,7000,8999,2224,32.83,8064,1289,19.03,7000,8999,1399-9-12
743,اخزا816,اسنادخزانه-م16بودجه98-010503,14,23020,17160952580,744486,745000,746001,1515,0.2,745480,994,0.13,745000,746002,1399-9-12
744,ضفلا1157,اختيارخ فولاد-18000-1399/11/28,14,239,181518000,1085,1097,721,-364,-33.55,759,-326,-30.05,720,1097,1399-9-12
745,اخزا901,اسنادخزانه-م1بودجه99-010621,13,21844,15929247675,723706,739980,729000,5294,0.73,729228,5522,0.76,729000,749885,1399-9-12
746,ضخود1040,اختيارخ خودرو-2000-1399/10/07,13,438,888894000,2118,2100,1950,-168,-7.93,2029,-89,-4.2,1950,2100,1399-9-12
747,ضپار1119,اختيارخ خپارس-9000-1399/11/19,12,580,532500000,920,950,900,-20,-2.17,918,-2,-0.22,900,1000,1399-9-12
748,اخزا904,اسنادخزانه-م4بودجه99-011215,12,9480,6177620150,650125,650000,655497,5372,0.83,651648,1523,0.23,648612,655497,1399-9-12
749,ضپار1118,اختيارخ خپارس-8000-1399/11/19,12,272,330350000,1676,1680,1200,-476,-28.4,1215,-461,-27.51,1100,1700,1399-9-12
750,كرونا2,تامين مالي جمعي صرفا اهداي سود,12,641,6410000,10000,10000,10000,0,0.0,10000,0,0.0,10000,10000,1399-9-12
751,گنجين,صندوق س. گنجينه يكم آويد-د,11,282492,3317442813,11727,11745,11737,10,0.09,11743,16,0.14,11733,11750,1399-9-12
752,ساذري,آذريت‌,11,17106,104295282,5807,6097,6097,290,4.99,5808,1,0.02,6097,6097,1399-9-12
753,اخزا810,اسنادخزانه-م10بودجه98-001006,11,31051,25983877548,834927,837990,836810,1883,0.23,836813,1886,0.23,830000,844989,1399-9-12
754,ضپيك1022,اختيارخ تاپيكو-18000-99/10/16,11,544,969845000,1898,2000,1500,-398,-20.97,1783,-115,-6.06,1500,2000,1399-9-12
755,ضفلا1154,اختيارخ فولاد-12000-1399/11/28,10,51,205150000,3720,4200,3501,-219,-5.89,4023,303,8.15,3501,4200,1399-9-12
756,ضفلا1151,اختيارخ فولاد-8000-1399/11/28,10,94,700599000,6950,6950,7000,50,0.72,7453,503,7.24,6950,7999,1399-9-12
757,اخزا820,اسنادخزانه-م20بودجه98-020806,10,2670,1549057060,582742,578001,580101,-2641,-0.45,580171,-2571,-0.44,578001,584000,1399-9-12
758,شسم,توليد سموم‌ علف‌ كش,10,7598,659210078,85060,86761,86761,1701,2.0,85170,110,0.13,86761,86761,1399-9-12
759,ضپاس1000,اختيارخ وپارس-2000-1399/10/30,9,203,482300000,2023,2200,2380,357,17.65,2376,353,17.45,2200,2380,1399-9-12
760,لخانه,لوازم‌ خانگي‌ پارس‌,9,3116,175929360,58206,56460,56460,-1746,-3.0,58190,-16,-0.03,56460,56460,1399-9-12
761,پست0008پ09,پسته بادامي30-28مه ولات0008(پ),8,1300,2085400000,1542477,1618000,1600000,57523,3.73,1604154,61677,4.0,1600000,1618000,1399-9-12
762,اطلس2,صندوق س.توسعه اندوخته آينده-س,7,70000,70000,207919,1,1,-207918,-100.0,1,-207918,-100.0,1,1,1399-9-12
763,ضمخا1026,اختيارخ اخابر-18000-1399/10/30,7,214,383568000,2600,1800,1800,-800,-30.77,1792,-808,-31.08,1768,1800,1399-9-12
764,اشاد10,مشاركت دولتي10-شرايط خاص001226,7,18300,17471809800,941001,954699,954800,13799,1.47,954744,13743,1.46,954699,954800,1399-9-12
765,وسزنجان,شركت س استان زنجان,6,93763,126580050,1420,1350,1350,-70,-4.93,1420,0,0.0,1350,1350,1399-9-12
766,اخزا805,اسنادخزانه-م5بودجه98-000422,6,4764,4303620100,903290,905000,910000,6710,0.74,903363,73,0.01,901100,910000,1399-9-12
767,صمعاد412,صكوك اجاره معادن412-6ماهه21%,6,51015,49999801500,980100,980100,980100,0,0.0,980100,0,0.0,980100,980100,1399-9-12
768,سپرمي,پرميت‌,6,6396,53496144,8282,8364,8364,82,0.99,8283,1,0.01,8364,8364,1399-9-12
769,اخزا807,اسنادخزانه-م7بودجه98-000719,6,2983,2592227000,870000,869000,869000,-1000,-0.11,869000,-1000,-0.11,869000,869000,1399-9-12
770,افران2,صندوق س افرا نماد پايدار-ثابت,6,600000,600000,12230,1,1,-12229,-99.99,1,-12229,-99.99,1,1,1399-9-12
771,اخزا813,اسنادخزانه-م13بودجه98-010219,5,2520,1952717136,774020,775000,774502,482,0.06,774888,868,0.11,774502,775000,1399-9-12
772,هصيكو402,اختيارف ت تاصيكو13500-00/02/20,5,38412,59653836,2778,1553,1553,-1225,-44.1,1553,-1225,-44.1,1553,1553,1399-9-12
773,كشم0001پ01,كشمش سبز0001خليل آباد(پ),5,69,26096836,390274,375000,370761,-19513,-5.0,378215,-12059,-3.09,370761,394999,1399-9-12
774,كابگن,توليدي و صنعتي آبگينه‌,5,36233,179751913,4912,4961,4961,49,1.0,4914,2,0.04,4961,4961,1399-9-12
775,شستا992,اجاره تامين اجتماعي-سپهر991226,5,52,51756144,1000000,991001,1008998,8998,0.9,995310,-4690,-0.47,990508,1008998,1399-9-12
776,ضمخا1024,اختيارخ اخابر-14000-1399/10/30,5,22,61782000,3077,2503,3800,723,23.5,2808,-269,-8.74,2501,3800,1399-9-12
777,ضصاد1107,اختيارخ وبصادر-7000-1399/11/12,5,500,39000000,80,80,70,-10,-12.5,78,-2,-2.5,70,80,1399-9-12
778,ضپيك1023,اختيارخ تاپيكو-20000-99/10/16,5,44,34604000,1102,501,801,-301,-27.31,786,-316,-28.68,501,801,1399-9-12
779,ضفلا1153,اختيارخ فولاد-10000-1399/11/28,5,12,61710000,5767,5060,5300,-467,-8.1,5142,-625,-10.84,4700,5400,1399-9-12
780,ومشان,س. فني و مهندسي مشانير,5,852,48886056,59152,57378,57378,-1774,-3.0,59148,-4,-0.01,57378,57378,1399-9-12
781,سرو2,صندوق س سروسودمند مدبران-سهام,4,400000,400000,71100,1,1,-71099,-100.0,1,-71099,-100.0,1,1,1399-9-12
782,ضملت1127,اختيارخ وبملت-5000-1399/11/28,4,114,168770000,1487,1450,1590,103,6.93,1480,-7,-0.47,1450,1590,1399-9-12
783,حرهشا,رهشاد سپاهان (سهامي عام,4,1614,95113020,62031,58930,58930,-3101,-5.0,62015,-16,-0.03,58930,58930,1399-9-12
784,ضچاد1019,اختيارخ كچاد-28000-1399/10/02,4,13,1700000,31,150,125,94,303.23,131,100,322.58,125,150,1399-9-12
785,زير0003پ01,زيره سبز0003كيميابذر(پ),4,120,69347545,573166,573170,579999,6833,1.19,577896,4730,0.83,573170,579999,1399-9-12
786,ضچاد1018,اختيارخ كچاد-24000-1399/10/02,4,10,8800000,1000,600,1000,0,0.0,880,-120,-12.0,600,1000,1399-9-12
787,تصميم2,صندوق س با درآمد ثابت تصميم,4,4000000,4000000,14960,1,1,-14959,-99.99,1,-14959,-99.99,1,1,1399-9-12
788,ضصاد1106,اختيارخ وبصادر-6000-1399/11/12,4,203,22300000,100,100,100,0,0.0,110,10,10.0,100,120,1399-9-12
789,وسگلستا,شركت س استان گلستان,4,13600,16048000,1240,1180,1180,-60,-4.84,1240,0,0.0,1180,1180,1399-9-12
790,وسيزد,شركت س استان يزد,4,15932,19437040,1280,1220,1220,-60,-4.69,1280,0,0.0,1220,1220,1399-9-12
791,وسكرشا,س.سهام عدالت استان كرمانشاه,4,18602,22322400,1260,1200,1200,-60,-4.76,1260,0,0.0,1200,1200,1399-9-12
792,ضچاد1012,اختيارخ كچاد-10000-1399/10/02,3,4,28999000,11527,4099,10400,-1127,-9.78,7250,-4277,-37.1,4099,10401,1399-9-12
793,ضمخا7069,اختيارخ اخابر-18000-1400/07/28,3,8,31400000,3464,3400,4000,536,15.47,3925,461,13.31,3400,4000,1399-9-12
794,اخزا713,اسنادخزانه-م13بودجه97-000518,3,304,274338896,891722,902459,902400,10678,1.2,902431,10709,1.2,902400,902499,1399-9-12
795,ضپنا1020,اختيارخ رمپنا-13406-1399/10/09,3,20,210302000,7800,7500,6700,-1100,-14.1,7100,-700,-8.97,6700,7500,1399-9-12
796,صايپا012,صكوك مرابحه سايپا012-3ماهه 16%,3,29,29000029,1004653,1000001,1000001,-4652,-0.46,1000001,-4652,-0.46,1000001,1000001,1399-9-12
797,اراد444,مرابحه عام دولت4-ش.خ 0007,3,6100000,5964951600000,1030000,980352,976600,-53400,-5.18,977861,-52139,-5.06,976600,980352,1399-9-12
798,ضگل1141,اختيارخ كگل-14000-1399/11/21,3,10,66300000,7300,6630,6630,-670,-9.18,6630,-670,-9.18,6630,6630,1399-9-12
799,وساربيل,شركت س استان اردبيل,3,15000,18300000,1280,1220,1220,-60,-4.69,1280,0,0.0,1220,1220,1399-9-12
800,وسمركز,شركت س استان مركزي,3,25000,33250000,1400,1330,1330,-70,-5.0,1400,0,0.0,1330,1330,1399-9-12
801,اراد53,مرابحه عام دولت5-ش.خ 0207,3,55000,50979610000,933704,926902,926902,-6802,-0.73,926902,-6802,-0.73,926902,926902,1399-9-12
802,ضمخا1025,اختيارخ اخابر-16000-1399/10/30,3,15,36088000,2192,2300,2498,306,13.96,2406,214,9.76,2300,2499,1399-9-12
803,ضترا1117,اختيارخ شتران-10000-1399/11/14,3,7,33500000,5805,5500,4600,-1205,-20.76,4786,-1019,-17.55,4600,5500,1399-9-12
804,اخزا9062,اسنادخزانه-م6بودجه99-020321,3,920000,570900000000,621924,620000,622000,76,0.01,620543,-1381,-0.22,620000,622000,1399-9-12
805,حريل02,اجاره ريل پردازسير021212,3,210,209883060,1014086,1014086,999086,-15000,-1.48,999443,-14643,-1.44,999086,1014086,1399-9-12
806,اخزا720,اسنادخزانه-م20بودجه97-000324,3,491,451657000,915400,917000,920000,4600,0.5,919872,4472,0.49,917000,920000,1399-9-12
807,اخزا723,اسنادخزانه-م23بودجه97-000824,2,427,365939020,859213,857001,857000,-2213,-0.26,857000,-2213,-0.26,857000,857001,1399-9-12
808,اراد50,مرابحه عام دولت5-ش.خ0302,2,50000,50000000000,968000,1000000,1000000,32000,3.31,1000000,32000,3.31,1000000,1000000,1399-9-12
809,اخزا7214,اسنادخزانه-م21بودجه97-000728,2,3165256,2727583391856,864003,859449,864003,0,0.0,861726,-2277,-0.26,859449,864003,1399-9-12
810,ضبدر1151,اختيارخ شبندر-36000-1399/11/19,2,11,12100000,3280,1100,1100,-2180,-66.46,1100,-2180,-66.46,1100,1100,1399-9-12
811,ضجار1010,اختيارخ وتجارت-1600-1399/10/21,2,18,26100000,2512,1200,2700,188,7.48,1450,-1062,-42.28,1200,2700,1399-9-12
812,عفولاد3,اوراق سلف موازي ورق گرم فولاد,2,1011,803336556,792116,794596,794596,2480,0.31,794596,2480,0.31,794596,794596,1399-9-12
813,وسالت,بانك قرض الحسنه رسالت,2,11300,50025100,4299,4427,4427,128,2.98,4299,0,0.0,4427,4427,1399-9-12
814,اخزا7184,اسنادخزانه-م18بودجه97-000525,2,2499226,2214737854807,889253,883086,889253,0,0.0,886169,-3084,-0.35,883086,889253,1399-9-12
815,ضپاس1006,اختيارخ وپارس-5000-1399/10/30,2,100,32500000,300,350,300,0,0.0,325,25,8.33,300,350,1399-9-12
816,اخزا8114,اسنادخزانه-م11بودجه98-001013,2,1737142,1444010578923,835497,827016,835497,0,0.0,831256,-4241,-0.51,827016,835497,1399-9-12
817,اخزا7224,اسنادخزانه-م22بودجه97-000428,2,1838026,1641098056334,902648,883070,902648,0,0.0,892859,-9789,-1.08,883070,902648,1399-9-12
818,اخزا716,اسنادخزانه-م16بودجه97-000407,2,230,208150000,902482,905000,905000,2518,0.28,905000,2518,0.28,905000,905000,1399-9-12
819,اخزا906,اسنادخزانه-م6بودجه99-020321,2,5023,3123924252,621924,621924,621924,0,0.0,621924,0,0.0,621924,621924,1399-9-12
820,ضجار1011,اختيارخ وتجارت-1800-1399/10/21,2,5,12400000,2339,2450,2500,161,6.88,2480,141,6.03,2450,2500,1399-9-12
821,اخزا8074,اسنادخزانه-م7بودجه98-000719,2,669536,581180346992,870000,866069,870000,0,0.0,868034,-1966,-0.23,866069,870000,1399-9-12
822,اخزا7204,اسنادخزانه-م20بودجه97-000324,2,1421116,1307431693906,915400,924607,915400,0,0.0,920003,4603,0.5,915400,924607,1399-9-12
823,زعف0008پ12,زعفران0008پوشالمعمول سحرخيز(پ),2,1000,110796000,10000,110796,110796,100796,1007.96,110796,100796,1007.96,110796,110796,1399-9-12
824,اخزا7164,اسنادخزانه-م16بودجه97-000407,2,1636660,1478499724240,902482,904246,902482,0,0.0,903364,882,0.1,902482,904246,1399-9-12
825,افاد844,منفعت دولت8-ش.خاص ساير0205,2,10000000,9561430000000,880000,958386,953900,73900,8.4,956143,76143,8.65,953900,958386,1399-9-12
826,زعف0008پ15,زعفران0008پوشالمعمول طلاسرخ(پ),2,47,5196768,105520,100244,110794,5274,5.0,110570,5050,4.79,100244,110794,1399-9-12
827,فبستم,صنايع ‌بسته‌بندي‌ مشهد,2,7186,5978752,793,832,832,39,4.92,793,0,0.0,832,832,1399-9-12
828,تملي809,تسهيلات مسكن ب. ملي-آذر98,2,52,11949080,218848,229790,229790,10942,5.0,229790,10942,5.0,229790,229790,1399-9-12
829,اخزا722,اسنادخزانه-م22بودجه97-000428,2,1346,1211728000,902648,910000,900200,-2448,-0.27,900244,-2404,-0.27,900200,910000,1399-9-12
830,اخزا718,اسنادخزانه-م18بودجه97-000525,2,1250,1112500000,889253,890000,890000,747,0.08,890000,747,0.08,890000,890000,1399-9-12
831,لازما,كارخانه هاي صنعتي آزمايش,2,2000,59038000,30121,29519,29519,-602,-2.0,30117,-4,-0.01,29519,29519,1399-9-12
832,اخزا8094,اسنادخزانه-م9بودجه98-000923,2,671492,564541118938,843659,837794,843659,0,0.0,840726,-2933,-0.35,837794,843659,1399-9-12
833,افاد614,منفعت دولت6-ش.خاص140109,2,10000000,9771190000000,985000,980958,973280,-11720,-1.19,977119,-7881,-0.8,973280,980958,1399-9-12
834,دومينو4,اجاره دومينو14040208,2,2500,2287500000,880704,915000,915000,34296,3.89,915000,34296,3.89,915000,915000,1399-9-12
835,اراد354,مرابحه عام دولت3-ش.خ 0103,2,20000000,19002650000000,920000,950265,950000,30000,3.26,950132,30132,3.28,950000,950265,1399-9-12
836,تملي708,تسهيلات مسكن ب. ملي-آبان97,2,10,7152530,752897,715253,715253,-37644,-5.0,715253,-37644,-5.0,715253,715253,1399-9-12
837,تملي702,تسهيلات مسكن ب. ملي-ارديبهشت97,2,7,5188876,780282,741268,741268,-39014,-5.0,741268,-39014,-5.0,741268,741268,1399-9-12
838,صگل1411,ص اجاره گل گهر 1411-3 ماهه 17%,2,18,17208000,956000,956000,956000,0,0.0,956000,0,0.0,956000,956000,1399-9-12
839,اخزا8134,اسنادخزانه-م13بودجه98-010219,2,434266,335807475416,774020,772532,774020,0,0.0,773276,-744,-0.1,772532,774020,1399-9-12
840,وسيلام,شركت س استان ايلام,2,10000,11800000,1240,1180,1180,-60,-4.84,1240,0,0.0,1180,1180,1399-9-12
841,نبورس,نهادهاي مالي بورس اوراق بهادار,1,10000,585200000,55740,58520,58520,2780,4.99,55760,20,0.04,58520,58520,1399-9-12
842,هرمز4,فولاد هرمزگان جنوب,1,194636847,2539621579656,12997,13048,13048,51,0.39,13048,51,0.39,13048,13048,1399-9-12
843,صخود0012,ص مرابحه خودرو0012- 3ماهه 18%,1,100,101000000,1010000,1010000,1010000,0,0.0,1010000,0,0.0,1010000,1010000,1399-9-12
844,اراد314,مرابحه عام دولت3-ش.خ 0208,1,10000000,8938400000000,1000000,893840,893840,-106160,-10.62,893840,-106160,-10.62,893840,893840,1399-9-12
845,بتك,كارخانجات كابل سازي‌ تك‌,1,296,10202824,33794,34469,34469,675,2.0,33795,1,0.0,34469,34469,1399-9-12
846,ضخوز1014,اختيارخ فخوز-12191-1399/10/16,1,14,140000000,8700,10000,10000,1300,14.94,10000,1300,14.94,10000,10000,1399-9-12
847,ضمخا7067,اختيارخ اخابر-14000-1400/07/28,1,1,7000000,7500,7000,7000,-500,-6.67,7000,-500,-6.67,7000,7000,1399-9-12
848,صفارس037,صكوك اجاره فارس037- 3ماهه18%,1,10,10300000,1060000,1030000,1030000,-30000,-2.83,1030000,-30000,-2.83,1030000,1030000,1399-9-12
849,رايان106,مشاركت رايان سايپا-3ماهه16%,1,7500,7020000000,1000000,936000,936000,-64000,-6.4,936000,-64000,-6.4,936000,936000,1399-9-12
850,ريل1401,اجاره ريل كوثر14010509,1,5,5059200,1011840,1011840,1011840,0,0.0,1011840,0,0.0,1011840,1011840,1399-9-12
851,اراد38,مرابحه عام دولت3-ش.خ 0105,1,500,485837500,989675,971675,971675,-18000,-1.82,971675,-18000,-1.82,971675,971675,1399-9-12
852,اراد56,مرابحه عام دولت5-ش.خ 0308,1,1000,945000000,935000,945000,945000,10000,1.07,945000,10000,1.07,945000,945000,1399-9-12
853,كرمان4,س. توسعه و عمران استان كرمان,1,11000000,909568000000,79486,82688,82688,3202,4.03,82688,3202,4.03,82688,82688,1399-9-12
854,صمسكن912,ص دين مسكن جنوب-ماهانه16درصد,1,38,2322104,60796,61108,61108,312,0.51,61108,312,0.51,61108,61108,1399-9-12
855,غيوان,كيوان,1,644,9973628,15334,15487,15487,153,1.0,15334,0,0.0,15487,15487,1399-9-12
856,صايپا203,صكوك مرابحه سايپا203-3ماهه 16%,1,3000,2925000000,987940,975000,975000,-12940,-1.31,975000,-12940,-1.31,975000,975000,1399-9-12
857,كمند2,صندوق س. با درآمد ثابت كمند,1,45000000,45000000,10143,1,1,-10142,-99.99,1,-10142,-99.99,1,1,1399-9-12
858,اعتماد4,صندوق س.اعتماد آفرين پارسيان-د,1,13380000,449902500000,33599,33625,33625,26,0.08,33625,26,0.08,33625,33625,1399-9-12
859,ضخوز1017,اختيارخ فخوز-18286-1399/10/16,1,5,5000000,3500,1000,1000,-2500,-71.43,1000,-2500,-71.43,1000,1000,1399-9-12
860,تملي803,تسهيلات مسكن ب. ملي-خرداد98,1,20,10660280,507633,533014,533014,25381,5.0,533014,25381,5.0,533014,533014,1399-9-12
861,صايپا112,صكوك مرابحه سايپا112-3ماهه 16%,1,20,19600000,980000,980000,980000,0,0.0,980000,0,0.0,980000,980000,1399-9-12
862,تابان03,اجاره تابان سپهر14021206,1,6,6000000,1000000,1000000,1000000,0,0.0,1000000,0,0.0,1000000,1000000,1399-9-12
863,دمعيار2,صندوق س. توازن معيار-د,1,2600000,2600000,10049,1,1,-10048,-99.99,1,-10048,-99.99,1,1,1399-9-12
864,اراد374,مرابحه عام دولت3-ش.خ 0005,1,1000000,981000000000,1011177,981000,981000,-30177,-2.98,981000,-30177,-2.98,981000,981000,1399-9-12
865,سپ2,پرداخت الكترونيك سامان كيش,1,27500000,473275000000,16610,17210,17210,600,3.61,17210,600,3.61,17210,17210,1399-9-12
866,ضصاد1105,اختيارخ وبصادر-5000-1399/11/12,1,80,8240000,200,103,103,-97,-48.5,103,-97,-48.5,103,103,1399-9-12
867,ضچاد1016,اختيارخ كچاد-18000-1399/10/02,1,1,3250000,3837,3250,3250,-587,-15.3,3250,-587,-15.3,3250,3250,1399-9-12
868,ميدكو2,هلدينگ صنايع  معدني خاورميانه,1,3800000,101460000000,26668,26700,26700,32,0.12,26700,32,0.12,26700,26700,1399-9-12
869,ضچاد1013,اختيارخ كچاد-12000-1399/10/02,1,20,186000000,9452,9300,9300,-152,-1.61,9300,-152,-1.61,9300,9300,1399-9-12
870,اراد244,مرابحه عام دولت2-ش.خ ساير0212,1,4000000,3736000000000,1025000,934000,934000,-91000,-8.88,934000,-91000,-8.88,934000,934000,1399-9-12
871,اراد404,مرابحه عام دولت4-ش.خ 0207,1,7000000,6571600000000,997000,938800,938800,-58200,-5.84,938800,-58200,-5.84,938800,938800,1399-9-12
872,ياقوت2,صندوق س ياقوت آگاه-ثابت,1,283000,283000,11454,1,1,-11453,-99.99,1,-11453,-99.99,1,1,1399-9-12
873,مشهد212,مشاركت ش مشهد212-3ماهه18%,1,1500,1350075000,903650,900050,900050,-3600,-0.4,900050,-3600,-0.4,900050,900050,1399-9-12
874,اراد334,مرابحه عام دولت3-ش.خ 0303,1,5000000,4285000000000,890400,857000,857000,-33400,-3.75,857000,-33400,-3.75,857000,857000,1399-9-12
875,تملي704,تسهيلات مسكن ب. ملي-تير97,1,4,5787444,1523011,1446861,1446861,-76150,-5.0,1446861,-76150,-5.0,1446861,1446861,1399-9-12
876,ونيكي2,سرمايه‌گذاري‌ ملي‌ايران‌,1,5000000,82300000000,15680,16460,16460,780,4.97,16460,780,4.97,16460,16460,1399-9-12
877,صينا205,صكوك منفعت سينا دارو-3ماهه 19%,1,1268,1268005072,1006129,1000004,1000004,-6125,-0.61,1000004,-6125,-0.61,1000004,1000004,1399-9-12
878,ضفار1123,اختيارخ فارس-13826-1399/11/07,1,5,20000000,2263,2000,2000,-263,-11.62,2000,-263,-11.62,2000,2000,1399-9-12
879,ونوين2,بانك‌اقتصادنوين‌,1,89000000,506410000000,5490,5690,5690,200,3.64,5690,200,3.64,5690,5690,1399-9-12
880,اوصتا4,صندوق انديشه ورزان صباتامين -د,1,21869190,376915489650,17204,17235,17235,31,0.18,17235,31,0.18,17235,17235,1399-9-12
881,كايتا,ايتالران‌,1,190,1815450,9277,9555,9555,278,3.0,9277,0,0.0,9555,9555,1399-9-12
882,وسبوشهر,شركت س استان بوشهر,1,5000,6000000,1260,1200,1200,-60,-4.76,1260,0,0.0,1200,1200,1399-9-12
