,نماد,نام,تعداد,حجم,ارزش,دیروز,اولین,آخرین معامله - مقدار,آخرین معامله - تغییر,آخرین معامله - درصد,قیمت پایانی - مقدار,قیمت پایانی - تغییر,قیمت پایانی - درصد,کمترین,بیشترین,تاریخ
0,سيتا,سرمايه گذاري سيمان تامين,92798,81164939,1546451492750,19000,18800,19880,880,4.63,19050,50,0.26,18060,19950,1399-7-1
1,دارا يكم,صندوق واسطه گري مالي يكم-سهام,85554,43362682,8866069324530,197160,209900,213300,16140,8.19,204460,7300,3.7,188000,214000,1399-7-1
2,خودرو,ايران‌ خودرو,82567,2216695297,6453833003700,3040,3010,2930,-110,-3.62,2910,-130,-4.28,2890,3120,1399-7-1
3,فولاد,فولاد مباركه اصفهان,81239,446998696,8550772732210,19530,19500,19900,370,1.89,19130,-400,-2.05,18560,20270,1399-7-1
4,ثبهساز,بهساز كاشانه تهران,79885,348762092,1439839358130,4310,4100,4100,-210,-4.87,4130,-180,-4.18,4100,4310,1399-7-1
5,فملي,ملي‌ صنايع‌ مس‌ ايران‌,77136,251548476,8239905612850,33790,33690,33440,-350,-1.04,32760,-1030,-3.05,32110,35120,1399-7-1
6,وبملت,بانك ملت,59306,1323474055,7253047988890,5490,5370,5760,270,4.92,5480,-10,-0.18,5220,5760,1399-7-1
7,شپنا,پالايش نفت اصفهان,48926,269332878,7821539020930,30470,29050,28950,-1520,-4.99,29040,-1430,-4.69,28950,30430,1399-7-1
8,وتجارت,بانك تجارت,43455,1159635144,3597318330520,3230,3100,3160,-70,-2.17,3100,-130,-4.02,3070,3220,1399-7-1
9,شبندر,پالايش نفت بندرعباس,41199,102296156,4195659822120,41480,42500,41950,470,1.13,41010,-470,-1.13,39420,42990,1399-7-1
10,شاروم,پتروشيمي اروميه,40210,673929,9755796204,13787,14476,14476,689,5.0,13912,125,0.91,14476,14476,1399-7-1
11,آريا,پليمر آريا ساسول,38855,18021125,3328771777395,176147,184954,184954,8807,5.0,184715,8568,4.86,176147,184954,1399-7-1
12,زملارد,كشاورزي و دامپروري ملارد شير,32096,418084,19328023320,44029,46230,46230,2201,5.0,44757,728,1.65,46230,46230,1399-7-1
13,خساپا,سايپا,31503,957145899,2404625658240,2630,2520,2500,-130,-4.94,2510,-120,-4.56,2500,2650,1399-7-1
14,شگويا,پتروشيمي تندگويان,30140,147372142,2404195989184,16012,16500,16812,800,5.0,16314,302,1.89,15220,16812,1399-7-1
15,دي,بانك دي,22839,66125789,3363008465609,48586,49800,51015,2429,5.0,50858,2272,4.68,49000,51015,1399-7-1
16,ذوب,سهامي ذوب آهن  اصفهان,19738,229419387,1375358205052,6255,6050,6020,-235,-3.76,5995,-260,-4.16,5943,6240,1399-7-1
17,پترول,گروه پتروشيمي س. ايرانيان,19315,180951658,2840893776600,14970,15710,15710,740,4.94,15700,730,4.88,15080,15710,1399-7-1
18,صبا,سرمايه گذاري صبا تامين,17901,78850263,927355294694,11239,11735,11800,561,4.99,11761,522,4.64,11275,11800,1399-7-1
19,فارس,صنايع پتروشيمي خليج فارس,17409,50483130,1546517065510,29960,31350,31450,1490,4.97,30630,670,2.24,28760,31450,1399-7-1
20,شتران,پالايش نفت تهران,17379,98502821,2605158556880,27820,26430,26430,-1390,-5.0,26450,-1370,-4.92,26430,27000,1399-7-1
21,وغدير,سرمايه‌گذاري‌غدير(هلدينگ‌,17264,76140839,1276655959500,16710,16900,17230,520,3.11,16770,60,0.36,15970,17500,1399-7-1
22,رافزا,رايان هم افزا,17076,158889,4892033421,29323,30789,30789,1466,5.0,29456,133,0.45,30789,30789,1399-7-1
23,ولپارس,ليزينگ پارسيان,14651,1092198,4521699720,3950,4140,4140,190,4.81,3960,10,0.25,4140,4140,1399-7-1
24,ثاميد,توسعه و عمران اميد,13810,14246232,38037439440,2550,2670,2670,120,4.71,2630,80,3.14,2670,2670,1399-7-1
25,كگل,معدني و صنعتي گل گهر,13588,98963823,2332092512430,24230,24000,24450,220,0.91,23570,-660,-2.72,23020,25110,1399-7-1
26,شبريز,پالايش نفت تبريز,13256,56191729,2024615126800,37870,36200,36000,-1870,-4.94,36030,-1840,-4.86,35980,37100,1399-7-1
27,فخوز,فولاد  خوزستان,13127,49308533,2287637687550,48090,47200,47330,-760,-1.58,46390,-1700,-3.54,45690,49540,1399-7-1
28,زاگرس,پتروشيمي زاگرس,12863,13288234,2393002720291,179056,182008,181337,2281,1.27,180084,1028,0.57,171000,186000,1399-7-1
29,كاوه,فولاد كاوه جنوب كيش,11976,135234627,3101466136180,23740,24100,23650,-90,-0.38,22930,-810,-3.41,22560,24410,1399-7-1
30,وخارزم,سرمايه گذاري خوارزمي,11175,69779246,768920720620,11110,11500,11240,130,1.17,11020,-90,-0.81,10560,11580,1399-7-1
31,پترولح,ح . گروه پتروشيمي س. ايرانيان,9251,56203110,807501124250,13500,14310,14850,1350,10.0,14370,870,6.44,13130,14850,1399-7-1
32,ختوقا,قطعات‌ اتومبيل‌ ايران‌,9215,119222484,466908385020,3980,4020,4010,30,0.75,3920,-60,-1.51,3790,4140,1399-7-1
33,بجهرم,توسعه مولد نيروگاهي جهرم,8708,75526244,318137815385,4388,4225,4240,-148,-3.37,4212,-176,-4.01,4169,4360,1399-7-1
34,ومعادن,توسعه‌معادن‌وفلزات‌,8594,64947220,1118919138350,17490,17890,17840,350,2.0,17230,-260,-1.49,16620,18200,1399-7-1
35,وپاسار,بانك  پاسارگاد,8276,131487021,1364957266060,10760,10230,10850,90,0.84,10380,-380,-3.53,10230,10880,1399-7-1
36,شصدفح,ح . صنعتي دوده فام,7449,3030130,59395873296,18832,18890,19773,941,5.0,19602,770,4.09,18890,19773,1399-7-1
37,كچاد,معدني‌وصنعتي‌چادرملو,7351,40941117,837532761570,19840,20630,20830,990,4.99,20460,620,3.13,19020,20830,1399-7-1
38,تاپيكو,س. نفت و گاز و پتروشيمي تأمين,7120,49109474,930254668550,18380,19010,19290,910,4.95,18940,560,3.05,17950,19290,1399-7-1
39,پارسان,گسترش نفت و گاز پارسيان,6993,37792758,1053267188110,28690,28690,29600,910,3.17,27870,-820,-2.86,27260,30000,1399-7-1
40,ونوين,بانك‌اقتصادنوين‌,6921,147664666,601131817600,4070,4110,4120,50,1.23,4070,0,0.0,3880,4250,1399-7-1
41,بپاس,بيمه پاسارگاد,6814,10883517,705227099652,61827,64300,64918,3091,5.0,64798,2971,4.81,61856,64918,1399-7-1
42,تملت,تامين سرمايه بانك ملت,6700,23031910,258929734340,11790,11210,11430,-360,-3.05,11240,-550,-4.66,11210,11700,1399-7-1
43,خبهمن,گروه‌بهمن‌,6638,63541646,1505681507570,24880,23660,24640,-240,-0.96,23700,-1180,-4.74,23640,24800,1399-7-1
44,اخابر,مخابرات ايران,6384,45721598,888535291780,20170,19170,20000,-170,-0.84,19430,-740,-3.67,19170,20030,1399-7-1
45,وبانك,سرمايه گذاري گروه توسعه ملي,6213,29605867,549596629510,18800,18800,19300,500,2.66,18560,-240,-1.28,17860,19370,1399-7-1
46,ارفع,شركت آهن و فولاد ارفع,6187,41115256,795891568848,18564,19492,19492,928,5.0,19358,794,4.28,18650,19492,1399-7-1
47,وپارس,بانك‌پارسيان‌,5281,197099143,855410280620,4560,4340,4340,-220,-4.82,4340,-220,-4.82,4340,4340,1399-7-1
48,كدماح,ح . معدني‌ دماوند,5176,6902130,628849672070,86020,90000,94620,8600,10.0,91110,5090,5.92,85500,94620,1399-7-1
49,غگيلا,شيرپاستوريزه پگاه گيلان,5163,82689,1345598097,15499,16273,16273,774,4.99,15519,20,0.13,16273,16273,1399-7-1
50,دماوند,توليد نيروي برق دماوند,5147,7222307,435893063915,59954,61000,62940,2986,4.98,60354,400,0.67,57400,62940,1399-7-1
51,بركت,گروه دارويي بركت,5016,29311035,490666725900,17620,16740,16740,-880,-4.99,16740,-880,-4.99,16740,16740,1399-7-1
52,آگاس,صندوق س.هستي بخش آگاه-س,4977,7545611,580994592771,73559,76000,79100,5541,7.53,76998,3439,4.68,73740,79500,1399-7-1
53,وآيند,بانك  آينده,4903,47108664,1293294728404,27712,27600,27250,-462,-1.67,27453,-259,-0.93,27158,28266,1399-7-1
54,نوري,پتروشيمي نوري,4484,2924172,526695749270,175860,184600,180900,5040,2.87,180120,4260,2.42,176000,184600,1399-7-1
55,فروي,ذوب روي اصفهان,4469,3847332,228224749521,58472,60000,61000,2528,4.32,59320,848,1.45,55840,61070,1399-7-1
56,كاما,باما,4449,4037298,630548504410,163900,155710,155710,-8190,-5.0,156180,-7720,-4.71,155710,165000,1399-7-1
57,فرابورس,فرابورس ايران,4337,8934512,506045386069,54485,56010,57209,2724,5.0,56639,2154,3.95,54700,57209,1399-7-1
58,شغدير,پتروشيمي غدير,4258,18728392,907817738467,46325,48641,48641,2316,5.0,48473,2148,4.64,46325,48641,1399-7-1
59,وصنعت,سرمايه گذاري توسعه صنعت وتجارت,4091,20883444,194180146110,9490,9600,9410,-80,-0.84,9300,-190,-2.0,9050,9900,1399-7-1
60,ختور,رادياتور ايران‌,4065,8188455,340843360750,40170,38220,42170,2000,4.98,41620,1450,3.61,38220,42170,1399-7-1
61,ومهان,گروه توسعه مالي مهر آيندگان,4045,18538935,358568394434,18515,19440,19440,925,5.0,19341,826,4.46,18515,19440,1399-7-1
62,ختورح,ح . رادياتور ايران‌,4031,10200949,267586461660,25560,25600,27240,1680,6.57,26230,670,2.62,23500,27800,1399-7-1
63,كمند,صندوق س. با درآمد ثابت كمند,3900,186667651,1887345968290,10110,10110,10110,0,0.0,10110,0,0.0,10100,10130,1399-7-1
64,هرمز,فولاد هرمزگان جنوب,3891,28698796,397967529152,13521,14050,14180,659,4.87,13867,346,2.56,13000,14197,1399-7-1
65,كالا,بورس كالاي ايران,3824,8037457,377173831160,48500,46600,47760,-740,-1.53,46930,-1570,-3.24,46080,49880,1399-7-1
66,زكوثر,سرمايه گذاري كشاورزي كوثر,3558,11367887,260129746840,21830,22920,22920,1090,4.99,22880,1050,4.81,22010,22920,1399-7-1
67,بنو,بيمه تجارت نو,3541,20296848,563557879239,27922,26526,29048,1126,4.03,27766,-156,-0.56,26526,29318,1399-7-1
68,كويرح,ح. توليدي فولاد سپيد فراب كوير,3297,17478808,188931375170,10480,10960,11200,720,6.87,10810,330,3.15,10180,11240,1399-7-1
69,ارزش,صندوق س ارزش آفرين بيدار-سهام,3185,20729447,235714435740,11080,11600,11630,550,4.96,11370,290,2.62,11000,11700,1399-7-1
70,شپديس,پتروشيمي پرديس,3173,3662312,429567705190,115590,116130,121300,5710,4.94,117290,1700,1.47,111200,121300,1399-7-1
71,قنيشا,قند  نيشابور,3149,4369770,509867001510,112970,118480,118610,5640,4.99,116680,3710,3.28,113000,118610,1399-7-1
72,وساخت,سرمايه‌ گذاري‌ ساختمان‌ايران‌,3028,9527603,411306009350,44760,45100,42900,-1860,-4.16,43170,-1590,-3.55,42530,45470,1399-7-1
73,پتاير,ايران‌ تاير,2950,2207287,227894883510,101710,106790,103850,2140,2.1,103250,1540,1.51,96630,106790,1399-7-1
74,كوير,توليدي فولاد سپيد فراب كوير,2869,11222893,154388167320,13740,14000,14280,540,3.93,13760,20,0.15,13060,14400,1399-7-1
75,شخارك,پتروشيمي‌ خارك‌,2858,5623613,277923804670,48580,48200,51000,2420,4.98,49420,840,1.73,46160,51000,1399-7-1
76,همراه,شركت ارتباطات سيار ايران,2798,8223416,328170848260,41450,39470,41500,50,0.12,39910,-1540,-3.72,39380,42000,1399-7-1
77,رمپنا,گروه مپنا (سهامي عام),2784,9425030,257154489000,27880,27100,27910,30,0.11,27280,-600,-2.15,26490,28990,1399-7-1
78,طلا,صندوق س.پشتوانه طلاي لوتوس,2761,1378818,144467257879,103829,103000,106110,2281,2.2,104776,947,0.91,100000,107750,1399-7-1
79,ونيكي,سرمايه‌گذاري‌ ملي‌ايران‌,2751,13075161,483999713920,38930,36990,37900,-1030,-2.65,37020,-1910,-4.91,36990,37980,1399-7-1
80,آوا,صندوق س.سهام آواي معيار-س,2745,16006968,164948398572,9673,10138,10700,1027,10.62,10305,632,6.53,9805,10710,1399-7-1
81,وملل,اعتباري ملل,2728,28767384,395596850863,14455,13733,13733,-722,-4.99,13752,-703,-4.86,13733,14451,1399-7-1
82,شسپا,نفت سپاهان,2722,12177253,242817967080,20770,20250,20390,-380,-1.83,19940,-830,-4.0,19740,20770,1399-7-1
83,ثباغ,شهر سازي و خانه سازي باغميشه,2669,23992603,432709272743,17226,18087,18087,861,5.0,18035,809,4.7,17335,18087,1399-7-1
84,شصدف,صنعتي دوده فام,2665,156295,3149656840,19193,20152,20152,959,5.0,19250,57,0.3,20152,20152,1399-7-1
85,وسپه,سرمايه‌گذاري‌ سپه‌,2611,9071320,152874216700,16710,16870,17500,790,4.73,16850,140,0.84,16030,17500,1399-7-1
86,فسازان,غلتك سازان سپاهان,2495,10916821,471095517290,41760,42600,43840,2080,4.98,43150,1390,3.33,40640,43840,1399-7-1
87,خكرمان,گروه اقتصادي كرمان خودرو,2475,29349030,202133670456,7076,7000,6900,-176,-2.49,6887,-189,-2.67,6864,7200,1399-7-1
88,تاصيكو,سرمايه گذاري صدرتامين,2449,15138093,181192407240,12410,12410,12000,-410,-3.3,11970,-440,-3.55,11790,12980,1399-7-1
89,قرن,پديده شيمي قرن,2426,1579308,79613285560,52350,49830,51280,-1070,-2.04,50410,-1940,-3.71,49740,52960,1399-7-1
90,فاسمين,كالسيمين‌,2412,4730640,244767319980,53650,51600,51990,-1660,-3.09,51740,-1910,-3.56,50970,55900,1399-7-1
91,وخاور,بانك خاورميانه,2392,18211692,202677026740,10770,10940,11050,280,2.6,11130,360,3.34,10320,11300,1399-7-1
92,بزاگرسح,ح . نيروگاه زاگرس كوثر,2379,19080186,140129198984,7657,7275,7390,-267,-3.49,7344,-313,-4.09,7275,7657,1399-7-1
93,ونفت,سرمايه‌گذاري‌ صنعت‌ نفت‌,2376,15416917,215579600800,14540,13830,14210,-330,-2.27,13980,-560,-3.85,13820,14540,1399-7-1
94,وبوعلي,سرمايه‌گذاري‌بوعلي‌,2348,14133700,133223170080,9640,9640,9730,90,0.93,9430,-210,-2.18,9160,9840,1399-7-1
95,تماوند,تامين سرمايه دماوند,2334,26687164,303372912749,11698,11401,11500,-198,-1.69,11368,-330,-2.82,11348,11930,1399-7-1
96,وتوس,توسعه‌شهري‌توس‌گستر,2327,22193305,540067172490,25610,24330,24550,-1060,-4.14,24330,-1280,-5.0,24330,25000,1399-7-1
97,غسالم,سالمين‌,2214,11806522,56976254580,5070,4820,4820,-250,-4.93,4830,-240,-4.73,4820,5000,1399-7-1
98,وسينا,بانك سينا,2205,18392593,203836093410,11450,11200,11300,-150,-1.31,11080,-370,-3.23,10880,11890,1399-7-1
99,امين يكم,صندوق درآمد ثابت امين يكم فردا,2132,62538700,644731461220,10510,10320,10330,-180,-1.71,10310,-200,-1.9,10250,10350,1399-7-1
100,كلر,كلر پارس,2104,1027153,68003870480,66317,65200,67921,1604,2.42,66206,-111,-0.17,63631,69360,1399-7-1
101,والبر,سرمايه‌ گذاري‌ البرز(هلدينگ‌,2069,7256332,134983975590,19190,18310,19000,-190,-0.99,18600,-590,-3.07,18240,19500,1399-7-1
102,دتوزيع,توزيع دارو پخش,2045,2079451,109004043565,51651,49069,53690,2039,3.95,52420,769,1.49,49069,54233,1399-7-1
103,وصندوق,سرمايه‌گذاري‌صندوق‌بازنشستگي‌,2028,19282880,336875214440,16930,17000,17770,840,4.96,17470,540,3.19,16130,17770,1399-7-1
104,فسپا,گروه‌صنعتي‌سپاهان‌,2022,7683394,335357984160,45740,43460,43660,-2080,-4.55,43650,-2090,-4.57,43460,45100,1399-7-1
105,سفارس,سيمان فارس و خوزستان,2007,15333719,254237125900,17420,16550,16800,-620,-3.56,16580,-840,-4.82,16550,17310,1399-7-1
106,سرو,صندوق س سروسودمند مدبران-سهام,1996,2222908,151230347660,65720,68670,69480,3760,5.72,68030,2310,3.51,65520,69900,1399-7-1
107,تاصيكوح,ح . سرمايه گذاري صدرتامين,1993,11997709,119824180740,10020,10150,10100,80,0.8,9990,-30,-0.3,9510,10400,1399-7-1
108,شاراك,پتروشيمي شازند,1988,6173905,158423831710,25330,25990,26000,670,2.65,25660,330,1.3,24080,26500,1399-7-1
109,ريشمك,توليد و صادرات ريشمك,1950,2932429,121770110933,42741,42750,41000,-1741,-4.07,41525,-1216,-2.85,40604,43800,1399-7-1
110,سرچشمه,سرمايه گذاري مس سرچشمه,1945,12202029,126207668845,9985,10200,10484,499,5.0,10343,358,3.59,9980,10484,1399-7-1
111,فزرين,زرين معدن آسيا,1939,5816150,120814247541,20460,20500,21483,1023,5.0,20772,312,1.52,19437,21483,1399-7-1
112,آسيا,بيمه آسيا,1936,5827658,151203374490,25270,26000,26530,1260,4.99,25950,680,2.69,24410,26530,1399-7-1
113,ارفعح,ح.شركت آهن و فولاد ارفع,1862,12844962,205280479524,15239,16000,16000,761,4.99,15981,742,4.87,15290,16000,1399-7-1
114,رانفور,خدمات‌انفورماتيك‌,1851,5904028,162952978990,28780,28780,28150,-630,-2.19,27600,-1180,-4.1,27350,28780,1399-7-1
115,كگازح,ح . شيشه‌ و گاز,1849,5478640,94067531790,16020,16220,17620,1600,9.99,17170,1150,7.18,15500,17620,1399-7-1
116,دانا,بيمه دانا,1840,14797237,105551066640,7460,7090,7170,-290,-3.89,7130,-330,-4.42,7090,7830,1399-7-1
117,دسينا,داروسازي‌ سينا,1817,3827020,120545218530,32860,31220,31220,-1640,-4.99,31500,-1360,-4.14,31220,34000,1399-7-1
118,كسرا,سراميك‌هاي‌صنعتي‌اردكان‌,1800,4790318,109504942060,25080,23000,22350,-2730,-10.89,22860,-2220,-8.85,22020,24150,1399-7-1
119,مدير,ص.س.مديريت ثروت ص.بازنشستگي-س,1764,9911466,115624849239,10644,11600,11708,1064,10.0,11666,1022,9.6,11350,11708,1399-7-1
120,توريل,توکاريل,1735,7500080,119562725042,16275,15462,16550,275,1.69,15942,-333,-2.05,15462,17000,1399-7-1
121,وسبحان,سرمايه گذاري سبحان,1716,14931452,136396200558,8900,9110,9345,445,5.0,9135,235,2.64,8590,9345,1399-7-1
122,وسكاب,س.ص.بازنشستگي كاركنان بانكها,1714,16621498,115435433390,6900,7000,7100,200,2.9,6940,40,0.58,6610,7210,1399-7-1
123,پارس,پتروشيمي پارس,1692,1358700,221945224420,157170,165000,165020,7850,4.99,163350,6180,3.93,154200,165020,1399-7-1
124,تنوين,تامين سرمايه نوين,1686,9406100,97138323290,10480,10300,10500,20,0.19,10330,-150,-1.43,10000,10990,1399-7-1
125,عيار,صندوق س. پشتوانه طلاي مفيد,1683,1701918,62654272837,36671,36990,37120,449,1.22,36814,143,0.39,35110,37400,1399-7-1
126,كبافق,معادن‌ بافق‌,1648,2711489,84792967690,32560,30940,31700,-860,-2.64,31270,-1290,-3.96,30940,33990,1399-7-1
127,شبهرن,نفت‌ بهران‌,1614,3035107,184291280750,63410,60710,61000,-2410,-3.8,60720,-2690,-4.24,60240,63000,1399-7-1
128,افق,فروشگاههاي زنجيره اي افق كوروش,1600,1871338,134160322390,69340,70700,72800,3460,4.99,71690,2350,3.39,70020,72800,1399-7-1
129,كرماشا,صنايع پتروشيمي كرمانشاه,1581,4127959,198812749390,46440,47680,48760,2320,5.0,48160,1720,3.7,45000,48760,1399-7-1
130,تيپيكو,سرمايه گذاري دارويي تامين,1580,2145145,127012258370,57190,59580,60040,2850,4.98,59210,2020,3.53,55550,60040,1399-7-1
131,سيمرغ,سيمرغ,1578,9310999,187723925470,19210,20170,20170,960,5.0,20160,950,4.95,19900,20170,1399-7-1
132,چدن,توليدي چدن سازان,1568,10884116,276830371870,26420,25110,26190,-230,-0.87,25430,-990,-3.75,25100,26900,1399-7-1
133,شلرد,كود شيميايي اوره لردگان,1564,18822530,222538772190,12188,11823,11823,-365,-2.99,11823,-365,-2.99,11823,11823,1399-7-1
134,فجر,فولاد اميركبيركاشان,1552,2882604,175141821780,60860,63000,62950,2090,3.43,60760,-100,-0.16,57820,63900,1399-7-1
135,وبشهر,توسعه‌ صنايع‌ بهشهر(هلدينگ,1549,15429809,252526213040,15830,15840,16620,790,4.99,16370,540,3.41,15350,16620,1399-7-1
136,واميد,گروه مديريت سرمايه گذاري اميد,1545,3402344,147241481090,42090,42090,44190,2100,4.99,43280,1190,2.83,40550,44190,1399-7-1
137,تكشا,گسترش‌صنايع‌وخدمات‌كشاورزي‌,1471,1773548,140297386570,82530,80000,80000,-2530,-3.07,79110,-3420,-4.14,78410,82000,1399-7-1
138,دتوليد,داروسازي توليد دارو,1460,3755056,140176298317,39282,37318,37500,-1782,-4.54,37330,-1952,-4.97,37318,38000,1399-7-1
139,بكهنوج,توليد برق ماهتاب كهنوج,1425,2840540,189229883381,70007,66507,66507,-3500,-5.0,66618,-3389,-4.84,66507,69301,1399-7-1
140,امين,تامين سرمايه امين,1425,2591099,34746637590,14110,13410,13410,-700,-4.96,13540,-570,-4.04,13410,13410,1399-7-1
141,شسينا,صنايع‌شيميايي‌سينا,1385,157994,95262293490,593640,596000,601500,7860,1.32,602950,9310,1.57,593700,610000,1399-7-1
142,خگستر,گسترش‌سرمايه‌گذاري‌ايران‌خودرو,1383,9070409,47801055430,5540,5270,5270,-270,-4.87,5390,-150,-2.71,5270,5270,1399-7-1
143,جم پيلن,پلي پروپيلن جم - جم پيلن,1374,2497765,229709282190,88070,90950,92470,4400,5.0,91970,3900,4.43,88070,92470,1399-7-1
144,غصينو,صنعتي مينو,1372,4988929,153089552103,30914,31778,30915,1,0.0,30686,-228,-0.74,29987,31778,1399-7-1
145,ودي,بيمه  دي,1355,9743837,192703535735,20697,19909,19663,-1034,-5.0,19777,-920,-4.45,19663,21200,1399-7-1
146,آتيمس,صندوق س.آرمان آتيه درخشان مس-س,1349,708870,168287293310,230520,237000,239000,8480,3.68,237402,6882,2.99,228001,245000,1399-7-1
147,اعتماد,صندوق س.اعتماد آفرين پارسيان-د,1337,51335200,1666972604970,32459,32467,32466,7,0.02,32472,13,0.04,32466,32483,1399-7-1
148,شكلر,نيروكلر,1319,3172570,134680952890,43570,42320,44600,1030,2.36,42450,-1120,-2.57,41400,44880,1399-7-1
149,كرازي,كارخانجات‌توليدي‌شيشه‌رازي‌,1314,3808674,64540216790,17640,16760,17230,-410,-2.32,16950,-690,-3.91,16760,17990,1399-7-1
150,فباهنر,مس‌ شهيدباهنر,1313,2805687,167744521690,62780,59650,59650,-3130,-4.99,59790,-2990,-4.76,59650,62810,1399-7-1
151,فخاسح,ح . فولاد خراسان,1259,5147024,144510718530,27020,28900,29720,2700,9.99,28080,1060,3.92,25600,29720,1399-7-1
152,پرديس,سرمايه گذاري پرديس,1246,10151967,78759721940,8050,8000,7820,-230,-2.86,7760,-290,-3.6,7650,8200,1399-7-1
153,جم,پتروشيمي جم,1242,2781014,133571069790,46410,47990,48730,2320,5.0,48030,1620,3.49,46200,48730,1399-7-1
154,وتوكا,سرمايه‌گذاري‌توكافولاد(هلدينگ,1238,8385409,98495021130,11920,11880,12000,80,0.67,11750,-170,-1.43,11330,12250,1399-7-1
155,وپست,پست بانك ايران,1230,7134872,75433146470,10640,10650,10860,220,2.07,10570,-70,-0.66,10210,10990,1399-7-1
156,ميدكو,هلدينگ صنايع  معدني خاورميانه,1217,10787524,219234028505,21079,20026,21090,11,0.05,20323,-756,-3.59,20026,21200,1399-7-1
157,واحيا,م .صنايع و معادن احياء سپاهان,1212,4114117,960409857394,237098,229986,233000,-4098,-1.73,233443,-3655,-1.54,229986,244210,1399-7-1
158,اتكام,شركت بيمه اتكايي امين,1212,6457781,48941215368,7301,7530,7666,365,5.0,7572,271,3.71,7320,7666,1399-7-1
159,وتوكاح,ح . ‌توكافولاد(هلدينگ‌,1206,5673508,50300040598,8671,8880,9080,409,4.72,8866,195,2.25,8371,9200,1399-7-1
160,ثاخت,بين‌المللي‌توسعه‌ساختمان,1191,12959984,60652725120,4920,4680,4680,-240,-4.88,4680,-240,-4.88,4680,4680,1399-7-1
161,كحافظ,كاشي‌ وسراميك‌ حافظ‌,1176,5454026,84469455240,14760,15490,15490,730,4.95,15490,730,4.95,15170,15490,1399-7-1
162,فولاژ,فولاد آلياژي ايران,1170,2097126,59218735550,28100,27410,28600,500,1.78,28220,120,0.43,26700,29400,1399-7-1
163,شپاكسا,پاكسان‌,1158,3910183,100469184240,26460,25600,25810,-650,-2.46,25690,-770,-2.91,25140,26700,1399-7-1
164,فروس,فروسيليس‌ ايران‌,1151,2244565,49622925590,22940,22200,22250,-690,-3.01,22110,-830,-3.62,21800,23190,1399-7-1
165,اطلس,صندوق س.توسعه اندوخته آينده-س,1149,331591,68260493551,196804,201123,208990,12186,6.19,205857,9053,4.6,198000,209000,1399-7-1
166,مبين,مبين انرژي خليج فارس,1121,5591285,148820589740,25550,26600,26820,1270,4.97,26620,1070,4.19,25290,26820,1399-7-1
167,دفارا,داروسازي‌ فارابي‌,1117,969909,70072141900,70400,70400,73920,3520,5.0,72250,1850,2.63,67230,73920,1399-7-1
168,ولصنم,ليزينگ‌صنعت‌ومعدن‌,1116,6507954,62188744890,10040,9540,9580,-460,-4.58,9560,-480,-4.78,9540,10030,1399-7-1
169,شپارسح,ح . بين‌ المللي‌محصولات پارس‌,1105,5140719,57102164508,11029,11100,11380,351,3.18,11108,79,0.72,10600,11730,1399-7-1
170,كنور,توسعه معدني و صنعتي صبانور,1091,1820651,88359481230,47080,48500,49400,2320,4.93,48530,1450,3.08,47080,49420,1399-7-1
171,سيدكو,سرمايه گذاري توسعه صنايع سيمان,1076,9649452,69846373500,7490,7340,7500,10,0.13,7240,-250,-3.34,7120,7800,1399-7-1
172,ساروم,سيمان‌اروميه‌,1072,2666593,67748255250,25410,26000,25560,150,0.59,25410,0,0.0,24500,26300,1399-7-1
173,وپترو,سرمايه‌گذاري صنايع پتروشيمي‌,1057,3407489,54930849430,16510,16510,16540,30,0.18,16120,-390,-2.36,15690,17040,1399-7-1
174,ضخود7057,اختيارخ خودرو-4000-1399/07/09,1056,66982,1156672000,17,23,17,0,0.0,17,0,0.0,14,24,1399-7-1
175,كگهر,سنگ آهن گهرزمين,1048,1182225,57255519389,47911,49000,49899,1988,4.15,48163,252,0.53,45516,50000,1399-7-1
176,كاردان,صندوق س تجارت شاخصي كاردان,1023,523490,105611386720,191520,206000,205970,14450,7.54,201740,10220,5.34,192010,207000,1399-7-1
177,حفاري,حفاري شمال,1013,10958800,124820732000,11980,11390,11390,-590,-4.92,11390,-590,-4.92,11390,11390,1399-7-1
178,كيميا,معدني كيمياي زنجان گستران,971,2481448,66151913029,28002,26615,26700,-1302,-4.65,26659,-1343,-4.8,26602,27900,1399-7-1
179,وتوسم,سرمايه‌گذاري‌توسعه‌ملي‌,970,4855012,64502113750,13070,13000,13390,320,2.45,13290,220,1.68,12470,13580,1399-7-1
180,غدام,خوراك‌  دام‌ پارس‌,959,2030572,281740900270,135720,130020,142500,6780,5.0,138750,3030,2.23,130020,142500,1399-7-1
181,مارون,پتروشيمي مارون,954,527642,68644070010,127960,128000,134350,6390,4.99,129549,1589,1.24,122501,134350,1399-7-1
182,فسرب,ملي‌ سرب‌وروي‌ ايران‌,949,723962,89670054790,126990,131990,123550,-3440,-2.71,123860,-3130,-2.46,120650,132000,1399-7-1
183,تليسه,دامداري تليسه نمونه,936,927280,58276152826,66145,62838,62838,-3307,-5.0,62846,-3299,-4.99,62838,65000,1399-7-1
184,بكاب,صنايع‌جوشكاب‌يزد,929,745679,97228103730,126760,129500,133090,6330,4.99,130390,3630,2.86,120430,133090,1399-7-1
185,فرآور,فرآوري‌موادمعدني‌ايران‌,927,4904810,126307736160,26850,26300,25630,-1220,-4.54,25750,-1100,-4.1,25510,27480,1399-7-1
186,شيراز,پتروشيمي‌شيراز,914,1483351,100020561830,67130,67500,69390,2260,3.37,67430,300,0.45,64600,70480,1399-7-1
187,شراز,پالايش نفت شيراز,913,955008,100853932982,104618,107300,106790,2172,2.08,105605,987,0.94,99390,109848,1399-7-1
188,وبيمه,سرمايه‌ گذاري‌ صنعت‌ بيمه‌,903,6963722,25372224350,3830,3640,3640,-190,-4.96,3720,-110,-2.87,3640,3700,1399-7-1
189,شگل,گلتاش‌,890,2965082,87333343880,29930,29440,30200,270,0.9,29450,-480,-1.6,28440,30790,1399-7-1
190,فخاس,فولاد خراسان,877,1939028,78472921570,39100,39000,41050,1950,4.99,40160,1060,2.71,37800,41050,1399-7-1
191,وصنا,گروه‌صنايع‌بهشهرايران‌,877,5788031,59496873140,9880,10370,10370,490,4.96,10280,400,4.05,9730,10370,1399-7-1
192,وهور,مديريت انرژي اميد  تابان هور,869,6405683,245920606282,40291,38400,38870,-1421,-3.53,38391,-1900,-4.72,38277,40000,1399-7-1
193,چكاپا,گروه صنايع كاغذ پارس,858,5496246,55786896900,10680,10150,10150,-530,-4.96,10150,-530,-4.96,10150,10150,1399-7-1
194,فيروزه,صندوق شاخص30 شركت فيروزه- سهام,851,1035430,212991862480,199110,207150,207000,7890,3.96,205700,6590,3.31,199110,216500,1399-7-1
195,بموتو,موتوژن‌,844,1287706,57694813120,43400,43500,45570,2170,5.0,44800,1400,3.23,41710,45570,1399-7-1
196,فايرا,آلومينيوم‌ايران‌,832,1644010,29276413280,18020,17300,17900,-120,-0.67,17880,-140,-0.78,17300,18900,1399-7-1
197,شفن,پتروشيمي فناوران,811,615380,187559241130,294190,300000,308890,14700,5.0,304790,10600,3.6,293000,308890,1399-7-1
198,غبشهر,صنعتي‌ بهشهر,803,2054360,42093248200,21470,20410,20500,-970,-4.52,20590,-880,-4.1,20400,21900,1399-7-1
199,بفجر,فجر انرژي خليج فارس,780,2524508,75996372820,29020,30470,30470,1450,5.0,30070,1050,3.62,28220,30470,1399-7-1
200,زر,صندوق س.پشتوانه سكه طلاي زر,771,356281,21797315849,60358,60010,62398,2040,3.38,61180,822,1.36,60010,62990,1399-7-1
201,غگل,گلوكوزان‌,771,4077272,22751177760,5870,5580,5580,-290,-4.94,5720,-150,-2.56,5580,5580,1399-7-1
202,سپ,پرداخت الكترونيك سامان كيش,757,1073687,22745189290,21480,20600,21600,120,0.56,21330,-150,-0.7,20520,21980,1399-7-1
203,كاذر,فرآورده‌هاي‌نسوزآذر,754,1621485,50050404640,30180,30900,31680,1500,4.97,30870,690,2.29,29100,31680,1399-7-1
204,شلعاب,لعابيران‌,729,2542732,22659204020,9180,8790,9220,40,0.44,8910,-270,-2.94,8730,9400,1399-7-1
205,كاريس,صندوق س.سپهر كاريزما-س,719,528980,114429782264,212036,218001,220000,7964,3.76,216322,4286,2.02,210000,224499,1399-7-1
206,شكربن,كربن‌ ايران‌,717,1051250,58834308670,56840,55000,57550,710,1.25,55970,-870,-1.53,54280,58250,1399-7-1
207,دزهراوي,داروسازي‌زهراوي‌,714,3472228,42242551900,12780,12150,12150,-630,-4.93,12190,-590,-4.62,12150,12500,1399-7-1
208,گوهران,سرمايه گذاري توسعه گوهران اميد,709,2854305,28780949841,10335,9900,10330,-5,-0.05,10178,-157,-1.52,9819,10550,1399-7-1
209,شپارس,بين‌ المللي‌ محصولات‌  پارس‌,709,4017465,57649026300,14260,14000,14210,-50,-0.35,14350,90,0.63,13560,14900,1399-7-1
210,لوتوس,تامين سرمايه لوتوس پارسيان,707,4937278,69126977230,14690,13960,14110,-580,-3.95,14000,-690,-4.7,13960,14360,1399-7-1
211,فاما,صنعتي‌ آما,707,3575167,64280299860,17540,17610,18410,870,4.96,17980,440,2.51,16910,18410,1399-7-1
212,دالبر,البرزدارو,690,864638,18393605380,20660,20720,21480,820,3.97,20890,230,1.11,20720,21690,1399-7-1
213,خراسان,پتروشيمي خراسان,688,444654,40287520170,88210,89000,92190,3980,4.51,89700,1490,1.69,85020,92580,1399-7-1
214,واتي,سرمايه‌ گذاري‌ آتيه‌ دماوند,673,4181033,54601421760,12640,12830,13270,630,4.98,13060,420,3.32,12500,13270,1399-7-1
215,قثابت,قند ثابت‌ خراسان‌,662,742315,63495347880,89400,85050,84930,-4470,-5.0,85540,-3860,-4.32,84930,89350,1399-7-1
216,خپارس,پارس‌ خودرو,652,7543621,70608292560,9850,9360,9360,-490,-4.97,9440,-410,-4.16,9360,9360,1399-7-1
217,شپاس,نفت پاسارگاد,650,1684271,36987410356,22551,22260,22260,-291,-1.29,22063,-488,-2.16,21424,23400,1399-7-1
218,حخزر,كشتيراني درياي خزر,647,1739316,43577576771,26326,25010,25010,-1316,-5.0,25119,-1207,-4.58,25010,25940,1399-7-1
219,پكرمان,گروه‌ صنعتي‌ بارز,643,1165042,23402747220,20000,19250,20340,340,1.7,20040,40,0.2,19150,20680,1399-7-1
220,دسبحان,سبحان دارو,640,798799,14261458260,18630,17860,18090,-540,-2.9,18380,-250,-1.34,17700,18660,1399-7-1
221,شوينده,مديريت صنعت شوينده ت.ص.بهشهر,637,666053,25216023870,38220,38100,38440,220,0.58,38030,-190,-0.5,36310,39700,1399-7-1
222,سخوز,سيمان خوزستان,626,2259653,47124322720,19930,20110,20920,990,4.97,20750,820,4.11,20110,20920,1399-7-1
223,سدبير,س. تدبيرگران فارس وخوزستان,623,1811513,47160388898,24827,25900,26068,1241,5.0,25954,1127,4.54,25000,26068,1399-7-1
224,غويتا,ويتانا,618,993838,67747251075,70911,67366,67366,-3545,-5.0,68167,-2744,-3.87,67366,70000,1399-7-1
225,دامين,داروسازي‌ امين‌,610,1926345,26830692310,14590,14000,14100,-490,-3.36,14220,-370,-2.54,13870,14590,1399-7-1
226,اوان,مبين وان كيش,606,682899,30980315769,46681,47600,45750,-931,-1.99,45774,-907,-1.94,44347,47600,1399-7-1
227,آبادا,توليد نيروي برق آبادان,606,381252,9340674000,25780,24500,24500,-1280,-4.97,25520,-260,-1.01,24500,24500,1399-7-1
228,زشگزا,شير و گوشت زاگرس شهركرد,606,759217,66070220888,91220,86809,86659,-4561,-5.0,87024,-4196,-4.6,86659,91300,1399-7-1
229,سباقر,سيمان باقران,606,2586051,43963697772,16536,17029,17032,496,3.0,17000,464,2.81,16800,17032,1399-7-1
230,شبصير,توليدات پتروشيمي قائد بصير,602,1244206,166670103142,127579,133957,133957,6378,5.0,133957,6378,5.0,133957,133957,1399-7-1
231,شفا,سرمايه گذاري شفادارو,601,797523,45124391190,54900,53260,57640,2740,4.99,56500,1600,2.91,53250,57640,1399-7-1
232,ثپرديسح,ح.سرمايه گذاري مسكن پرديس,584,1060456,8498816542,7979,8290,8144,165,2.07,8014,35,0.44,7766,8310,1399-7-1
233,دسبحاح,ح .گروه دارويي سبحان,575,1102439,17215956230,14740,15300,16210,1470,9.97,15620,880,5.97,15290,16210,1399-7-1
234,حسينا,توسعه خدمات دريايي وبندري سينا,573,679871,37796172757,54345,56500,56220,1875,3.45,55239,894,1.65,51900,57062,1399-7-1
235,مفاخر,توسعه فناوري اطلاعات خوارزمي,555,690337,31965824033,47116,44800,46600,-516,-1.1,46523,-593,-1.26,44800,48000,1399-7-1
236,شرانل,نفت ايرانول,553,991959,26949607511,27402,26601,26950,-452,-1.65,27271,-131,-0.48,26150,28000,1399-7-1
237,گوهر,صندوق سكه طلاي كيان,549,211301,14751001198,68886,68800,71600,2714,3.94,69810,924,1.34,68700,72000,1399-7-1
238,كمرجان,بازرگاني و توليدي مرجان كار,545,756647,28923189938,39500,37525,39950,450,1.14,38723,-777,-1.97,37525,40250,1399-7-1
239,افق ملت,صندوق س در سهام افق ملت,543,209015,31504750020,146590,152000,153000,6410,4.37,150730,4140,2.82,146000,154000,1399-7-1
240,دسبحا,گروه دارويي سبحان,540,1789426,32100301470,17230,18080,18090,860,4.99,17680,450,2.61,17210,18090,1399-7-1
241,درازك,دارويي‌ رازك‌,538,872959,34781104740,41760,39680,41230,-530,-1.27,40310,-1450,-3.47,39680,41490,1399-7-1
242,دعبيد,لابراتوارداروسازي‌  دكترعبيدي‌,538,497235,16815377440,35410,33640,34060,-1350,-3.81,34970,-440,-1.24,33640,35180,1399-7-1
243,دارا,صندوق س. دارا الگوريتم-د,537,17439661,174612450742,10138,10025,10012,-126,-1.24,10012,-126,-1.24,10007,10027,1399-7-1
244,پلوله,گازلوله‌,536,1438800,30077260317,20966,21175,20757,-209,-1.0,20904,-62,-0.3,20757,21175,1399-7-1
245,زفكا,كشت و دامداري فكا,534,931431,41433272219,46446,44124,45000,-1446,-3.11,44740,-1706,-3.67,44124,48700,1399-7-1
246,آساس,صندوق س.آسمان آرماني سهام-س,534,516340,85609562884,161601,162350,165000,3399,2.1,165801,4200,2.6,161015,169800,1399-7-1
247,انرژي3,سايراشخاص بورس انرژي,523,78528,30556815360,409590,389120,389120,-20470,-5.0,402500,-7090,-1.73,389120,389120,1399-7-1
248,اعتلاح,ح سرمايه گذاري اعتلاء البرز,516,1973725,15160248960,7958,7565,7830,-128,-1.61,7681,-277,-3.48,7561,7958,1399-7-1
249,شيران,س. صنايع‌شيميايي‌ايران,516,1765345,54178438050,32300,30690,30690,-1610,-4.98,31270,-1030,-3.19,30690,30690,1399-7-1
250,كمنگنز,معادن‌منگنزايران‌,515,541372,46607210220,82040,86140,86140,4100,5.0,85840,3800,4.63,82590,86140,1399-7-1
251,درهآور,دارويي ره آورد تامين,498,823080,24379117506,31039,29488,29488,-1551,-5.0,30283,-756,-2.44,29488,30000,1399-7-1
252,كخاك,صنايع‌خاك‌چيني‌ايران‌,485,769586,44047391160,59510,56580,62000,2490,4.18,57460,-2050,-3.44,56540,62000,1399-7-1
253,كروي,توسعه‌ معادن‌ روي‌ ايران‌,478,1235773,43888981140,37360,35500,35500,-1860,-4.98,35520,-1840,-4.93,35500,37000,1399-7-1
254,دتمادح,ح . توليدمواداوليه‌داروپخش‌,478,384570,13434552460,34020,34170,35560,1540,4.53,34930,910,2.67,33200,36160,1399-7-1
255,سكه0012پ01,سكه تمام بهارتحويلي 1روزه رفاه,477,126400,165019968100,1303884,1306000,1309000,5116,0.39,1305538,1654,0.13,1293000,1319998,1399-7-1
256,دتماد,توليدمواداوليه‌داروپخش‌,477,664343,26320292860,40550,38600,40260,-290,-0.72,40050,-500,-1.23,38550,41490,1399-7-1
257,غبهنوش,بهنوش‌ ايران‌,476,902748,55465124790,64670,61440,61440,-3230,-4.99,61440,-3230,-4.99,61440,62000,1399-7-1
258,اتكاي,بيمه اتكايي ايرانيان,475,4072976,59730712908,15094,14340,15188,94,0.62,14665,-429,-2.84,14340,15190,1399-7-1
259,غزر,صنعتي زر ماكارون,467,227241,14559330870,67440,64070,64070,-3370,-5.0,66320,-1120,-1.66,64070,64070,1399-7-1
260,پخش,پخش البرز,462,903230,28127274112,32156,32000,31400,-756,-2.35,31560,-596,-1.85,30549,32530,1399-7-1
261,بترانس,ايران‌ ترانسفو,462,716944,28978876480,42540,40420,40420,-2120,-4.98,41530,-1010,-2.37,40420,40420,1399-7-1
262,وپويا,سرمايه گذاري پويا,457,1437044,17316380200,12684,12050,12050,-634,-5.0,12450,-234,-1.84,12050,12050,1399-7-1
263,ددام,داروسازي زاگرس فارمد پارس,449,838852,11179816170,14010,13500,13310,-700,-5.0,13840,-170,-1.21,13310,13960,1399-7-1
264,دجابر,داروسازي‌ جابرابن‌حيان‌,445,600879,24580715610,42160,40060,41300,-860,-2.04,41490,-670,-1.59,40060,43860,1399-7-1
265,پارند,صندوق س. پارند پايدار سپهر,440,10317260,122019925220,11790,11760,11900,110,0.93,11830,40,0.34,11710,11930,1399-7-1
266,ثشرقح,ح. سرمايه گذاري مسكن شمال شرق,437,2576664,10457124850,4160,4220,4150,-10,-0.24,4060,-100,-2.4,3850,4390,1399-7-1
267,زمگسا,كشاورزي‌ ودامپروي‌ مگسال‌,413,908887,25164017860,29040,27750,27900,-1140,-3.93,28310,-730,-2.51,27590,28600,1399-7-1
268,كي بي سي,شركت كي بي سي,409,616188,22619934660,37082,37115,35332,-1750,-4.72,36915,-167,-0.45,35228,38410,1399-7-1
269,زپارس,ملي كشت و صنعت و دامپروري پارس,405,190330,14005505870,71570,75120,73080,1510,2.11,72150,580,0.81,71800,75120,1399-7-1
270,پارسيان,بيمه پارسيان,403,2904341,29451316530,10630,10110,10540,-90,-0.85,10250,-380,-3.57,10100,10580,1399-7-1
271,حريل,ريل پردازسير,394,4777347,20303724750,4473,4250,4250,-223,-4.99,4371,-102,-2.28,4250,4250,1399-7-1
272,شنفت,نفت‌ پارس‌,392,768875,47257398650,64390,61180,61180,-3210,-4.99,62140,-2250,-3.49,61180,64390,1399-7-1
273,خديزل,بهمن  ديزل,384,713960,27990416986,39200,40000,39500,300,0.77,39203,3,0.01,37240,41160,1399-7-1
274,دشيمي,شيمي‌ داروئي‌ داروپخش‌,374,519972,31669621750,63490,64590,60320,-3170,-4.99,61870,-1620,-2.55,60320,64590,1399-7-1
275,وجامي,سرمايه گذاري جامي,367,3244791,37212950049,11158,11492,11492,334,2.99,11469,311,2.79,11010,11492,1399-7-1
276,سهرمز,سيمان‌هرمزگان‌,364,523242,8609829050,16740,17300,16700,-40,-0.24,16690,-50,-0.3,15910,17300,1399-7-1
277,ولساپا,ليزينگ رايان‌ سايپا,360,6975360,29994048000,4520,4300,4300,-220,-4.87,4370,-150,-3.32,4300,4300,1399-7-1
278,چكارن,كارتن‌ ايران‌,352,2017253,8936430790,4660,4430,4430,-230,-4.94,4610,-50,-1.07,4430,4430,1399-7-1
279,دشيري,شيرين دارو,350,110495,21130021667,190594,185309,191999,1405,0.74,191231,637,0.33,185309,196310,1399-7-1
280,بگيلان,توسعه مسير برق گيلان,350,178190,5994667980,35412,33642,33642,-1770,-5.0,35229,-183,-0.52,33642,33642,1399-7-1
281,فلات,گروه صنايع معادن فلات ايرانيان,349,2041654,29715496471,14975,14526,14526,-449,-3.0,14555,-420,-2.8,14526,15000,1399-7-1
282,زگلدشت,كشت و دام گلدشت نمونه اصفهان,349,490986,18862014300,40421,38400,39000,-1421,-3.52,39599,-822,-2.03,38400,40000,1399-7-1
283,كاسپين,داروسازي كاسپين تامين,347,486340,12162682275,26254,24942,25290,-964,-3.67,25918,-336,-1.28,24942,26254,1399-7-1
284,سهگمت,سيمان‌هگمتان‌,345,605811,11332242520,18900,18150,19150,250,1.32,18860,-40,-0.21,18060,19430,1399-7-1
285,دابور,داروسازي‌ ابوريحان‌,343,272478,11403179980,41260,40530,42490,1230,2.98,41390,130,0.32,40530,42900,1399-7-1
286,ساينا,صنايع بهداشتي ساينا,340,206722,40177667536,185147,194404,194404,9257,5.0,191914,6767,3.65,190000,194404,1399-7-1
287,خمحركه,نيرو محركه‌,331,1170009,10424780190,9370,8910,8910,-460,-4.91,9270,-100,-1.07,8910,8910,1399-7-1
288,فاراك,ماشين‌ سازي‌ اراك‌,331,1360316,13698382120,10590,10070,10070,-520,-4.91,10430,-160,-1.51,10070,10070,1399-7-1
289,آ س پ,آ.س.پ,311,1089239,16602428731,15935,15139,15139,-796,-5.0,15691,-244,-1.53,15139,16124,1399-7-1
290,سبهان,سيمان‌ بهبهان‌,311,196529,11630584500,60030,58510,60100,70,0.12,59820,-210,-0.35,58000,61850,1399-7-1
291,تايرا,تراكتورسازي‌ايران‌,307,1676907,38602434140,24230,23020,23020,-1210,-4.99,23210,-1020,-4.21,23020,23030,1399-7-1
292,رنيك,جنرال مكانيك,288,1401201,35762745552,26863,25520,25520,-1343,-5.0,25833,-1030,-3.83,25520,25577,1399-7-1
293,غنوش,نوش‌ مازندران‌,286,1297493,113348988480,91950,87360,87360,-4590,-4.99,87360,-4590,-4.99,87360,87360,1399-7-1
294,غپينو,پارس‌ مينو,285,2211385,12936602250,6150,5850,5850,-300,-4.88,6060,-90,-1.46,5850,5850,1399-7-1
295,دارا2,صندوق س. دارا الگوريتم-د,283,28300000,28300000,10138,1,1,-10137,-99.99,1,-10137,-99.99,1,1,1399-7-1
296,وآفري,بيمه كارآفرين,281,2307981,36373059655,15302,15761,15761,459,3.0,15760,458,2.99,15700,15761,1399-7-1
297,دارو,كارخانجات‌داروپخش‌,281,277258,13928795670,50650,48250,51500,850,1.68,50530,-120,-0.24,48250,53000,1399-7-1
298,ما,بيمه  ما,280,1770796,11014991440,6540,6220,6220,-320,-4.89,6460,-80,-1.22,6220,6230,1399-7-1
299,زعف9908پ10,زعفران9908نگين طلاي سرخ(پ),279,238958,20004642703,87746,86006,83359,-4387,-5.0,83716,-4030,-4.59,83359,86006,1399-7-1
300,ثاصفا,شركت‌ ساختمان‌ اصفهان‌,276,503862,14537930286,28013,28853,28853,840,3.0,28560,547,1.95,28853,28853,1399-7-1
301,وسخراج,شركت س استان خراسان جنوبي,272,15180847,32942437990,2070,2170,2170,100,4.83,2130,60,2.9,2170,2170,1399-7-1
302,كفرا,فراورده‌ هاي‌ نسوزايران‌,270,327010,13247952610,42620,40490,40490,-2130,-5.0,42030,-590,-1.38,40490,40990,1399-7-1
303,دلر,داروسازي‌ اكسير,260,108996,10956947770,99930,97020,101800,1870,1.87,100060,130,0.13,97020,102990,1399-7-1
304,كيان,صندوق س. با درآمد ثابت كيان,257,4094476,103495811120,25240,25240,25300,60,0.24,25280,40,0.16,25240,25320,1399-7-1
305,بذر,صندوق س بذر اميد آفرين-سهام,256,104174,12270216820,114210,120500,119490,5280,4.62,117790,3580,3.13,114600,120500,1399-7-1
306,كاسپينح,ح .داروسازي كاسپين تامين,253,368825,7721509299,21138,21002,21269,131,0.62,20935,-203,-0.96,20110,21630,1399-7-1
307,هغدير912,اختيارف ت غدير-17380-99/12/16,252,6908500,6908500,1,1,1,0,0.0,1,0,0.0,1,1,1399-7-1
308,دمعيار,صندوق س. توازن معيار-د,248,10634571,106446115145,10131,10010,10007,-124,-1.22,10009,-122,-1.2,10000,10013,1399-7-1
309,ضجار7022,اختيارخ وتجارت-2800-1399/07/22,248,8993,4889918000,573,610,525,-48,-8.38,544,-29,-5.06,472,648,1399-7-1
310,سفانو,سيمان فارس نو,243,250161,8101361390,33860,32170,32970,-890,-2.63,33600,-260,-0.77,32170,33800,1399-7-1
311,وپخش,داروپخش‌ (هلدينگ‌,242,68906,8332539930,121540,115710,121500,-40,-0.03,121430,-110,-0.09,115710,126980,1399-7-1
312,ولملت,واسپاري ملت,240,2560008,30566695520,12560,11940,11940,-620,-4.94,12160,-400,-3.18,11940,11980,1399-7-1
313,پكوير,كوير تاير,238,1256914,18237822140,15270,14510,14510,-760,-4.98,14970,-300,-1.96,14510,14510,1399-7-1
314,كرمان,س. توسعه و عمران استان كرمان,236,320734,24968179698,81944,77847,77847,-4097,-5.0,79636,-2308,-2.82,77847,77847,1399-7-1
315,وساپا,سرمايه‌گذاري‌ سايپا,233,2770440,31832355600,12090,11490,11490,-600,-4.96,11700,-390,-3.23,11490,11490,1399-7-1
316,سبجنو,سيمان‌ بجنورد,225,472126,15374253190,32930,32150,31790,-1140,-3.46,32820,-110,-0.33,31290,33970,1399-7-1
317,افران,صندوق س افرا نماد پايدار-ثابت,215,15063397,176242409240,11710,11730,11730,20,0.17,11700,-10,-0.09,11700,11730,1399-7-1
318,دقاضي,داروسازي شهيد قاضي,214,312408,29473340981,94962,92114,97789,2827,2.98,94342,-620,-0.65,92114,97810,1399-7-1
319,پرداخت,به پرداخت ملت,204,190703,7467807430,41010,39020,39130,-1880,-4.58,40700,-310,-0.76,38970,40350,1399-7-1
320,شاملا,معدني‌ املاح‌  ايران‌,204,174862,11740559920,70200,67290,68000,-2200,-3.13,69400,-800,-1.14,66690,73000,1399-7-1
321,فاهواز,نورد و لوله اهواز,203,1841027,36472585897,20215,19811,19811,-404,-2.0,19886,-329,-1.63,19811,19811,1399-7-1
322,زقيام,كشت و دام قيام اصفهان,202,1184230,34194641250,30394,28875,28875,-1519,-5.0,29277,-1117,-3.68,28875,28875,1399-7-1
323,ستران,سيمان‌ تهران‌,196,376984,13707138240,38270,36360,36360,-1910,-4.99,37660,-610,-1.59,36360,36360,1399-7-1
324,غپونه,نوش پونه مشهد,195,633447,11250956827,18306,17758,17757,-549,-3.0,17984,-322,-1.76,17757,18000,1399-7-1
325,ومعلم,بيمه معلم,191,831250,13344887500,16898,16054,16054,-844,-4.99,16652,-246,-1.46,16054,16054,1399-7-1
326,شپترو,پتروشيمي آبادان,189,4186592,28050166400,6907,6700,6700,-207,-3.0,6700,-207,-3.0,6700,6700,1399-7-1
327,كهمدا,شيشه‌ همدان‌,189,630403,17058705180,28480,27060,27060,-1420,-4.99,27970,-510,-1.79,27060,27060,1399-7-1
328,شتوكا,توكا رنگ فولاد سپاهان,187,497564,14918464852,31557,29980,29980,-1577,-5.0,31027,-530,-1.68,29980,31000,1399-7-1
329,غشهداب,كشت و صنعت شهداب ناب خراسان,185,780054,4141306686,5588,5309,5309,-279,-4.99,5563,-25,-0.45,5309,5309,1399-7-1
330,دپارس,پارس‌ دارو,185,206139,19554318500,99040,94090,96500,-2540,-2.56,97340,-1700,-1.72,94090,99040,1399-7-1
331,ثفارس,عمران‌وتوسعه‌فارس‌,180,2461444,25082114360,10720,10190,10190,-530,-4.94,10430,-290,-2.71,10190,10190,1399-7-1
332,داسوه,داروسازي‌ اسوه‌,179,663534,22002787440,34900,33160,33160,-1740,-4.99,34080,-820,-2.35,33160,33160,1399-7-1
333,سيستم,همكاران سيستم,178,401415,10726023990,26450,25300,27370,920,3.48,26510,60,0.23,25300,27650,1399-7-1
334,ضجار7026,اختيارخ وتجارت-3600-1399/07/22,177,8649,1131820000,200,180,165,-35,-17.5,131,-69,-34.5,120,210,1399-7-1
335,ثشاهد,سرمايه‌ گذاري‌ شاهد,177,128558,6035798100,49420,46950,46950,-2470,-5.0,49220,-200,-0.4,46950,46950,1399-7-1
336,بكام,كارخانجات توليدي شهيد قندي,177,752501,4800956380,6710,6380,6380,-330,-4.92,6670,-40,-0.6,6380,6380,1399-7-1
337,ضچاد7024,اختيارخ كچاد-23300-1399/07/07,174,5265,951390000,428,333,455,27,6.31,181,-247,-57.71,117,549,1399-7-1
338,واحصا,احياء صنايع خراسان,170,410959,6582741262,15552,16018,16018,466,3.0,15705,153,0.98,16018,16018,1399-7-1
339,قچار,فراوردههاي غذايي وقند چهارمحال,159,77350,14721870800,181265,190328,190328,9063,5.0,183636,2371,1.31,190328,190328,1399-7-1
340,فپنتا,سپنتا,157,61681,18985411800,293150,307800,307800,14650,5.0,297920,4770,1.63,307800,307800,1399-7-1
341,صايند,صندوق س. گنجينه آينده روشن-د,156,3166970,31621444060,9947,9942,10030,83,0.83,9985,38,0.38,9942,10030,1399-7-1
342,قهكمت,قندهكمتان‌,156,199379,8973627730,47350,44990,44990,-2360,-4.98,46920,-430,-0.91,44990,46000,1399-7-1
343,خكمك,كمك‌فنرايندامين‌,156,188494,10169251300,59940,53950,53950,-5990,-9.99,58590,-1350,-2.25,53950,53950,1399-7-1
344,سكه9912پ04,سكه تمام بهارتحويل1روزه صادرات,155,39800,51938993900,1299013,1300000,1311770,12757,0.98,1305000,5987,0.46,1291000,1312000,1399-7-1
345,آكورد,صندوق س. آرمان آتي كوثر-د,154,4892712,139714408331,28548,28560,28555,7,0.02,28556,8,0.03,28510,28599,1399-7-1
346,سقاين,سيمان‌ قائن‌,148,235114,9722913130,43520,41350,41360,-2160,-4.96,43060,-460,-1.06,41350,42490,1399-7-1
347,سامان,بانك سامان,147,3102592,41754683136,13874,13458,13458,-416,-3.0,13471,-403,-2.9,13458,13458,1399-7-1
348,پيزد,مجتمع صنايع لاستيك يزد,142,16336,1713662736,110422,104901,104901,-5521,-5.0,110221,-201,-0.18,104901,104901,1399-7-1
349,شاوان,پالايش نفت لاوان,141,293900,34142950800,122286,116172,116172,-6114,-5.0,118357,-3929,-3.21,116172,116172,1399-7-1
350,الماس,صندوق س.امين تدبيرگران فردا-س,140,67520,8347924269,121676,124312,125300,3624,2.98,123636,1960,1.61,118980,125408,1399-7-1
351,ضجار7036,اختيارخ وتجارت-6500-1399/07/22,140,8401,153376000,29,19,18,-11,-37.93,18,-11,-37.93,17,23,1399-7-1
352,كماسه,تامين‌ ماسه‌ ريخته‌گري‌,138,69443,4224217690,64030,60830,60830,-3200,-5.0,63730,-300,-0.47,60830,60830,1399-7-1
353,دسانكو,داروسازي سبحان انكولوژي,135,581851,9929869166,17964,17066,17066,-898,-5.0,17769,-195,-1.09,17066,17066,1399-7-1
354,داوه,داروسازي آوه سينا,135,194043,3534881331,19175,18217,18217,-958,-5.0,19102,-73,-0.38,18217,18217,1399-7-1
355,آريان,سرمايه گذاري پارس آريان,134,4720340,68251396060,15219,14459,14459,-760,-4.99,14651,-568,-3.73,14459,14459,1399-7-1
356,هملت911,اختيارف ت ملت-6770-99/11/25,132,1040000,816400000,510,785,785,275,53.92,785,275,53.92,785,785,1399-7-1
357,كصدف,كاشي صدف سرام استقلال آباده,131,346874,5334310718,15078,15379,15379,301,2.0,15225,147,0.97,15000,15379,1399-7-1
358,سكه0011پ02,سكه تمام بهارتحويلي 1روزه ملت,129,34400,44835379200,1296981,1290001,1307636,10655,0.82,1303354,6373,0.49,1290001,1312000,1399-7-1
359,اخزا815,اسنادخزانه-م15بودجه98-010406,128,134665,98959138917,734202,734200,736000,1798,0.24,734854,652,0.09,734200,736000,1399-7-1
360,ذوب تبعي9912,اختيارف.تبعي ذوب991224,124,158217,110751900,260,700,700,440,169.23,700,440,169.23,700,700,1399-7-1
361,مرقام,ايران‌ارقام‌,123,151384,4157004640,28900,27460,27460,-1440,-4.98,28770,-130,-0.45,27460,27460,1399-7-1
362,اخزا808,اسنادخزانه-م8بودجه98-000817,122,105507,86988642769,823265,821721,824606,1341,0.16,824482,1217,0.15,821721,828499,1399-7-1
363,غچين,كشت‌ و صنعت‌ چين‌ چين,121,338371,16827189830,52340,49730,49730,-2610,-4.99,51330,-1010,-1.93,49730,49730,1399-7-1
364,فيروزا,صندوق بادرآمد ثابت فيروزه آسيا,119,3311813,68901488570,20770,20840,20810,40,0.19,20800,30,0.14,20800,20880,1399-7-1
365,تسه9904,امتياز تسهيلات مسكن تير99,118,1736,1470956958,813414,806000,850000,36586,4.5,847325,33911,4.17,806000,854084,1399-7-1
366,تصميم,صندوق س با درآمد ثابت تصميم,118,4118337,59996180080,14600,14630,14580,-20,-0.14,14570,-30,-0.21,14510,14640,1399-7-1
367,هبهرن912,اختيارف ت شبهرن-74590-99/12/02,116,105000,575400000,3340,5480,5480,2140,64.07,5480,2140,64.07,5480,5480,1399-7-1
368,سپاس,صندوق س. پاداش سهامداري توسعه1,115,3536941,35728089830,10090,10100,10100,10,0.1,10100,10,0.1,10090,10110,1399-7-1
369,صنوين,صندوق سرمايه‌گذاري صنوين-مختلط,113,50352,5563796280,110040,110300,113100,3060,2.78,110500,460,0.42,109000,114500,1399-7-1
370,ثقزوي,شركت عمران و سازندگي قزوين,111,722323,16090467148,21628,22276,22276,648,3.0,22101,473,2.19,22276,22276,1399-7-1
371,ثالوند,سرمايه گذاري مسكن الوند,109,2233888,30586394496,14412,13692,13692,-720,-5.0,13947,-465,-3.23,13692,13692,1399-7-1
372,آسام,صندوق س.آرمان سپهر آشنا-م,109,65180,7133160070,106258,109000,109500,3242,3.05,109438,3180,2.99,105007,115619,1399-7-1
373,كفرآور,فرآورده هاي سيمان شرق,107,908741,19431608803,20365,21383,21383,1018,5.0,21234,869,4.27,21383,21383,1399-7-1
374,ملت,بيمه ملت,106,704365,9163788650,13690,13010,13010,-680,-4.97,13550,-140,-1.02,13010,13010,1399-7-1
375,وگستر,گسترش سرمايه گذاري ايرانيان,105,711564,15000480684,22190,21081,21081,-1109,-5.0,21837,-353,-1.59,21081,21081,1399-7-1
376,سشرق,سيمان‌ شرق‌,98,359550,2732580000,8000,7600,7600,-400,-5.0,7980,-20,-0.25,7600,7600,1399-7-1
377,لپارس,پارس‌ الكتريك‌,98,15571,5769834050,390050,370550,370550,-19500,-5.0,387670,-2380,-0.61,370550,370550,1399-7-1
378,ياقوت,صندوق س ياقوت آگاه-ثابت,95,1376631,15252751230,11090,11070,11100,10,0.09,11080,-10,-0.09,11060,11170,1399-7-1
379,حفارس,حمل و نقل بين المللي خليج فارس,95,460392,2435473680,5560,5290,5290,-270,-4.86,5550,-10,-0.18,5290,5290,1399-7-1
380,بخاور,بيمه زندگي خاورميانه,94,726668,5251629636,7607,7227,7227,-380,-5.0,7563,-44,-0.58,7227,7227,1399-7-1
381,شتولي,تولي‌پرس‌,94,674568,11515550328,16737,17071,17071,334,2.0,17071,334,2.0,17071,17071,1399-7-1
382,اخزا814,اسنادخزانه-م14بودجه98-010318,94,351595,260833911314,741894,741000,742900,1006,0.14,741859,-35,0.0,740510,742900,1399-7-1
383,سلار,شركت سيمان لارستان,92,831160,24457808040,30288,29450,29380,-908,-3.0,29426,-862,-2.85,29380,29450,1399-7-1
384,وهنر,گروه توسعه هنر ايران,91,1507905,7480716705,5222,4961,4961,-261,-5.0,5115,-107,-2.05,4961,4961,1399-7-1
385,سپاها,سيمان‌سپاهان‌,90,1058115,10189647450,10130,9630,9630,-500,-4.94,10020,-110,-1.09,9630,9630,1399-7-1
386,بهپاك,صنعتي بهپاك,89,115754,4140983596,37656,35774,35774,-1882,-5.0,37489,-167,-0.44,35774,35774,1399-7-1
387,زماهان,مجتمع توليد گوشت مرغ ماهان,87,270029,6901941240,26905,25560,25560,-1345,-5.0,26709,-196,-0.73,25560,25560,1399-7-1
388,ضجار7031,اختيارخ وتجارت-4600-1399/07/22,85,4150,264994000,82,61,70,-12,-14.63,64,-18,-21.95,60,75,1399-7-1
389,ولغدر,ليزينگ‌خودروغدير,85,2573221,46884086620,19170,18220,18220,-950,-4.96,18220,-950,-4.96,18220,18220,1399-7-1
390,تسه9901,امتياز تسهيلات مسكن فروردين99,85,3599,3022458005,809209,830000,849595,40386,4.99,839805,30596,3.78,803500,849595,1399-7-1
391,فنفت,صنايع تجهيزات نفت,84,628581,9656889903,15838,15363,15363,-475,-3.0,15597,-241,-1.52,15363,15363,1399-7-1
392,ثجوان,تامين مسكن جوانان,84,749148,6123248041,8603,8173,8173,-430,-5.0,8456,-147,-1.71,8173,8200,1399-7-1
393,تسه9708,امتياز تسهيلات مسكن آبان97,82,1839,1462171845,795256,770000,800000,4744,0.6,795091,-165,-0.02,762100,820000,1399-7-1
394,كدما,معدني‌ دماوند,82,91548,13751425080,143060,150210,150210,7150,5.0,144820,1760,1.23,150210,150210,1399-7-1
395,شجم,صنايع پتروشيمي تخت جمشيد,81,677873,6312353376,9600,9312,9312,-288,-3.0,9525,-75,-0.78,9312,9312,1399-7-1
396,ورنا,سرمايه‌گذاري‌ رنا(هلدينگ‌,79,205216,2284054080,11710,11130,11130,-580,-4.95,11680,-30,-0.26,11130,11130,1399-7-1
397,وملي,گروه‌ صنعتي‌ ملي‌ (هلدينگ‌,79,3943,2215689990,591500,561930,561930,-29570,-5.0,590320,-1180,-0.2,561930,561930,1399-7-1
398,بزاگرس,نيروگاه زاگرس كوثر,78,642044,9893255996,16220,15409,15409,-811,-5.0,16049,-171,-1.05,15409,15409,1399-7-1
399,تسه9905,امتياز تسهيلات مسكن مرداد99,77,1054,903928730,827167,810333,868525,41358,5.0,857617,30450,3.68,810333,868525,1399-7-1
400,سدور,سيمان‌ دورود,76,536239,4445421310,8720,8290,8290,-430,-4.93,8680,-40,-0.46,8290,8290,1399-7-1
401,وآرين,شركت توسعه اقتصادي آرين,76,926421,4849813935,5510,5235,5235,-275,-4.99,5438,-72,-1.31,5235,5235,1399-7-1
402,اخزا813,اسنادخزانه-م13بودجه98-010219,75,31487,23686496595,750616,751000,753900,3284,0.44,752263,1647,0.22,750108,755000,1399-7-1
403,حپترو,حمل و نقل پتروشيمي( سهامي عام,74,79997,2447908200,32210,30600,30600,-1610,-5.0,32130,-80,-0.25,30600,30600,1399-7-1
404,سكارون,سيمان كارون,72,89374,9828905650,106772,109975,109975,3203,3.0,108384,1612,1.51,109975,109975,1399-7-1
405,غمارگ,مارگارين‌,72,108215,3188013900,31010,29460,29460,-1550,-5.0,30910,-100,-0.32,29460,29460,1399-7-1
406,حاريا,كشتيراني آريا,71,763882,21504806064,27333,28152,28152,819,3.0,28101,768,2.81,28152,28152,1399-7-1
407,اميد,تامين سرمايه اميد,69,294528,4827313920,17250,16390,16390,-860,-4.99,17180,-70,-0.41,16390,16390,1399-7-1
408,تسه9709,امتياز تسهيلات مسكن آذر97,67,1703,1384022005,798412,806920,790960,-7452,-0.93,812696,14284,1.79,785015,827999,1399-7-1
409,حتايد,تايدواترخاورميانه,67,143151,2787149970,20490,19470,19470,-1020,-4.98,20430,-60,-0.29,19470,19470,1399-7-1
410,شپلي,پلي اكريل ايران,67,194796,1580769540,8365,8115,8115,-250,-2.99,8344,-21,-0.25,8115,8115,1399-7-1
411,دروز,داروسازي‌ روزدارو,66,431999,8372291620,20390,19380,19380,-1010,-4.95,20210,-180,-0.88,19380,19830,1399-7-1
412,وتوشه,سرمايه‌ گذاري‌ پارس‌ توشه‌,66,828274,17708498120,22500,21380,21380,-1120,-4.98,22050,-450,-2.0,21380,21380,1399-7-1
413,اخزا811,اسنادخزانه-م11بودجه98-001013,66,155176,124566672748,802925,800074,804000,1075,0.13,802744,-181,-0.02,800074,805000,1399-7-1
414,اخزا809,اسنادخزانه-م9بودجه98-000923,64,37556,30456391433,810761,807789,811006,245,0.03,810959,198,0.02,807789,812500,1399-7-1
415,سمتاز,سيمان ممتازان كرمان,63,99039,2084640743,21661,21012,21012,-649,-3.0,21594,-67,-0.31,21012,22095,1399-7-1
416,شكبير,پتروشيمي اميركبير,62,202660,12398130820,63069,61177,61177,-1892,-3.0,62803,-266,-0.42,61177,61177,1399-7-1
417,ثنور,سرمايه گذاري كوه نور,61,223105,1735756900,8189,7780,7780,-409,-4.99,8150,-39,-0.48,7780,7780,1399-7-1
418,غشهد,شهد ايران ‌,61,141240,1070599200,7970,7580,7580,-390,-4.89,7960,-10,-0.13,7580,7580,1399-7-1
419,غمينو,شركت صنايع غذايي مينو شرق,61,129035,1883781965,15367,14599,14599,-768,-5.0,15336,-31,-0.2,14599,14599,1399-7-1
420,هشير911,اختيارف ت شيراز-73480-99/11/27,60,128000,116096000,1,907,907,906,90600.0,907,906,90600.0,907,907,1399-7-1
421,ثعمرا,عمران و توسعه شاهد,58,1663202,44630362468,28246,26834,26834,-1412,-5.0,26917,-1329,-4.71,26834,26834,1399-7-1
422,تسه9906,امتياز تسهيلات مسكن شهريور99,58,1240,1016989256,774564,820000,824999,50435,6.51,820153,45589,5.89,820000,824999,1399-7-1
423,زبينا,كشاورزي و دامپروري بينالود,58,1017568,51837966624,53624,50943,50943,-2681,-5.0,50943,-2681,-5.0,50943,50943,1399-7-1
424,سخاش,سيمان‌خاش‌,56,36787,2711201900,77570,73700,73700,-3870,-4.99,77350,-220,-0.28,73700,73700,1399-7-1
425,ضغدر8043,اختيارخ وغدير-16000-1399/08/26,56,662,2111030000,3103,3500,3400,297,9.57,3189,86,2.77,3100,3500,1399-7-1
426,ثپرديس,سرمايه گذاري مسكن پرديس,55,2211304,30544742152,14540,13813,13813,-727,-5.0,14072,-468,-3.22,13813,13813,1399-7-1
427,گكوثر,هتل پارسيان كوثر اصفهان,54,14780,2693728900,191847,182255,182255,-9592,-5.0,191293,-554,-0.29,182255,182255,1399-7-1
428,ساوه,سيمان ساوه,54,14890,1054048210,74514,70789,70789,-3725,-5.0,74431,-83,-0.11,70789,70789,1399-7-1
429,تسه9903,امتياز تسهيلات مسكن خرداد99,54,1141,960871254,813748,794980,830200,16452,2.02,842131,28383,3.49,794980,854435,1399-7-1
430,تسه9902,امتياز تسهيلات مسكن ارديبهشت99,54,767,649639567,807561,829794,847939,40378,5.0,846988,39427,4.88,829794,847939,1399-7-1
431,قنقش,قند نقش جهان,53,69402,5354294898,75637,77149,77149,1512,2.0,76445,808,1.07,77149,77149,1399-7-1
432,كوثر,بيمه كوثر,52,111330,1586229840,14997,14248,14248,-749,-4.99,14971,-26,-0.17,14248,14248,1399-7-1
433,دبالك,مواد اوليه دارويي البرز بالك,52,435776,7551126528,18239,17328,17328,-911,-4.99,18086,-153,-0.84,17328,17328,1399-7-1
434,غپآذر,شير پگاه آذربايجان شرقي,51,21214,1198039436,59446,56474,56474,-2972,-5.0,59371,-75,-0.13,56474,56474,1399-7-1
435,ثروتم,صندوق س. ثروت آفرين پارسيان-س,50,13840,1367927530,99862,101940,98355,-1507,-1.51,98839,-1023,-1.02,98000,101940,1399-7-1
436,هخود911,اختيارف ت خودرو-3680-99/11/20,49,1050000,399000000,210,380,380,170,80.95,380,170,80.95,380,380,1399-7-1
437,تسه9810,امتياز تسهيلات مسكن دي98,49,1827,1522117636,806602,785555,840000,33398,4.14,833124,26522,3.29,785555,840000,1399-7-1
438,ديران,ايران‌دارو,48,126367,2830620800,23570,22400,22400,-1170,-4.96,23500,-70,-0.3,22400,22400,1399-7-1
439,تسه9812,امتياز تسهيلات مسكن اسفند98,48,1445,1205430491,804369,781100,844000,39631,4.93,834208,29839,3.71,781100,844000,1399-7-1
440,ثنوسا,نوسازي‌وساختمان‌تهران‌,48,905192,10916615520,12690,12060,12060,-630,-4.96,12540,-150,-1.18,12060,12060,1399-7-1
441,سدشت,صنايع سيمان دشتستان,48,86389,3374354340,37200,39060,39060,1860,5.0,37320,120,0.32,39060,39060,1399-7-1
442,غديس,پاكديس,48,25961,885140295,35889,34095,34095,-1794,-5.0,35855,-34,-0.09,34095,34095,1399-7-1
443,وشهر,بانك شهر,47,88830,839443500,9642,9450,9450,-192,-1.99,9639,-3,-0.03,9450,9450,1399-7-1
444,داريك,صندوق س.اعتماد داريك-د,47,698340,7060030892,10103,10120,10110,7,0.07,10110,7,0.07,9502,10120,1399-7-1
445,نطرين,عطرين نخ قم,46,96326,1674531184,18298,17384,17384,-914,-5.0,18264,-34,-0.19,17384,17384,1399-7-1
446,ثعتما,س. ساختماني اعتماد گستر,46,74712,2586380016,33610,34618,34618,1008,3.0,33726,116,0.35,34618,34618,1399-7-1
447,اپرداز,آتيه داده پرداز,46,431833,10986263353,26780,25441,25441,-1339,-5.0,26448,-332,-1.24,25441,25441,1399-7-1
448,نوين,بيمه نوين,46,384735,2394205905,6550,6223,6223,-327,-4.99,6533,-17,-0.26,6223,6223,1399-7-1
449,تسه9809,امتياز تسهيلات مسكن آذر98,46,2216,1847423364,805554,768678,830000,24446,3.03,833675,28121,3.49,768555,845831,1399-7-1
450,سمازن,سيمان‌مازندران‌,46,112769,1087093160,10140,9640,9640,-500,-4.93,10130,-10,-0.1,9640,9640,1399-7-1
451,خمهر,مهركام‌پارس‌,46,120321,991445040,8670,8240,8240,-430,-4.96,8660,-10,-0.12,8240,8240,1399-7-1
452,سصوفي,سيمان‌ صوفيان‌,44,147269,2820201350,20150,19150,19150,-1000,-4.96,20090,-60,-0.3,19150,19150,1399-7-1
453,زعف9908پ05,زعفران9908نگين زرين(پ),44,13546,1172531296,88284,87000,86100,-2184,-2.47,86559,-1725,-1.95,84360,87300,1399-7-1
454,زدشت,كشت و صنعت دشت خرم دره,44,622415,30170944710,51025,48474,48474,-2551,-5.0,49357,-1668,-3.27,48474,48474,1399-7-1
455,قشرين,قند شيرين خراسان,43,149640,3027217200,20855,20230,20230,-625,-3.0,20753,-102,-0.49,20230,20230,1399-7-1
456,فولاي,صنايع فولاد آلياژي يزد,43,19894,1011410960,53515,50840,50840,-2675,-5.0,53458,-57,-0.11,50840,50840,1399-7-1
457,سخند,صندوق س.سپهرخبرگان نفت-د,43,168310,1690978260,10023,10046,10050,27,0.27,10047,24,0.24,10046,10065,1399-7-1
458,اخزا818,اسنادخزانه-م18بودجه98-010614,42,76353,54289889830,709234,708500,712506,3272,0.46,711038,1804,0.25,708500,712506,1399-7-1
459,ولبهمن,شركت بهمن ليزينگ,42,2227141,22970732274,10856,10314,10314,-542,-4.99,10593,-263,-2.42,10314,10314,1399-7-1
460,سكه0112پ03,سكه تمام بهارتحويلي1روزه سامان,41,7300,9512383000,1299435,1300000,1316400,16965,1.31,1303066,3631,0.28,1290221,1317913,1399-7-1
461,ثمسكن,سرمايه‌گذاري‌ مسكن‌,41,319099,2284748840,7530,7160,7160,-370,-4.91,7510,-20,-0.27,7160,7160,1399-7-1
462,وتوصا,گروه س توسعه صنعتي ايران,40,52807,771510270,15370,14610,14610,-760,-4.94,15360,-10,-0.07,14610,14610,1399-7-1
463,تسه9710,امتياز تسهيلات مسكن دي 97,40,884,716236406,797487,782020,830000,32513,4.08,810222,12735,1.6,782020,830000,1399-7-1
464,ضسپا8018,اختيارخ خساپا-2400-1399/08/26,40,1059,517450000,584,500,480,-104,-17.81,489,-95,-16.27,450,700,1399-7-1
465,تسه9707,امتياز تسهيلات مسكن مهر97,40,761,596988334,784895,780111,780000,-4895,-0.62,784479,-416,-0.05,780000,791000,1399-7-1
466,قپيرا,فرآورده‌هاي‌غدايي‌وقندپيرانشهر,39,12675,967141150,80310,76330,76300,-4010,-4.99,80230,-80,-0.1,76300,76500,1399-7-1
467,آساميد,صندوق س.مشترك آسمان اميد -د,39,677076,7259108884,10700,10743,10715,15,0.14,10721,21,0.2,10702,10743,1399-7-1
468,غفارس,شير پاستوريزه پگاه فارس,39,70356,679076112,10160,9652,9652,-508,-5.0,10152,-8,-0.08,9652,9652,1399-7-1
469,تسه9802,امتياز تسهيلات مسكن ارديبهشت98,38,1054,846175999,798679,765700,838612,39933,5.0,802823,4144,0.52,765700,838612,1399-7-1
470,هجرت,پخش هجرت,38,23489,1400836982,62776,59638,59638,-3138,-5.0,62680,-96,-0.15,59638,59638,1399-7-1
471,گنجين,صندوق س. گنجينه يكم آويد-د,38,448584,5073113538,11300,11305,11305,5,0.04,11309,9,0.08,11300,11337,1399-7-1
472,هصند911,اختيارف ت صندوق-19926-99/11/29,38,69752,104697752,820,1501,1501,681,83.05,1501,681,83.05,1501,1501,1399-7-1
473,هرانف912,اختيارف ت رانفور32120-99/12/03,37,100000,87000000,1,870,870,869,86900.0,870,869,86900.0,870,870,1399-7-1
474,حآسا,آسيا سير ارس,37,325896,3916944024,12651,12019,12019,-632,-5.0,12599,-52,-0.41,12019,12019,1399-7-1
475,ضجار7023,اختيارخ وتجارت-3000-1399/07/22,35,1215,492590000,522,450,400,-122,-23.37,405,-117,-22.41,330,460,1399-7-1
476,قلرست,قند لرستان‌,34,905410,23513497700,27330,25970,25970,-1360,-4.98,26660,-670,-2.45,25970,25970,1399-7-1
477,سخزر,سيمان‌ خزر,34,324335,9674913050,31400,29830,29830,-1570,-5.0,31080,-320,-1.02,29830,29830,1399-7-1
478,وايران,ليزينگ ايرانيان,34,93677,1016395450,11420,10850,10850,-570,-4.99,11410,-10,-0.09,10850,10850,1399-7-1
479,خريخت,صنايع‌ريخته‌گري‌ايران‌,34,123732,747341280,6350,6040,6040,-310,-4.88,6350,0,0.0,6040,6040,1399-7-1
480,اخزا807,اسنادخزانه-م7بودجه98-000719,33,82931,69580182620,834974,840000,836406,1432,0.17,839013,4039,0.48,835500,840000,1399-7-1
481,ساراب,سيمان‌ داراب‌,33,105565,1303727750,13000,12350,12350,-650,-5.0,12980,-20,-0.15,12350,12350,1399-7-1
482,سفار,سيمان‌فارس‌,33,51543,5351194260,109280,103820,103820,-5460,-5.0,108660,-620,-0.57,103820,103820,1399-7-1
483,زشريف,كشت وصنعت شريف آباد,33,416234,11191699792,28303,26888,26888,-1415,-5.0,27969,-334,-1.18,26888,26888,1399-7-1
484,اخزا817,اسنادخزانه-م17بودجه98-010512,33,46749,33756150983,721512,721005,721621,109,0.02,722072,560,0.08,721000,723418,1399-7-1
485,خشرق,الكتريك‌ خودرو شرق‌,32,134293,2526051330,19790,18810,18810,-980,-4.95,19740,-50,-0.25,18810,18810,1399-7-1
486,لابسا,آبسال‌,32,43266,1345139940,32720,31090,31090,-1630,-4.98,32670,-50,-0.15,31090,31090,1399-7-1
487,صگل1411,ص اجاره گل گهر 1411-3 ماهه 17%,32,695,708701000,980186,1020000,980200,14,0.0,1019714,39528,4.03,980200,1020000,1399-7-1
488,قاسم,قاسم ايران,32,32140,491420600,16094,15290,15290,-804,-5.0,16086,-8,-0.05,15290,15290,1399-7-1
489,ارمغان,ص سرمايه گذاري ارمغان ايرانيان,32,101895,1028765300,10090,10080,10100,10,0.1,10100,10,0.1,10080,10110,1399-7-1
490,سجام,مجتمع سيمان غرب آسيا,32,34023,443115552,13426,13024,13024,-402,-2.99,13417,-9,-0.07,13024,13024,1399-7-1
491,وبهمن,سرمايه‌گذاري‌بهمن‌,32,191724,3460618200,18990,18050,18050,-940,-4.95,18920,-70,-0.37,18050,18050,1399-7-1
492,ساربيل,سيمان آرتا اردبيل,31,21387,2339951670,115160,109410,109410,-5750,-4.99,114880,-280,-0.24,109410,109410,1399-7-1
493,فنورد,نوردوقطعات‌ فولادي‌,31,342810,42189626700,117210,123070,123070,5860,5.0,121900,4690,4.0,123070,123070,1399-7-1
494,سايرا,ايرانيت‌,31,15698,571815754,35819,36535,36535,716,2.0,35852,33,0.09,35819,36535,1399-7-1
495,سكرد,سيمان كردستان,31,39410,419322400,11190,10640,10640,-550,-4.92,11190,0,0.0,10640,10640,1399-7-1
496,غگلستا,شير پاستوريزه پگاه گلستان,30,36445,556187145,16064,15261,15261,-803,-5.0,16055,-9,-0.06,15261,15261,1399-7-1
497,خرينگ,رينگ‌سازي‌مشهد,30,33558,908079480,28480,27060,27060,-1420,-4.99,28450,-30,-0.11,27060,27060,1399-7-1
498,خوساز,محورسازان‌ايران‌خودرو,30,145623,1402349490,10130,9630,9630,-500,-4.94,10120,-10,-0.1,9630,9630,1399-7-1
499,وليز,ليزينگ‌ايران‌,30,39521,384934540,10250,9740,9740,-510,-4.98,10250,0,0.0,9740,9740,1399-7-1
500,وآذر,سرمايه‌گذاري‌توسعه‌آذربايجان‌,30,4019,473398010,123980,117790,117790,-6190,-4.99,123920,-60,-0.05,117790,117790,1399-7-1
501,آبين,كشت و صنعت آبشيرين,29,58710,254390430,4467,4333,4333,-134,-3.0,4465,-2,-0.04,4333,4333,1399-7-1
502,زنجان,صنايع كشاورزي وكود زنجان,29,182787,1263423744,7125,6912,6912,-213,-2.99,7111,-14,-0.2,6912,6912,1399-7-1
503,فلوله,لوله‌وماشين‌سازي‌ايران‌,29,32673,842636670,27140,25790,25790,-1350,-4.97,27120,-20,-0.07,25790,25790,1399-7-1
504,هترول911,اختيارف ت پترول-14730-99/11/15,29,480000,480000,1,1,1,0,0.0,1,0,0.0,1,1,1399-7-1
505,تكنار,مجتمع معادن مس تكنار,28,38125,2908060625,74056,76277,76277,2221,3.0,74359,303,0.41,76277,76277,1399-7-1
506,خكاوه,سايپا ديزل,28,154826,1018600254,6782,6579,6579,-203,-2.99,6771,-11,-0.16,6579,6579,1399-7-1
507,تكمبا,كمباين‌ سازي‌ ايران‌,28,60289,623991150,10890,10350,10350,-540,-4.96,10880,-10,-0.09,10350,10350,1399-7-1
508,ولشرق,ليزينگ ايران و شرق,28,287147,2456542585,9005,8555,8555,-450,-5.0,8982,-23,-0.26,8555,8555,1399-7-1
509,قشكر,شكرشاهرود,28,33412,1502537640,47330,44970,44970,-2360,-4.99,47250,-80,-0.17,44970,44970,1399-7-1
510,گپارس,امور رفاهي كارگزاران پارس,27,27982,3184827294,110502,113817,113817,3315,3.0,110987,485,0.44,113817,113817,1399-7-1
511,اخزا806,اسنادخزانه-م6بودجه98-000519,27,29013,24973915914,859885,857785,860196,311,0.04,860784,899,0.1,857785,863900,1399-7-1
512,اوصتا,صندوق انديشه ورزان صباتامين -د,27,442481,7423417867,16760,16670,16840,80,0.48,16777,17,0.1,16670,16850,1399-7-1
513,هفارس912,اختيارف ت فارس-14576-99/12/13,26,698322,698322,1,1,1,0,0.0,1,0,0.0,1,1,1399-7-1
514,وبرق,س.کارکنان صنعت برق زنجان وقزوي,26,4323,900290688,214696,208256,208256,-6440,-3.0,214390,-306,-0.14,208256,208256,1399-7-1
515,اخزا816,اسنادخزانه-م16بودجه98-010503,26,17396,12617064534,724648,723350,726001,1353,0.19,725285,637,0.09,723350,726003,1399-7-1
516,ركيش,كارت اعتباري ايران كيش,26,45369,758569680,17590,16720,16720,-870,-4.95,17580,-10,-0.06,16720,16720,1399-7-1
517,اعتلا,شركت سرمايه گذاري اعتلاء البرز,25,485643,5746127976,12454,11832,11832,-622,-4.99,12377,-77,-0.62,11832,11832,1399-7-1
518,وزمين,بانك ايران زمين,25,43401,772016988,18151,17788,17788,-363,-2.0,18141,-10,-0.06,17788,17788,1399-7-1
519,اخزا821,اسنادخزانه-م21بودجه98-020906,25,8483,4946027214,583098,583000,583010,-88,-0.02,583052,-46,-0.01,583000,584500,1399-7-1
520,خكار,ايركا پارت صنعت,25,59044,2159239080,38490,36570,36570,-1920,-4.99,38400,-90,-0.23,36570,36570,1399-7-1
521,تسه9712,امتياز تسهيلات مسكن اسفند97,24,413,341515109,798777,820000,830000,31223,3.91,826913,28136,3.52,768454,838015,1399-7-1
522,زكشت,كشاورزي مكانيزه اصفهان كشت,24,403247,12930518302,33753,32066,32066,-1687,-5.0,33290,-463,-1.37,32066,32066,1399-7-1
523,تسه9801,امتياز تسهيلات مسكن فروردين98,24,336,278930237,800146,830000,825555,25409,3.18,830149,30003,3.75,790761,840153,1399-7-1
524,لكما,كارخانجات‌مخابراتي‌ايران‌,24,66187,770549054,12002,11642,11642,-360,-3.0,11988,-14,-0.12,11642,11642,1399-7-1
525,ضخود7053,اختيارخ خودرو-3200-1399/07/09,23,261,45789000,189,104,186,-3,-1.59,175,-14,-7.41,101,290,1399-7-1
526,زعف9908پ09,زعفران9908نگين نوين(پ),23,4391,368923525,87957,86197,83359,-4598,-5.23,84018,-3939,-4.48,83359,87500,1399-7-1
527,تسه9808,امتياز تسهيلات مسكن آبان98,23,564,472148336,806271,767999,840000,33729,4.18,837142,30871,3.83,767999,846584,1399-7-1
528,كگاز,شيشه‌ و گاز,23,13829,345448420,26290,24980,24980,-1310,-4.98,26280,-10,-0.04,24980,24980,1399-7-1
529,كپشير,پشم‌شيشه‌ايران‌,23,12386,654228520,55590,52820,52820,-2770,-4.98,55550,-40,-0.07,52820,52820,1399-7-1
530,قشير,قند شيروان قوچان و بجنورد,23,24070,623798120,27279,25916,25916,-1363,-5.0,27261,-18,-0.07,25916,25916,1399-7-1
531,شكف,كف,22,250005,11037720750,43285,44150,44150,865,2.0,44150,865,2.0,44150,44150,1399-7-1
532,لسرما,سرما آفرين‌,22,73536,1842076800,26360,25050,25050,-1310,-4.97,26310,-50,-0.19,25050,25050,1399-7-1
533,سغرب,سيمان‌غرب‌,22,526470,10808429100,21610,20530,20530,-1080,-5.0,21360,-250,-1.16,20530,20530,1399-7-1
534,ثاباد,توريستي ورفاهي آبادگران ايران,22,713549,22662316240,33430,31760,31760,-1670,-5.0,32620,-810,-2.42,31760,31760,1399-7-1
535,قزوين,كارخانجات‌ قند قزوين‌,22,11980,430201800,37800,35910,35910,-1890,-5.0,37780,-20,-0.05,35910,35910,1399-7-1
536,تسه9803,امتياز تسهيلات مسكن خرداد98,22,298,244693279,799585,790000,790000,-9585,-1.2,821118,21533,2.69,786719,839500,1399-7-1
537,ضخود7055,اختيارخ خودرو-3600-1399/07/09,22,450,32684000,74,63,82,8,10.81,73,-1,-1.35,26,98,1399-7-1
538,شرنگي,شيميايي رنگين,22,9022,1083966234,123862,120147,120147,-3715,-3.0,123654,-208,-0.17,120147,120147,1399-7-1
539,بمپنا,توليد برق عسلويه  مپنا,21,3422,325148174,100017,95017,95017,-5000,-5.0,99981,-36,-0.04,95017,95017,1399-7-1
540,همعاد911,اختيارف ت معادن-19080-99/11/19,21,150000,37350000,1,249,249,248,24800.0,249,248,24800.0,249,249,1399-7-1
541,غپاك,لبنيات‌ پاك‌,21,22686,384527700,17840,16950,16950,-890,-4.99,17830,-10,-0.06,16950,16950,1399-7-1
542,پسهند,صنايع‌ لاستيكي‌  سهند,21,26493,1266100470,50300,47790,47790,-2510,-4.99,50230,-70,-0.14,47790,47790,1399-7-1
543,كپرور,فرآوري زغال سنگ پروده طبس,21,11169,464194809,43748,41561,41561,-2187,-5.0,43727,-21,-0.05,41561,41561,1399-7-1
544,كرونا2,تامين مالي جمعي صرفا اهداي سود,21,2500,25000000,10000,10000,10000,0,0.0,10000,0,0.0,10000,10000,1399-7-1
545,كمينا,شيشه سازي مينا,20,303897,10023434751,34003,32983,32983,-1020,-3.0,33465,-538,-1.58,32983,32983,1399-7-1
546,آكورد2,صندوق س. آرمان آتي كوثر-د,20,2000000,2000000,28548,1,1,-28547,-100.0,1,-28547,-100.0,1,1,1399-7-1
547,ضچاد7025,اختيارخ كچاد-26000-1399/07/07,20,78,8615000,53,40,132,79,149.06,110,57,107.55,37,144,1399-7-1
548,اخزا810,اسنادخزانه-م10بودجه98-001006,20,24682,19888327226,807826,803290,806005,-1821,-0.23,805783,-2043,-0.25,803290,807899,1399-7-1
549,بنيرو,نيروترانس‌,20,6340,435177600,72250,68640,68640,-3610,-5.0,72220,-30,-0.04,68640,68640,1399-7-1
550,حتوكا,حمل‌ونقل‌توكا,20,24731,374427340,15930,15140,15140,-790,-4.96,15920,-10,-0.06,15140,15140,1399-7-1
551,همپنا912,اختيارف ت مپنا-23410-99/12/11,20,47375,195800875,2950,4133,4133,1183,40.1,4133,1183,40.1,4133,4133,1399-7-1
552,غاذر,كشت‌وصنعت‌پياذر,20,5267,469342370,93800,89110,89110,-4690,-5.0,93750,-50,-0.05,89110,89110,1399-7-1
553,بساما,بيمه سامان,20,21199,507122478,25181,23922,23922,-1259,-5.0,25167,-14,-0.06,23922,23922,1399-7-1
554,خاذين,سايپاآذين‌,20,45612,360334800,8310,7900,7900,-410,-4.93,8310,0,0.0,7900,7900,1399-7-1
555,خزر,فنرسازي‌زر,19,62407,547309390,9230,8770,8770,-460,-4.98,9220,-10,-0.11,8770,8770,1399-7-1
556,اخزا703,اسنادخزانه-م3بودجه97-990721,19,33617,33281471472,989433,989928,990000,567,0.06,990019,586,0.06,989620,992000,1399-7-1
557,شفارا,پتروشيمي فارابي,19,123718,665602840,5546,5380,5380,-166,-2.99,5540,-6,-0.11,5380,5380,1399-7-1
558,تسه9806,امتياز تسهيلات مسكن شهريور98,19,260,216746518,807648,783701,848030,40382,5.0,833640,25992,3.22,783701,848030,1399-7-1
559,نگين,ص.س. زمين و ساختمان نگين شهرري,19,299952,15297552000,51000,52000,51000,0,0.0,51000,0,0.0,51000,51000,1399-7-1
560,سصفها,سيمان‌اصفهان‌,19,5352,585241200,115100,109350,109350,-5750,-5.0,115030,-70,-0.06,109350,109350,1399-7-1
561,ولانا,شركت ليزينگ آريا دانا,19,15484,362960444,24165,23441,23441,-724,-3.0,24151,-14,-0.06,23441,23441,1399-7-1
562,زعف9908پ08,زعفران9908نگين روستا(پ),18,4730,398973061,86479,84039,84000,-2479,-2.87,84349,-2130,-2.46,83559,86700,1399-7-1
563,سرود,سيمان‌شاهرود,18,47507,716405560,15870,15080,15080,-790,-4.98,15860,-10,-0.06,15080,15080,1399-7-1
564,چكاوه,صنايع‌كاغذسازي‌كاوه‌,18,11407,430272040,39700,37720,37720,-1980,-4.99,39680,-20,-0.05,37720,37720,1399-7-1
565,زير0003پ01,زيره سبز0003كيميابذر(پ),18,260,130549950,486425,509999,505000,18575,3.82,502115,15690,3.23,500000,509999,1399-7-1
566,دكوثر,داروسازي‌ كوثر,17,29897,774033330,27250,25890,25890,-1360,-4.99,27230,-20,-0.07,25890,25890,1399-7-1
567,شدوص,دوده‌ صنعتي‌ پارس‌,17,13947,278103180,20980,19940,19940,-1040,-4.96,20970,-10,-0.05,19940,19940,1399-7-1
568,اخزا820,اسنادخزانه-م20بودجه98-020806,17,26386,15544477353,590620,587002,589001,-1619,-0.27,589118,-1502,-0.25,587002,590900,1399-7-1
569,دكپسول,توليد ژلاتين كپسول ايران,17,5715,220970475,40700,38665,38665,-2035,-5.0,40690,-10,-0.02,38665,38665,1399-7-1
570,زعف9908پ16,زعفران9908نگين بيرجند(پ),17,7816,655530455,89333,84000,83360,-5973,-6.69,83870,-5463,-6.12,83359,88000,1399-7-1
571,ضخوز7028,اختيارخ فخوز-43470-1399/07/20,16,98,588410000,10925,6000,6890,-4035,-36.93,6004,-4921,-45.04,5050,6890,1399-7-1
572,وارس,سرمايه گذاري ارس صبا,16,13471,1485595351,113691,110281,110281,-3410,-3.0,113415,-276,-0.24,110281,110281,1399-7-1
573,كتوكا,توليدي و خدمات صنايع نسوز توكا,16,8561,1230378359,151283,143719,143719,-7564,-5.0,151086,-197,-0.13,143719,143719,1399-7-1
574,ضخود7040,اختيارخ خودرو-1600-1399/07/09,16,133,158154000,1470,1150,1420,-50,-3.4,1189,-281,-19.12,1150,1420,1399-7-1
575,دكيمي,كيميدارو,16,16271,430856080,27870,26480,26480,-1390,-4.99,27860,-10,-0.04,26480,26480,1399-7-1
576,هشفن911,اختيارف ت شفن-318060-99/11/26,16,20000,9180000,1,459,459,458,45800.0,459,458,45800.0,459,459,1399-7-1
577,خاور,ايران خودرو ديزل,15,60019,427395299,7341,7121,7121,-220,-3.0,7336,-5,-0.07,7121,7121,1399-7-1
578,شفارس,صنايع‌ شيميايي‌ فارس‌,15,15862,529632180,35140,33390,33390,-1750,-4.98,35120,-20,-0.06,33390,33390,1399-7-1
579,ولتجار,واسپاري تجارت وسرمايه ايرانيان,15,50668,342667684,6972,6763,6763,-209,-3.0,6968,-4,-0.06,6763,6763,1399-7-1
580,چافست,افست‌,15,6455,166797200,27200,25840,25840,-1360,-5.0,27200,0,0.0,25840,25840,1399-7-1
581,كسعدي,كاشي‌ سعدي‌,14,10654,685052200,67680,64300,64300,-3380,-4.99,67630,-50,-0.07,64300,64300,1399-7-1
582,لبوتان,گروه‌صنعتي‌بوتان‌,14,6632,525188080,83350,79190,79190,-4160,-4.99,83300,-50,-0.06,79190,79190,1399-7-1
583,تسه9805,امتياز تسهيلات مسكن مرداد98,14,316,258913368,809576,850054,849000,39424,4.87,819346,9770,1.21,769098,850054,1399-7-1
584,كقزوي,شيشه‌ قزوين‌,14,26196,272569380,10726,10405,10405,-321,-2.99,10721,-5,-0.05,10405,10405,1399-7-1
585,پاسا,ايران‌ياساتايرورابر,14,14152,333845680,24830,23590,23590,-1240,-4.99,24820,-10,-0.04,23590,23590,1399-7-1
586,غبهار,كشت وصنعت بهاران گلبهار خراسان,14,36582,1424539662,40145,38941,38941,-1204,-3.0,40057,-88,-0.22,38941,38941,1399-7-1
587,ضخود7059,اختيارخ خودرو-4400-1399/07/09,13,1202,12404000,12,20,52,40,333.33,10,-2,-16.67,7,52,1399-7-1
588,سخواف,سيمان مجد خواف,13,14991,247471428,17018,16508,16508,-510,-3.0,17011,-7,-0.04,16508,16508,1399-7-1
589,وسقم,شركت س استان قم,13,26860,37872600,1350,1410,1410,60,4.44,1350,0,0.0,1410,1410,1399-7-1
590,زعف9908پ14,زعفران9908پوشالمعمول نوين(پ),13,1087,72425523,67876,65050,68498,622,0.92,66629,-1247,-1.84,65050,69400,1399-7-1
591,بسويچ,پارس‌سويچ‌,13,2757,125415930,47880,45490,45490,-2390,-4.99,47870,-10,-0.02,45490,45490,1399-7-1
592,تسه9811,امتياز تسهيلات مسكن بهمن98,13,399,331709327,811434,775111,850000,38566,4.75,831352,19918,2.45,775111,850000,1399-7-1
593,اخزا812,اسنادخزانه-م12بودجه98-001111,13,50642,40141965110,792718,790008,793201,483,0.06,792661,-57,-0.01,790008,794000,1399-7-1
594,ضجار7027,اختيارخ وتجارت-3800-1399/07/22,13,424,56995000,399,100,135,-264,-66.17,134,-265,-66.42,100,200,1399-7-1
595,تسه9807,امتياز تسهيلات مسكن مهر98,13,377,312226850,802417,767130,842000,39583,4.93,828188,25771,3.21,767130,842000,1399-7-1
596,صگل411,ص اجاره گل گهر 411- 3 ماهه 17%,13,1141,1161270949,1039945,1019608,1030000,-9945,-0.96,1017766,-22179,-2.13,990000,1091940,1399-7-1
597,داناح,ح . بيمه دانا,13,53155,309725200,5840,5840,5700,-140,-2.4,5830,-10,-0.17,5700,5840,1399-7-1
598,آينده,بازرگاني آينده سازان بهشت پارس,12,9784,221108616,23297,22599,22599,-698,-3.0,23289,-8,-0.03,22599,22599,1399-7-1
599,اخزا721,اسنادخزانه-م21بودجه97-000728,12,18189,15140811506,832320,832000,832464,144,0.02,832416,96,0.01,830506,833004,1399-7-1
600,اخزا903,اسنادخزانه-م3بودجه99-011110,12,47241,31240728842,661147,661100,661500,353,0.05,661305,158,0.02,661000,663000,1399-7-1
601,اخزا704,اسنادخزانه-م4بودجه97-991022,11,2283,2164905623,950196,945028,954492,4296,0.45,948272,-1924,-0.2,945028,954492,1399-7-1
602,چفيبر,فيبر ايران‌,11,15210,166701600,11530,10960,10960,-570,-4.94,11530,0,0.0,10960,10960,1399-7-1
603,تسه9804,امتياز تسهيلات مسكن تير98,11,198,162312621,797636,790000,837517,39881,5.0,819761,22125,2.77,790000,837517,1399-7-1
604,وثوق,سرمايه گذاري وثوق امين,11,18212,286019460,16190,15705,15705,-485,-3.0,16183,-7,-0.04,15705,15705,1399-7-1
605,ضفلا8085,اختيارخ فولاد-16775-1399/08/28,11,55,231385000,4158,4000,4500,342,8.23,4207,49,1.18,3999,4500,1399-7-1
606,واعتبار,سرمايه گذاري اعتبار ايران,11,20010,156678300,8240,7830,7830,-410,-4.98,8240,0,0.0,7830,7830,1399-7-1
607,پلاسك,پلاسكوكار,11,13317,121451040,9590,9120,9120,-470,-4.9,9590,0,0.0,9120,9120,1399-7-1
608,فمراد,آلومراد,11,1265,187169400,155740,147960,147960,-7780,-5.0,155710,-30,-0.02,147960,147960,1399-7-1
609,ولراز,ليزينگ رازي,11,10244,244145252,25087,23833,23833,-1254,-5.0,25071,-16,-0.06,23833,23833,1399-7-1
610,غدشت,دشت‌ مرغاب‌,11,2070,608435100,309400,293930,293930,-15470,-5.0,309200,-200,-0.06,293930,293930,1399-7-1
611,حپارسا,توسعه حمل و نقل ريلي پارسيان,11,6112,205564896,35403,33633,33633,-1770,-5.0,35395,-8,-0.02,33633,33633,1399-7-1
612,خعمرا,توسعه و عمران شهرستان نائين,11,314401,4631126730,14301,14730,14730,429,3.0,14396,95,0.66,14730,14730,1399-7-1
613,كطبس,ذغال‌سنگ‌ نگين‌ ط‌بس‌,11,3941,201503330,53820,51130,51130,-2690,-5.0,53810,-10,-0.02,51130,51130,1399-7-1
614,ضچاد7020,اختيارخ كچاد-17300-1399/07/07,11,47,187503000,4114,3986,4000,-114,-2.77,3989,-125,-3.04,3986,4000,1399-7-1
615,ضفلا8086,اختيارخ فولاد-17775-1399/08/28,11,64,254510000,3108,3300,5000,1892,60.88,3977,869,27.96,3300,5000,1399-7-1
616,كلوند,كاشي‌ الوند,10,2576,66718400,27260,25900,25900,-1360,-4.99,27260,0,0.0,25900,25900,1399-7-1
617,ضبدر8070,اختيارخ شبندر-59580-1399/08/18,10,85,237700000,2700,3000,2700,0,0.0,2796,96,3.56,2000,3000,1399-7-1
618,كشرق,صنعتي و معدني شمال شرق شاهرود,10,7337,622749886,89345,84878,84878,-4467,-5.0,89286,-59,-0.07,84878,84878,1399-7-1
619,ثنظام,س. ساختماني نظام مهندسي ايران,10,11463,552103932,49653,48164,48164,-1489,-3.0,49610,-43,-0.09,48164,48164,1399-7-1
620,ثشرق,سرمايه گذاري مسكن شمال شرق,10,12370,89929900,7650,7270,7270,-380,-4.97,7650,0,0.0,7270,7270,1399-7-1
621,ضملي8077,اختيارخ فملي -29750-1399/08/06,10,45,322170000,6548,8000,7000,452,6.9,7159,611,9.33,6450,8000,1399-7-1
622,سيلام,سيمان‌ ايلام‌,10,11070,113688900,10810,10270,10270,-540,-5.0,10810,0,0.0,10270,10270,1399-7-1
623,سنير,سيمان‌ سفيد ني‌ريز,10,4033,370229400,96630,91800,91800,-4830,-5.0,96590,-40,-0.04,91800,91800,1399-7-1
624,سكرما,سيمان‌ كرمان‌,10,30630,500800500,17210,16350,16350,-860,-5.0,17200,-10,-0.06,16350,16350,1399-7-1
625,فنوال,نورد آلومينيوم‌,10,7045,255874400,38230,36320,36320,-1910,-5.0,38220,-10,-0.03,36320,36320,1399-7-1
626,صايپا012,صكوك مرابحه سايپا012-3ماهه 16%,10,239,250868979,999678,1049661,1049661,49983,5.0,1049661,49983,5.0,1049661,1049661,1399-7-1
627,آگاس2,صندوق س.هستي بخش آگاه-س,10,2800000,2800000,73559,1,1,-73558,-100.0,1,-73558,-100.0,1,1,1399-7-1
628,لخزر,پارس‌ خزر,10,1685,365931450,228590,217170,217170,-11420,-5.0,228500,-90,-0.04,217170,217170,1399-7-1
629,ثامان,سامان‌ گستراصفهان‌,9,71385,1579036200,23280,22120,22120,-1160,-4.98,23240,-40,-0.17,22120,22120,1399-7-1
630,غشاذر,پگاه‌آذربايجان‌غربي‌,9,7809,172266540,23220,22060,22060,-1160,-5.0,23220,0,0.0,22060,22060,1399-7-1
631,بالبر,كابل‌ البرز,9,6106,158511760,27320,25960,25960,-1360,-4.98,27320,0,0.0,25960,25960,1399-7-1
632,وسخراش,شركت س استان خراسان شمالي,9,382443,539244630,1350,1410,1410,60,4.44,1350,0,0.0,1410,1410,1399-7-1
633,ضفار1126,اختيارخ فارس-19826-1399/11/07,9,61,201247000,5954,5499,5498,-456,-7.66,3299,-2655,-44.59,2500,5499,1399-7-1
634,غگلپا,شير پاستوريزه پگاه گلپايگان,9,1607,118148247,77390,73521,73521,-3869,-5.0,77380,-10,-0.01,73521,73521,1399-7-1
635,ضشنا7053,اختيارخ شپنا-3758-1399/07/28,9,11,229000000,26000,20000,21000,-5000,-19.23,20818,-5182,-19.93,20000,21000,1399-7-1
636,فالوم,آلومتك‌,9,21403,731019465,35211,34155,34155,-1056,-3.0,35171,-40,-0.11,34155,34155,1399-7-1
637,رتكو,كنترل‌خوردگي‌تكين‌كو,9,8127,150186960,19450,18480,18480,-970,-4.99,19450,0,0.0,18480,18480,1399-7-1
638,سشمال,سيمان‌ شمال‌,9,10390,126446300,12810,12170,12170,-640,-5.0,12810,0,0.0,12170,12170,1399-7-1
639,زير0003پ02,زيره سبز0003 دانش(پ),9,113,56644174,497632,510746,462104,-35528,-7.14,501276,3644,0.73,462104,510746,1399-7-1
640,تسه9711,امتياز تسهيلات مسكن بهمن 97,9,79,62220631,792322,765000,809990,17668,2.23,787603,-4719,-0.6,765000,810000,1399-7-1
641,كهرام,توليدي گرانيت بهسرام,9,21529,1223751418,58599,56842,56842,-1757,-3.0,58481,-118,-0.2,56842,56842,1399-7-1
642,بايكا,كارخانجات كابلسازي ‌ايران‌,8,2185,91761260,43294,41996,41996,-1298,-3.0,43288,-6,-0.01,41996,41996,1399-7-1
643,عفولاد3,اوراق سلف موازي ورق گرم فولاد,8,120,94025240,783349,769438,784826,1477,0.19,783544,195,0.02,769438,784826,1399-7-1
644,خفنر,فنرسازي‌خاور,8,19111,381646670,21020,19970,19970,-1050,-5.0,21010,-10,-0.05,19970,19970,1399-7-1
645,اخزا804,اسنادخزانه-م4بودجه98-000421,8,9443,8225406405,871551,870196,872633,1082,0.12,871059,-492,-0.06,870196,872633,1399-7-1
646,اخزا902,اسنادخزانه-م2بودجه99-011019,8,32501,21884373604,667114,668200,674000,6886,1.03,673345,6231,0.93,668200,674000,1399-7-1
647,وثنو,سرمايه گذاري ساختماني نوين,8,19060,345214720,18672,18112,18112,-560,-3.0,18662,-10,-0.05,18112,18112,1399-7-1
648,زير0003پ04,زيره سبز0003شركت مينوبذر(پ),8,164,77937392,455126,462104,483104,27978,6.15,475228,20102,4.42,462104,489000,1399-7-1
649,خنصير,مهندسي‌نصيرماشين‌,8,1459,73737860,53200,50540,50540,-2660,-5.0,53200,0,0.0,50540,50540,1399-7-1
650,خلنت,لنت‌ ترمزايران‌,8,1454,134320520,97240,92380,92380,-4860,-5.0,97230,-10,-0.01,92380,92380,1399-7-1
651,فبيرا,بسته‌ بندي‌ ايران‌,8,39969,202243140,5216,5060,5060,-156,-2.99,5214,-2,-0.04,5060,5060,1399-7-1
652,لخانه,لوازم‌ خانگي‌ پارس‌,8,4649,266150601,59019,57249,57249,-1770,-3.0,58995,-24,-0.04,57249,57249,1399-7-1
653,پارتا,مجتمع‌صنعتي‌آرتاويل‌تاير,8,7320,448972200,63231,61335,61335,-1896,-3.0,63202,-29,-0.05,61335,61335,1399-7-1
654,فافزا,فولاد افزا سپاهان,7,1376,64040416,48990,46541,46541,-2449,-5.0,48982,-8,-0.02,46541,46541,1399-7-1
655,اخزا713,اسنادخزانه-م13بودجه97-000518,7,14706,12667401136,861421,858506,861421,0,0.0,861376,-45,-0.01,858506,861421,1399-7-1
656,ضفار8030,اختيارخ فارس-7826-1399/08/06,7,25,370000000,14464,16000,14000,-464,-3.21,14800,336,2.32,14000,16000,1399-7-1
657,زعف9908پ15,زعفران9908پوشالمعمول طلاسرخ(پ),7,1269,86429500,69710,68500,69800,90,0.13,68108,-1602,-2.3,64800,69800,1399-7-1
658,اراد49,مرابحه عام دولت4-ش.خ 0206,7,748600,700270384000,931580,935440,935440,3860,0.41,935440,3860,0.41,935440,935440,1399-7-1
659,صايپا203,صكوك مرابحه سايپا203-3ماهه 16%,7,3119,2997911006,956780,991000,960000,3220,0.34,961177,4397,0.46,955001,993000,1399-7-1
660,اخزا718,اسنادخزانه-م18بودجه97-000525,7,4469,3830444879,862506,857000,860000,-2506,-0.29,857115,-5391,-0.63,856701,860000,1399-7-1
661,فسديد,لوله‌وتجهيزات‌ سديد - ورشكسته,7,2778,346577724,123523,124758,124758,1235,1.0,123605,82,0.07,124758,124758,1399-7-1
662,نتوس,پشم‌ بافي‌ توس,7,5354,58369308,11239,10902,10902,-337,-3.0,11238,-1,-0.01,10902,10902,1399-7-1
663,وسالت,بانك قرض الحسنه رسالت,7,7750,32821250,4152,4235,4235,83,2.0,4152,0,0.0,4235,4235,1399-7-1
664,ضملي8082,اختيارخ فملي-39750-1399/08/06,7,59,153978000,3480,3000,2989,-491,-14.11,2610,-870,-25.0,1500,3000,1399-7-1
665,تكنو,تكنوتار,7,18086,265140760,15430,14660,14660,-770,-4.99,15430,0,0.0,14660,14660,1399-7-1
666,ثاژن,سخت آژند,7,164221,1674068874,10402,10194,10194,-208,-2.0,10366,-36,-0.35,10194,10194,1399-7-1
667,اخزا805,اسنادخزانه-م5بودجه98-000422,7,7146,6254010781,871188,871521,871800,612,0.07,875176,3988,0.46,871521,877000,1399-7-1
668,سنوين,سرمايه گذاري اقتصاد نوين,7,106718,1161732148,11339,10886,10886,-453,-4.0,11284,-55,-0.49,10886,10886,1399-7-1
669,شستا004,اجاره تامين اجتماعي-نوين000523,7,47,48859610,1031400,1031400,969762,-61638,-5.98,1039566,8166,0.79,968122,1134540,1399-7-1
670,ضخود7060,اختيارخ خودرو-4600-1399/07/09,7,7,700000,10,100,100,90,900.0,100,90,900.0,100,100,1399-7-1
671,كساپا,سايپاشيشه‌,6,2247,44962470,21060,20010,20010,-1050,-4.99,21060,0,0.0,20010,20010,1399-7-1
672,ضخود7063,اختيارخ خودرو-5500-1399/07/09,6,250,704000,2,4,2,0,0.0,3,1,50.0,2,4,1399-7-1
673,ضخود7068,اختيارخ خودرو-8000-1399/07/09,6,397,794000,6,2,2,-4,-66.67,2,-4,-66.67,2,2,1399-7-1
674,اخزا723,اسنادخزانه-م23بودجه97-000824,6,3302,2713650113,840041,820000,822002,-18039,-2.15,821820,-18221,-2.17,820000,822003,1399-7-1
675,تپمپي,پمپ‌ سازي‌ ايران‌,6,1209,59047560,51410,48840,48840,-2570,-5.0,51410,0,0.0,48840,48840,1399-7-1
676,كيا,كيا الكترود شرق,6,275000,1292225000,4150,4699,4699,549,13.23,4699,549,13.23,4699,4699,1399-7-1
677,ضمخا7032,اختيارخ اخابر-4750-1399/07/30,6,29,450000000,14000,16500,15000,1000,7.14,15517,1517,10.84,15000,16500,1399-7-1
678,خمحور,توليدمحورخودرو,6,2828,162666560,60540,57520,57520,-3020,-4.99,60530,-10,-0.02,57520,57520,1399-7-1
679,ختراك,ريخته‌گري‌ تراكتورسازي‌ ايران‌,6,2567,57141420,23430,22260,22260,-1170,-4.99,23430,0,0.0,22260,22260,1399-7-1
680,دفرا,فرآورده‌هاي‌ تزريقي‌ ايران‌,6,12137,330490510,28660,27230,27230,-1430,-4.99,28650,-10,-0.03,27230,27230,1399-7-1
681,ضچاد7012,اختيارخ كچاد-9300-1399/07/07,6,18,212699000,12000,11700,12000,0,0.0,11817,-183,-1.53,11700,12000,1399-7-1
682,اراد53,مرابحه عام دولت5-ش.خ 0207,6,1071100,999978960000,933171,933600,933600,429,0.05,933600,429,0.05,933600,933600,1399-7-1
683,ضغدر8045,اختيارخ وغدير-18000-1399/08/26,6,19,44550000,1300,2222,2840,1540,118.46,2345,1045,80.38,2222,2840,1399-7-1
684,پست9908-04,پسته فندقي32-30سبزدانه9908,6,45,61200006,1419999,1360001,1360000,-59999,-4.23,1360000,-59999,-4.23,1360000,1360001,1399-7-1
685,ضملي1154,اختيارخ فملي-24336-1399/11/05,6,6,18000000,3000,3000,3000,0,0.0,3000,0,0.0,3000,3000,1399-7-1
686,ضملي1151,اختيارخ فملي-16224-1399/11/05,6,101,847200000,1,8000,9000,8999,899900.0,8388,8387,838700.0,8000,9000,1399-7-1
687,كيان2,صندوق س. با درآمد ثابت كيان,6,600000,600000,25240,1,1,-25239,-100.0,1,-25239,-100.0,1,1,1399-7-1
688,ضفار8032,اختيارخ فارس-8826-1399/08/06,6,33,503000000,12510,22000,12000,-510,-4.08,15242,2732,21.84,12000,22000,1399-7-1
689,ضشنا7054,اختيارخ شپنا-4094-1399/07/28,5,5,102940000,20000,17970,23000,3000,15.0,20588,588,2.94,17970,23000,1399-7-1
690,لازما,كارخانه هاي صنعتي آزمايش,5,4797,151235019,32170,31527,31527,-643,-2.0,32160,-10,-0.03,31527,31527,1399-7-1
691,تابا,تابان نيرو سپاهان,5,2851,88868521,32811,31171,31171,-1640,-5.0,32803,-8,-0.02,31171,31171,1399-7-1
692,پلاست,كارخانجات توليدي پلاستيران,5,11990,509071420,43771,42458,42458,-1313,-3.0,43736,-35,-0.08,42458,42458,1399-7-1
693,عسناسنگ,سلف كنستانتره سنگ آهن سناباد,5,9,60498090,6683836,6692268,6692268,8432,0.13,6722010,38174,0.57,6692268,6826114,1399-7-1
694,خفولا,خدمات فني فولاد يزد,5,3611,106437836,30387,29476,29476,-911,-3.0,30382,-5,-0.02,29476,29476,1399-7-1
695,ضفلا8093,اختيارخ فولاد-29775-1399/08/28,5,31,27375000,825,825,1050,225,27.27,883,58,7.03,825,1050,1399-7-1
696,ضغدر8044,اختيارخ وغدير-17000-1399/08/26,5,32,92650000,3100,2855,3500,400,12.9,2895,-205,-6.61,2855,3500,1399-7-1
697,كابگن,توليدي و صنعتي آبگينه‌,5,14572,65049408,4420,4464,4464,44,1.0,4421,1,0.02,4464,4464,1399-7-1
698,لپيام,گسترش صنايع پيام,5,3291,103603971,32123,31481,31481,-642,-2.0,32116,-7,-0.02,31481,31481,1399-7-1
699,ضخود7054,اختيارخ خودرو-3400-1399/07/09,5,45,5495000,200,100,101,-99,-49.5,122,-78,-39.0,100,179,1399-7-1
700,صايپا908,صكوك مرابحه سايپا908-3ماهه 18%,5,168,167832504,997192,999003,999003,1811,0.18,999003,1811,0.18,999003,999003,1399-7-1
701,زعف9908پ17,زعفران9908پوشالمعمول بيرجند(پ),5,932,60799942,67081,64483,66500,-581,-0.87,65236,-1845,-2.75,64483,66500,1399-7-1
702,قشهد,شهد,5,2605,82005400,33130,31480,31480,-1650,-4.98,33130,0,0.0,31480,31480,1399-7-1
703,شمواد,توليد مواداوليه الياف مصنوعي,5,5269,334144173,65378,63417,63417,-1961,-3.0,65344,-34,-0.05,63417,63417,1399-7-1
704,ضفار8036,اختيارخ فارس-11826-1399/08/06,5,45,360000000,4500,9000,9500,5000,111.11,8000,3500,77.78,6000,9500,1399-7-1
705,پدرخش,درخشان‌ تهران‌,5,1546,338635840,230560,219040,219040,-11520,-5.0,230480,-80,-0.03,219040,219040,1399-7-1
706,نمرينو,ايران‌ مرينوس‌,5,1171,75693440,68040,64640,64640,-3400,-5.0,68030,-10,-0.01,64640,64640,1399-7-1
707,ضملت8032,اختيارخ وبملت-5789-1399/08/28,5,32,102692659,1020,800,1000,-20,-1.96,775,-245,-24.02,600,1000,1399-7-1
708,اعتماد2,صندوق س.اعتماد آفرين پارسيان-د,4,36500000,36500000,32459,1,1,-32458,-100.0,1,-32458,-100.0,1,1,1399-7-1
709,شلرد02,كود شيميايي اوره لردگان,4,29,28814104,997374,990001,998010,636,0.06,993590,-3784,-0.38,990001,998010,1399-7-1
710,صينا205,صكوك منفعت سينا دارو-3ماهه 19%,4,22,21690942,1014600,985911,986001,-28599,-2.82,985952,-28648,-2.82,985911,986001,1399-7-1
711,ضفار8029,اختيارخ فارس-7326-1399/08/06,4,17,289000000,17933,18000,17000,-933,-5.2,17000,-933,-5.2,16000,18000,1399-7-1
712,ضگل8065,اختيارخ كگل-23100-1399/08/21,4,25,112500000,5700,4500,4500,-1200,-21.05,4500,-1200,-21.05,4500,4500,1399-7-1
713,ضملت8033,اختيارخ وبملت-6272-1399/08/28,4,26,57551618,528,450,900,372,70.45,535,7,1.33,400,900,1399-7-1
714,زعف9908پ11,زعفران9908نگين سحرخيز(پ),4,194,17092340,91714,88100,88110,-3604,-3.93,88105,-3609,-3.94,88100,88110,1399-7-1
715,تبريز112,مشاركت شهرداري تبريز-3ماهه18%,4,1574,1573920000,1005000,980000,1000000,-5000,-0.5,999949,-5051,-0.5,980000,1000000,1399-7-1
716,ضخود7049,اختيارخ خودرو-3000-1399/07/09,4,36,8010000,305,200,290,-15,-4.92,222,-83,-27.21,200,290,1399-7-1
717,ضفار1120,اختيارخ فارس-8826-1399/11/07,4,16,313000000,1,20500,18000,17999,1799900.0,19562,19561,1956100.0,18000,20500,1399-7-1
718,سفارود,كارخانه فارسيت درود,4,5822,40358104,7073,6932,6932,-141,-1.99,7072,-1,-0.01,6932,6932,1399-7-1
719,ضملي1153,اختيارخ فملي-20280-1399/11/05,4,6,38500000,6590,7000,7000,410,6.22,6417,-173,-2.63,6000,7000,1399-7-1
720,ضفلا8079,اختيارخ فولاد-10775-1399/08/28,4,15,138910000,9949,9000,8000,-1949,-19.59,9261,-688,-6.92,8000,9990,1399-7-1
721,تملي612,تسهيلات مسكن بانك ملي-اسفند96,4,11,28456505,2463767,2586955,2586955,123188,5.0,2586955,123188,5.0,2586955,2586955,1399-7-1
722,ضسپا8033,اختيارخ خساپا-6000-1399/08/26,4,45,26426000,103,150,101,-2,-1.94,587,484,469.9,81,1019,1399-7-1
723,ضخود7050,اختيارخ خودرو-1200-1399/07/09,4,142,208461000,1511,1500,1500,-11,-0.73,1468,-43,-2.85,1411,1500,1399-7-1
724,ومللح,ح . اعتباري ملل,4,4908,61894788,13274,12611,12611,-663,-4.99,12611,-663,-4.99,12611,12611,1399-7-1
725,ضپاس7016,اختيارخ وپارس-4200-1399/07/30,4,20,32100000,805,1333,1790,985,122.36,1605,800,99.38,1333,1790,1399-7-1
726,افرا,افرانت,4,2464,161000224,68780,65341,65341,-3439,-5.0,68768,-12,-0.02,65341,65341,1399-7-1
727,ضخود7039,اختيارخ خودرو-1500-1399/07/09,4,4,5500000,1206,1200,1500,294,24.38,1375,169,14.01,1200,1500,1399-7-1
728,زنگان,صنعت روي زنگان,4,1409,219014960,163621,155440,155440,-8181,-5.0,163583,-38,-0.02,155440,155440,1399-7-1
729,ضپنا7039,اختيارخ رمپنا-25556-1399/07/13,4,7,1900000,289,200,300,11,3.81,271,-18,-6.23,200,300,1399-7-1
730,فنرژي,گسترش صنايع انرژي آذرآب,4,48278,528740656,11175,10952,10952,-223,-2.0,11163,-12,-0.11,10952,10952,1399-7-1
731,غشصفا,شيرپاستوريزه‌پگاه‌اصفهان‌,3,1184,31766720,28240,26830,26830,-1410,-4.99,28240,0,0.0,26830,26830,1399-7-1
732,ضجار7015,اختيارخ وتجارت-1700-1399/07/22,3,9,15210000,1600,1690,1690,90,5.63,1690,90,5.63,1690,1690,1399-7-1
733,پست9908-08,پسته فندقي32-30زرينمه ولات9908,3,18,24554750,1462686,1359625,1380000,-82686,-5.65,1364153,-98533,-6.74,1359625,1380000,1399-7-1
734,شسم,توليد سموم‌ علف‌ كش,3,1348,108284840,78755,80330,80330,1575,2.0,78772,17,0.02,80330,80330,1399-7-1
735,ضفلا8082,اختيارخ فولاد-13775-1399/08/28,3,12,84000000,6000,6500,7000,1000,16.67,7000,1000,16.67,6500,7500,1399-7-1
736,زعف9908پ06,زعفران 9908پوشالمعمول زرين(پ),3,676,45028000,67086,65500,67000,-86,-0.13,66609,-477,-0.71,65500,67000,1399-7-1
737,ضچاد7023,اختيارخ كچاد-21300-1399/07/07,3,5,7500000,1500,1500,1500,0,0.0,1500,0,0.0,1500,1500,1399-7-1
738,خموتور,موتورسازان‌تراكتورسازي‌ايران‌,3,5861,77541030,13920,13230,13230,-690,-4.96,13920,0,0.0,13230,13230,1399-7-1
739,ضغدر8041,اختيارخ وغدير-14000-1399/08/26,3,24,120000000,6000,5000,5000,-1000,-16.67,5000,-1000,-16.67,5000,5000,1399-7-1
740,ضفلا8060,اختيارخ فولاد-3507-1399/08/28,3,5,128640000,12792,16000,16000,3208,25.08,16000,3208,25.08,16000,16000,1399-7-1
741,پارسان2,گسترش نفت و گاز پارسيان,3,17500000,477050000000,28690,27260,27260,-1430,-4.98,27260,-1430,-4.98,27260,27260,1399-7-1
742,ضفار8041,اختيارخ فارس-16826-1399/08/06,3,7,21777000,2500,3111,3111,611,24.44,3111,611,24.44,3111,3111,1399-7-1
743,غمهرا,توليدي‌مهرام‌,3,2400,251904000,110480,104960,104960,-5520,-5.0,110450,-30,-0.03,104960,104960,1399-7-1
744,ضملي1152,اختيارخ فملي-18252-1399/11/05,3,14,102000000,16500,7000,7000,-9500,-57.58,7286,-9214,-55.84,7000,9000,1399-7-1
745,ضچاد7017,اختيارخ كچاد-14300-1399/07/07,3,18,124700000,5000,6900,7000,2000,40.0,6928,1928,38.56,6900,7000,1399-7-1
746,ضگل8057,اختيارخ كگل-13100-1399/08/21,3,35,482000000,9900,13000,14000,4100,41.41,13771,3871,39.1,13000,14000,1399-7-1
747,ضترا8023,اختيارخ شتران-4886-1399/08/11,3,3,47500000,20000,17500,15000,-5000,-25.0,15833,-4167,-20.84,15000,17500,1399-7-1
748,ضفار8033,اختيارخ فارس-9326-1399/08/06,3,5,60000000,12900,12000,12000,-900,-6.98,12000,-900,-6.98,12000,12000,1399-7-1
749,شستا993,اجاره ت.اجتماعي-كاردان991226,3,26,26889710,1014710,1035000,1014710,0,0.0,1034220,19510,1.92,1014710,1035000,1399-7-1
750,ضخود7058,اختيارخ خودرو-4200-1399/07/09,3,300,4000000,28,10,20,-8,-28.57,13,-15,-53.57,10,20,1399-7-1
751,ضشنا7073,اختيارخ شپنا-15837-1399/07/28,3,25,175000000,25000,7000,7000,-18000,-72.0,7000,-18000,-72.0,7000,7000,1399-7-1
752,ضغدر8047,اختيارخ وغدير-20000-1399/08/26,3,70,148000000,2600,2400,2000,-600,-23.08,2114,-486,-18.69,2000,2400,1399-7-1
753,ضچاد7018,اختيارخ كچاد-15300-1399/07/07,3,3,17900000,4000,5900,6000,2000,50.0,5967,1967,49.18,5900,6000,1399-7-1
754,ضپاس7015,اختيارخ وپارس-4000-1399/07/30,3,32,26542000,914,821,830,-84,-9.19,829,-85,-9.3,821,830,1399-7-1
755,وهنر4,گروه توسعه هنر ايران,2,334069761,336663595641,5222,1369,858,-4364,-83.57,1008,-4214,-80.7,858,1369,1399-7-1
756,خچرخش,چرخشگر,2,2835,60527250,22470,21350,21350,-1120,-4.98,22470,0,0.0,21350,21350,1399-7-1
757,ياقوت2,صندوق س ياقوت آگاه-ثابت,2,1180000,1180000,11090,1,1,-11089,-99.99,1,-11089,-99.99,1,1,1399-7-1
758,ثزاگرس,سرمايه گذاري توسعه عمران زاگرس,2,1053,24921351,24398,23667,23667,-731,-3.0,24397,-1,0.0,23667,23667,1399-7-1
759,ضغدر8042,اختيارخ وغدير-15000-1399/08/26,2,3,13600000,3946,4000,4800,854,21.64,4533,587,14.88,4000,4800,1399-7-1
760,ضفار8035,اختيارخ فارس-10826-1399/08/06,2,15,155000000,16999,11000,10000,-6999,-41.17,10333,-6666,-39.21,10000,11000,1399-7-1
761,ضغدر8033,اختيارخ وغدير-8010-1399/08/26,2,10,91200000,9943,9000,9300,-643,-6.47,9120,-823,-8.28,9000,9300,1399-7-1
762,ضترا8050,اختيارخ شتران-32752-1399/08/11,2,32,218000000,9662,1500,10000,338,3.5,6812,-2850,-29.5,1500,10000,1399-7-1
763,اراد524,مرابحه عام دولت5-ش.خ 0108,2,5666075,5369739277500,1000000,947700,947700,-52300,-5.23,947700,-52300,-5.23,947700,947700,1399-7-1
764,ضبدر8056,اختيارخ شبندر-21580-1399/08/18,2,5,90000000,21853,18000,18000,-3853,-17.63,18000,-3853,-17.63,18000,18000,1399-7-1
765,ضجار7016,اختيارخ وتجارت-1800-1399/07/22,2,2,2363000,1550,1015,1348,-202,-13.03,1181,-369,-23.81,1015,1348,1399-7-1
766,وثخوز,سرمايه گذاري و توسعه خوزستان,2,13713,505776579,38023,36883,36883,-1140,-3.0,37993,-30,-0.08,36883,36883,1399-7-1
767,ضپاس7017,اختيارخ وپارس-4400-1399/07/30,2,2,1478000,866,739,739,-127,-14.67,739,-127,-14.67,739,739,1399-7-1
768,ضملي1150,اختيارخ فملي-14196-1399/11/05,2,42,504000000,12700,12000,12000,-700,-5.51,12000,-700,-5.51,12000,12000,1399-7-1
769,ضپيك7030,اختيارخ تاپيكو-17370-99/07/20,2,6,23975000,3414,3980,3999,585,17.14,3996,582,17.05,3980,3999,1399-7-1
770,تملي712,تسهيلات مسكن ب. ملي-اسفند97,2,10,4988010,475049,498801,498801,23752,5.0,498801,23752,5.0,498801,498801,1399-7-1
771,وپسا,س. پتروشيمي ساختمان  خليج فارس,2,2895,14981625,5335,5175,5175,-160,-3.0,5335,0,0.0,5175,5175,1399-7-1
772,شستا992,اجاره تامين اجتماعي-سپهر991226,2,11,11011011,1001000,1001001,1001001,1,0.0,1001001,1,0.0,1001001,1001001,1399-7-1
773,وايرا,سرمايه گذاري صنايع ايران,2,1600,14544000,9371,9090,9090,-281,-3.0,9371,0,0.0,9090,9090,1399-7-1
774,ضفار8034,اختيارخ فارس-9826-1399/08/06,2,10,111000000,11000,12200,10000,-1000,-9.09,11100,100,0.91,10000,12200,1399-7-1
775,ضغدر8039,اختيارخ وغدير-12000-1399/08/26,2,10,75000000,7292,7500,7500,208,2.85,7500,208,2.85,7500,7500,1399-7-1
776,ضسپا8019,اختيارخ خساپا-2600-1399/08/26,2,15,6010000,484,410,400,-84,-17.36,401,-83,-17.15,400,410,1399-7-1
777,ضفلا8076,اختيارخ فولاد-8775-1399/08/28,2,17,161500000,10722,9500,9500,-1222,-11.4,9500,-1222,-11.4,9500,9500,1399-7-1
778,افاد61,منفعت دولت6-ش.خاص140109,2,600,588600000,980000,981000,981000,1000,0.1,981000,1000,0.1,981000,981000,1399-7-1
779,ضترا8022,اختيارخ شتران-4593-1399/08/11,2,2,29000000,3600,13000,16000,12400,344.44,14500,10900,302.78,13000,16000,1399-7-1
780,وپاسار2,بانك  پاسارگاد,2,9091762,93008725260,10760,10230,10230,-530,-4.93,10230,-530,-4.93,10230,10230,1399-7-1
781,ثتوسا,س.توسعه و عمران استان اردبيل,2,364,26922896,76251,73964,73964,-2287,-3.0,76248,-3,0.0,73964,73964,1399-7-1
782,ضگل8060,اختيارخ كگل-16100-1399/08/21,2,21,178300000,11154,8300,8500,-2654,-23.79,8490,-2664,-23.88,8300,8500,1399-7-1
783,زعف9908پ12,زعفران9908پوشالمعمول سحرخيز(پ),2,155,10478200,70000,65000,70600,600,0.86,67601,-2399,-3.43,65000,70600,1399-7-1
784,ضملت8035,اختيارخ وبملت-7238-1399/08/28,2,10,33119718,9599,800,798,-8801,-91.69,800,-8799,-91.67,798,800,1399-7-1
785,فن آوا,گروه فن آوا,2,974,13984692,14651,14358,14358,-293,-2.0,14651,0,0.0,14358,14358,1399-7-1
786,ضفار8031,اختيارخ فارس-8326-1399/08/06,2,10,140000000,16000,15000,13000,-3000,-18.75,14000,-2000,-12.5,13000,15000,1399-7-1
787,ضفلا8091,اختيارخ فولاد-25775-1399/08/28,2,23,25300000,1560,1100,1100,-460,-29.49,1100,-460,-29.49,1100,1100,1399-7-1
788,ضترا8030,اختيارخ شتران-8113-1399/08/11,2,2,24000000,17000,12000,12000,-5000,-29.41,12000,-5000,-29.41,12000,12000,1399-7-1
789,بشهاب,لامپ‌  پارس‌ شهاب‌,2,381,26860500,74210,70500,70500,-3710,-5.0,74210,0,0.0,70500,70500,1399-7-1
790,هپارس912,اختيارف ت وپارس-5920-99/12/10,2,100000,88600000,700,886,886,186,26.57,886,186,26.57,886,886,1399-7-1
791,كمند2,صندوق س. با درآمد ثابت كمند,2,55000000,55000000,10110,1,1,-10109,-99.99,1,-10109,-99.99,1,1,1399-7-1
792,اعتماد4,صندوق س.اعتماد آفرين پارسيان-د,1,5638920,183073176720,32459,32466,32466,7,0.02,32466,7,0.02,32466,32466,1399-7-1
793,پست9908-02,پسته فندقي32-30طلاسبززرند9908,1,4,5657600,1431184,1414400,1414400,-16784,-1.17,1414400,-16784,-1.17,1414400,1414400,1399-7-1
794,تملي701,تسهيلات مسكن ب. ملي-فروردين97,1,1,550627,524407,550627,550627,26220,5.0,550627,26220,5.0,550627,550627,1399-7-1
795,ضملي8085,اختيارخ فملي-51750-1399/08/06,1,32,32320000,1180,1010,1010,-170,-14.41,1010,-170,-14.41,1010,1010,1399-7-1
796,ضفار1121,اختيارخ فارس-9826-1399/11/07,1,1,18500000,13100,18500,18500,5400,41.22,18500,5400,41.22,18500,18500,1399-7-1
797,ورازي4,بيمه رازي,1,400000000,895600000000,15619,2239,2239,-13380,-85.66,2239,-13380,-85.66,2239,2239,1399-7-1
798,ضخود7056,اختيارخ خودرو-3800-1399/07/09,1,51,2601000,50,51,51,1,2.0,51,1,2.0,51,51,1399-7-1
799,افران2,صندوق س افرا نماد پايدار-ثابت,1,15000000,15000000,11710,1,1,-11709,-99.99,1,-11709,-99.99,1,1,1399-7-1
800,تملي705,تسهيلات مسكن ب. ملي-مرداد97,1,1,327544,311947,327544,327544,15597,5.0,327544,15597,5.0,327544,327544,1399-7-1
801,ضبدر8061,اختيارخ شبندر-31580-1399/08/18,1,2,20000000,14000,10000,10000,-4000,-28.57,10000,-4000,-28.57,10000,10000,1399-7-1
802,تملي707,تسهيلات مسكن ب. ملي-مهر97,1,1,410271,390735,410271,410271,19536,5.0,410271,19536,5.0,410271,410271,1399-7-1
803,وصندوق2,سرمايه‌گذاري‌صندوق‌بازنشستگي‌,1,5000000,84650000000,16930,16930,16930,0,0.0,16930,0,0.0,16930,16930,1399-7-1
804,ضچاد7014,اختيارخ كچاد-11300-1399/07/07,1,5,45500000,6913,9100,9100,2187,31.64,9100,2187,31.64,9100,9100,1399-7-1
805,تملي801,تسهيلات مسكن ب. ملي-فروردين98,1,1,316072,301021,316072,316072,15051,5.0,316072,15051,5.0,316072,316072,1399-7-1
806,كي بي سي2,شركت كي بي سي,1,3802148,140991252136,37082,37082,37082,0,0.0,37082,0,0.0,37082,37082,1399-7-1
807,ضملي1149,اختيارخ فملي-12168-1399/11/05,1,1,16000000,16000,16000,16000,0,0.0,16000,0,0.0,16000,16000,1399-7-1
808,ضفار8028,اختيارخ فارس-6826-1399/08/06,1,5,90000000,21000,18000,18000,-3000,-14.29,18000,-3000,-14.29,18000,18000,1399-7-1
809,ضچاد7026,اختيارخ كچاد-28000-1399/07/07,1,1,40000,51,40,40,-11,-21.57,40,-11,-21.57,40,40,1399-7-1
810,تاصيكوح2,ح . سرمايه گذاري صدرتامين,1,2000000,20200000000,10020,10100,10100,80,0.8,10100,80,0.8,10100,10100,1399-7-1
811,دارا4,صندوق س. دارا الگوريتم-د,1,20000000,200120000000,10138,10006,10006,-132,-1.3,10006,-132,-1.3,10006,10006,1399-7-1
812,ضفلا8088,اختيارخ فولاد-19775-1399/08/28,1,2,7008000,3185,3504,3504,319,10.02,3504,319,10.02,3504,3504,1399-7-1
813,ضگل8067,اختيارخ كگل-26000-1399/08/21,1,1,4000000,3567,4000,4000,433,12.14,4000,433,12.14,4000,4000,1399-7-1
814,تملي807,تسهيلات مسكن ب. ملي-مهر98,1,5,1275490,242951,255098,255098,12147,5.0,255098,12147,5.0,255098,255098,1399-7-1
815,تملي702,تسهيلات مسكن ب. ملي-ارديبهشت97,1,1,474343,451756,474343,474343,22587,5.0,474343,22587,5.0,474343,474343,1399-7-1
816,تملي703,تسهيلات مسكن ب. ملي-خرداد97,1,1,259815,247443,259815,259815,12372,5.0,259815,12372,5.0,259815,259815,1399-7-1
817,تملي709,تسهيلات مسكن ب. ملي-آذر97,1,1,334595,318662,334595,334595,15933,5.0,334595,15933,5.0,334595,334595,1399-7-1
818,ضبدر8071,اختيارخ شبندر-65580-1399/08/18,1,1,3100000,4040,3100,3100,-940,-23.27,3100,-940,-23.27,3100,3100,1399-7-1
819,صمسكن912,ص دين مسكن جنوب-ماهانه16درصد,1,100,16086600,169332,160866,160866,-8466,-5.0,160866,-8466,-5.0,160866,160866,1399-7-1
820,ضپيك7032,اختيارخ تاپيكو-19370-99/07/20,1,1,3000000,1000,3000,3000,2000,200.0,3000,2000,200.0,3000,3000,1399-7-1
821,ضملي8087,اختيارخ فملي-59750-1399/08/06,1,1,530000,580,530,530,-50,-8.62,530,-50,-8.62,530,530,1399-7-1
822,ضسپا8020,اختيارخ خساپا-2800-1399/08/26,1,20,2000000,201,100,100,-101,-50.25,100,-101,-50.25,100,100,1399-7-1
823,تملي711,تسهيلات مسكن ب. ملي-بهمن97,1,1,486597,463426,486597,486597,23171,5.0,486597,23171,5.0,486597,486597,1399-7-1
824,ضخود7065,اختيارخ خودرو-6500-1399/07/09,1,1,10000,2999,10,10,-2989,-99.67,10,-2989,-99.67,10,10,1399-7-1
825,گواهي ظرفيت,گواهي ظرفيت نقدي,1,10500000,111709500000,10639,10639,10639,0,0.0,10639,0,0.0,10639,10639,1399-7-1
826,تيپيكو2,سرمايه گذاري دارويي تامين,1,7845166,448194333580,57190,57130,57130,-60,-0.1,57130,-60,-0.1,57130,57130,1399-7-1
827,ضپيك7033,اختيارخ تاپيكو-21370-99/07/20,1,6,12000000,1800,2000,2000,200,11.11,2000,200,11.11,2000,2000,1399-7-1
828,تپولا,مهندسي مرآت پولاد,1,480,7816320,16787,16284,16284,-503,-3.0,16787,0,0.0,16284,16284,1399-7-1
829,ضفار8037,اختيارخ فارس-12826-1399/08/06,1,15,129000000,5815,8600,8600,2785,47.89,8600,2785,47.89,8600,8600,1399-7-1
830,ضخوز7030,اختيارخ فخوز-51470-1399/07/20,1,1,1600000,3317,1600,1600,-1717,-51.76,1600,-1717,-51.76,1600,1600,1399-7-1
831,ضغدر8036,اختيارخ وغدير-9500-1399/08/26,1,1,9999000,10000,9999,9999,-1,-0.01,9999,-1,-0.01,9999,9999,1399-7-1
832,شرق1400,مشاركت ليزينگ ايران وشرق140010,1,10,10100000,1030000,1010000,1010000,-20000,-1.94,1010000,-20000,-1.94,1010000,1010000,1399-7-1
833,اشاد1,مشاركت دولتي1-شرايط خاص001026,1,2000,1980000000,1000000,990000,990000,-10000,-1.0,990000,-10000,-1.0,990000,990000,1399-7-1
834,ضپنا7046,اختيارخ رمپنا-44457-1399/07/13,1,1,50000,100,50,50,-50,-50.0,50,-50,-50.0,50,50,1399-7-1
835,ضجار7018,اختيارخ وتجارت-2000-1399/07/22,1,1,1100000,1466,1100,1100,-366,-24.97,1100,-366,-24.97,1100,1100,1399-7-1
836,تابان03,اجاره تابان سپهر14021206,1,1000,1000000000,1000000,1000000,1000000,0,0.0,1000000,0,0.0,1000000,1000000,1399-7-1
837,لوتوس99,اجاره لوتوس پارسيان990717,1,7,7000000,1000000,1000000,1000000,0,0.0,1000000,0,0.0,1000000,1000000,1399-7-1
838,ضجار7010,اختيارخ وتجارت-1200-1399/07/22,1,5,9995000,2000,1999,1999,-1,-0.05,1999,-1,-0.05,1999,1999,1399-7-1
839,ضبدر8058,اختيارخ شبندر-25580-1399/08/18,1,2,30000000,17000,15000,15000,-2000,-11.76,15000,-2000,-11.76,15000,15000,1399-7-1
840,دسبحا2,گروه دارويي سبحان,1,32000000,566400000000,17230,17700,17700,470,2.73,17700,470,2.73,17700,17700,1399-7-1
841,تملي803,تسهيلات مسكن ب. ملي-خرداد98,1,1,173541,165278,173541,173541,8263,5.0,173541,8263,5.0,173541,173541,1399-7-1
842,ضجار7021,اختيارخ وتجارت-2600-1399/07/22,1,5,4000000,785,800,800,15,1.91,800,15,1.91,800,800,1399-7-1
843,تملي706,تسهيلات مسكن ب. ملي-شهريور97,1,1,234491,223325,234491,234491,11166,5.0,234491,11166,5.0,234491,234491,1399-7-1
844,اخزا819,اسنادخزانه-م19بودجه98-020322,1,20,12940000,640333,647000,647000,6667,1.04,647000,6667,1.04,647000,647000,1399-7-1
845,ضچاد7013,اختيارخ كچاد-10300-1399/07/07,1,1,10600000,8990,10600,10600,1610,17.91,10600,1610,17.91,10600,10600,1399-7-1
846,مبين2,مبين انرژي خليج فارس,1,8000000,204400000000,25550,25550,25550,0,0.0,25550,0,0.0,25550,25550,1399-7-1
847,ضفار8042,اختيارخ فارس-17826-1399/08/06,1,1,3333000,1000,3333,3333,2333,233.3,3333,2333,233.3,3333,3333,1399-7-1
848,ضپاس7018,اختيارخ وپارس-4600-1399/07/30,1,6,4200000,668,700,700,32,4.79,700,32,4.79,700,700,1399-7-1
849,ساروج,بين المللي ساروج بوشهر,1,3000,71709000,24642,23903,23903,-739,-3.0,24639,-3,-0.01,23903,23903,1399-7-1
850,اخزا9022,اسنادخزانه-م2بودجه99-011019,1,150000,101100000000,667114,674000,674000,6886,1.03,674000,6886,1.03,674000,674000,1399-7-1
851,تملي802,تسهيلات مسكن ب. ملي-ارديبهشت98,1,14,7357812,500532,525558,525558,25026,5.0,525558,25026,5.0,525558,525558,1399-7-1
852,قمرو,قند مرودشت‌,1,149,5276090,37270,35410,35410,-1860,-4.99,37270,0,0.0,35410,35410,1399-7-1
853,اوصتا4,صندوق انديشه ورزان صباتامين -د,1,18400000,306176000000,16760,16640,16640,-120,-0.72,16640,-120,-0.72,16640,16640,1399-7-1
854,اخزا720,اسنادخزانه-م20بودجه97-000324,1,15,13275000,885244,885000,885000,-244,-0.03,885000,-244,-0.03,885000,885000,1399-7-1
855,ضگل8068,اختيارخ كگل-28000-1399/08/21,1,45,202500000,3500,4500,4500,1000,28.57,4500,1000,28.57,4500,4500,1399-7-1
856,اراد42,مرابحه عام دولت4-ش.خ 0106,1,1000,1020000000,1000000,1020000,1020000,20000,2.0,1020000,20000,2.0,1020000,1020000,1399-7-1
857,تايرا2,تراكتورسازي‌ايران‌,1,11453811,271455320700,24230,23700,23700,-530,-2.19,23700,-530,-2.19,23700,23700,1399-7-1
858,پارسان4,گسترش نفت و گاز پارسيان,1,15000000,412245000000,28690,27483,27483,-1207,-4.21,27483,-1207,-4.21,27483,27483,1399-7-1
859,اشاد14,مشاركت دولتي1-شرايط خاص001026,1,585000,571545000000,1000000,977000,977000,-23000,-2.3,977000,-23000,-2.3,977000,977000,1399-7-1
860,ضخود7052,اختيارخ خودرو-1400-1399/07/09,1,6,10800000,1600,1800,1800,200,12.5,1800,200,12.5,1800,1800,1399-7-1
861,تملي804,تسهيلات مسكن ب. ملي-تير98,1,1,229327,218407,229327,229327,10920,5.0,229327,10920,5.0,229327,229327,1399-7-1
862,سپرمي,پرميت‌,1,600,5026200,8461,8377,8377,-84,-0.99,8461,0,0.0,8377,8377,1399-7-1
863,اشاد102,مشاركت دولتي10-شرايط خاص001226,1,87,82650000,961562,950000,950000,-11562,-1.2,950000,-11562,-1.2,950000,950000,1399-7-1
864,ضفلا8078,اختيارخ فولاد-9775-1399/08/28,1,1,10000000,7610,10000,10000,2390,31.41,10000,2390,31.41,10000,10000,1399-7-1
865,ضپنا7042,اختيارخ رمپنا-32306-1399/07/13,1,45,4500000,100,100,100,0,0.0,100,0,0.0,100,100,1399-7-1
866,شتهران,داروسازي تهران شيمي,1,771,6592821,8223,8551,8551,328,3.99,8223,0,0.0,8551,8551,1399-7-1
867,ضغدر8037,اختيارخ وغدير-10000-1399/08/26,1,6,60000000,9500,10000,10000,500,5.26,10000,500,5.26,10000,10000,1399-7-1
868,اشاد10,مشاركت دولتي10-شرايط خاص001226,1,100,96500000,961562,965000,965000,3438,0.36,965000,3438,0.36,965000,965000,1399-7-1
869,تملي704,تسهيلات مسكن ب. ملي-تير97,1,1,823832,784602,823832,823832,39230,5.0,823832,39230,5.0,823832,823832,1399-7-1
870,ضگل8059,اختيارخ كگل-15100-1399/08/21,1,1,8700000,8000,8700,8700,700,8.75,8700,700,8.75,8700,8700,1399-7-1
