,نماد,نام,تعداد,حجم,ارزش,دیروز,اولین,آخرین معامله - مقدار,آخرین معامله - تغییر,آخرین معامله - درصد,قیمت پایانی - مقدار,قیمت پایانی - تغییر,قیمت پایانی - درصد,کمترین,بیشترین,تاریخ
0,دارا يكم,صندوق واسطه گري مالي يكم-سهام,58017,30119583,5758330887510,200270,196500,186600,-13670,-6.83,191180,-9090,-4.54,186000,197000,1399-8-11
1,بپيوند,برق و انرژي پيوندگستر پارس,51912,70656346,1682084777665,24034,24500,23050,-984,-4.09,23807,-227,-0.94,22000,25250,1399-8-11
2,خساپا,سايپا,45089,1558164308,3749655485300,2440,2490,2400,-40,-1.64,2410,-30,-1.23,2320,2520,1399-8-11
3,وسپهر,سرمايه گذاري مالي سپهرصادرات,42935,122002362,1447307931498,12391,12456,11772,-619,-5.0,11863,-528,-4.26,11772,12456,1399-8-11
4,فولاد,فولاد مباركه اصفهان,30741,193483428,2421422917390,13010,13100,12370,-640,-4.92,12510,-500,-3.84,12360,13120,1399-8-11
5,سيتا,سرمايه گذاري سيمان تامين,25350,46807724,792433116520,17730,17730,16850,-880,-4.96,16930,-800,-4.51,16850,17730,1399-8-11
6,فملي,ملي‌ صنايع‌ مس‌ ايران‌,21310,81345212,1700893566630,21540,22000,20490,-1050,-4.87,20910,-630,-2.92,20480,22000,1399-8-11
7,خگستر,گسترش‌سرمايه‌گذاري‌ايران‌خودرو,18984,377620458,1519298057800,4190,4250,3990,-200,-4.77,4020,-170,-4.06,3990,4250,1399-8-11
8,شپنا,پالايش نفت اصفهان,16652,121359757,1672185098780,14450,14350,13730,-720,-4.98,13780,-670,-4.64,13730,14400,1399-8-11
9,ذوب,سهامي ذوب آهن  اصفهان,16413,221927179,1042439320517,4682,4786,4589,-93,-1.99,4697,15,0.32,4500,4830,1399-8-11
10,گدنا,تهيه توزيع غذاي دنا آفرين فدك,16407,156891,2510099109,15238,15999,15999,761,4.99,15274,36,0.24,15999,15999,1399-8-11
11,لپارس,پارس‌ الكتريك‌,15430,6426651,1232439791430,186000,195300,181800,-4200,-2.26,191770,5770,3.1,177500,195300,1399-8-11
12,وبصادر,بانك صادرات ايران,15387,362828569,1182073824960,3410,3400,3240,-170,-4.99,3260,-150,-4.4,3240,3400,1399-8-11
13,وبملت,بانك ملت,15013,238440402,1128358073680,4800,4890,4620,-180,-3.75,4730,-70,-1.46,4570,4890,1399-8-11
14,پترول,گروه پتروشيمي س. ايرانيان,14911,71566524,869753765900,12590,12800,11970,-620,-4.92,12150,-440,-3.49,11970,12800,1399-8-11
15,امين,تامين سرمايه امين,14328,19984916,227772237460,11890,11930,11300,-590,-4.96,11400,-490,-4.12,11300,12010,1399-8-11
16,آريا,پليمر آريا ساسول,13249,3061973,481635476708,161706,161990,154580,-7126,-4.41,157296,-4410,-2.73,154400,161990,1399-8-11
17,شاروم,پتروشيمي اروميه,12832,11374920,245383604719,22691,21557,21557,-1134,-5.0,21572,-1119,-4.93,21557,22230,1399-8-11
18,ثبهساز,بهساز كاشانه تهران,11795,74973158,218410858500,3050,3050,2900,-150,-4.92,2910,-140,-4.59,2900,3050,1399-8-11
19,رافزا,رايان هم افزا,11702,68305,2352560810,32802,34442,34442,1640,5.0,32875,73,0.22,34442,34442,1399-8-11
20,ولپارس,ليزينگ پارسيان,11531,881518,4178395320,4520,4740,4740,220,4.87,4530,10,0.22,4740,4740,1399-8-11
21,خپارس,پارس‌ خودرو,10693,130909877,818205471400,7040,6000,6300,-740,-10.51,6250,-790,-11.22,6000,6300,1399-8-11
22,ونوين,بانك‌اقتصادنوين‌,9455,380219909,1647447719540,4140,4340,4340,200,4.83,4330,190,4.59,4200,4340,1399-8-11
23,شتران,پالايش نفت تهران,9228,51218819,589737975350,12090,11900,11490,-600,-4.96,11510,-580,-4.8,11490,11960,1399-8-11
24,شبندر,پالايش نفت بندرعباس,9205,37459286,1029089400680,28870,27630,27430,-1440,-4.99,27470,-1400,-4.85,27430,28760,1399-8-11
25,گكوثر,هتل پارسيان كوثر اصفهان,8471,10572821,1566799355817,143749,140010,150936,7187,5.0,148191,4442,3.09,136562,150936,1399-8-11
26,بگيلان,توسعه مسير برق گيلان,8252,6681732,181199622907,28463,27700,27040,-1423,-5.0,27119,-1344,-4.72,27040,28200,1399-8-11
27,قثابت,قند ثابت‌ خراسان‌,7261,11043835,962283182440,84090,88290,85190,1100,1.31,87130,3040,3.62,80210,88290,1399-8-11
28,وغدير,سرمايه‌گذاري‌غدير(هلدينگ‌,6961,41130656,445914741010,11300,11590,10740,-560,-4.96,10840,-460,-4.07,10740,11590,1399-8-11
29,وپارس,بانك‌پارسيان‌,6764,188808169,593966725940,3290,3250,3130,-160,-4.86,3150,-140,-4.26,3130,3280,1399-8-11
30,انرژي3,سايراشخاص بورس انرژي,6764,1413925,527593844040,384610,390000,365380,-19230,-5.0,373140,-11470,-2.98,365380,395000,1399-8-11
31,زبينا,كشاورزي و دامپروري بينالود,6254,11863869,569568624162,44650,48900,49115,4465,10.0,48009,3359,7.52,45000,49115,1399-8-11
32,غزر,صنعتي زر ماكارون,6077,2943981,147333587200,52660,50030,50030,-2630,-4.99,50050,-2610,-4.96,50030,51000,1399-8-11
33,صباح,ح . سرمايه گذاري صبا تامين,5786,28634117,180557521880,6614,6420,6300,-314,-4.75,6306,-308,-4.66,6284,6500,1399-8-11
34,آبادا,توليد نيروي برق آبادان,5395,3392987,63080692720,19520,19480,18550,-970,-4.97,18590,-930,-4.76,18550,19480,1399-8-11
35,فخوز,فولاد  خوزستان,5309,18648161,641609073870,35040,36000,34010,-1030,-2.94,34410,-630,-1.8,33290,36000,1399-8-11
36,صبا,سرمايه گذاري صبا تامين,5161,27033099,223078679671,8676,8420,8243,-433,-4.99,8252,-424,-4.89,8243,8489,1399-8-11
37,شگويا,پتروشيمي تندگويان,5119,25889399,280085988063,11352,11150,10785,-567,-4.99,10819,-533,-4.7,10785,11230,1399-8-11
38,كاما,باما,4944,4127509,655127099850,164430,168770,156210,-8220,-5.0,158720,-5710,-3.47,156210,168770,1399-8-11
39,كچاد,معدني‌وصنعتي‌چادرملو,4580,28737484,434280769620,14660,15360,15110,450,3.07,15110,450,3.07,14130,15390,1399-8-11
40,نوري,پتروشيمي نوري,4555,2912565,486637532050,165560,166600,166010,450,0.27,167080,1520,0.92,160300,171580,1399-8-11
41,غگيلا,شيرپاستوريزه پگاه گيلان,4324,109512,1878240312,16335,17151,17151,816,5.0,16364,29,0.18,17151,17151,1399-8-11
42,كرازي,كارخانجات‌توليدي‌شيشه‌رازي‌,4228,27760651,465063543880,16010,16810,16600,590,3.69,16750,740,4.62,16150,16810,1399-8-11
43,فارس,صنايع پتروشيمي خليج فارس,3911,29104156,379033178450,13630,13250,12950,-680,-4.99,13020,-610,-4.48,12950,13300,1399-8-11
44,بجهرم,توسعه مولد نيروگاهي جهرم,3802,37504388,139279629561,3850,3910,3658,-192,-4.99,3714,-136,-3.53,3658,3920,1399-8-11
45,ثاميد,توسعه و عمران اميد,3681,40114995,103893131810,2710,2610,2580,-130,-4.8,2590,-120,-4.43,2580,2610,1399-8-11
46,فروي,ذوب روي اصفهان,3618,4789932,225158677843,47523,48250,46700,-823,-1.73,47007,-516,-1.09,45500,48400,1399-8-11
47,تسه9907,امتياز تسهيلات مسكن مهر99,3609,99414,81978918100,836144,810222,822620,-13524,-1.62,824621,-11523,-1.38,803055,830000,1399-8-11
48,شسپا,نفت سپاهان,3517,15324884,297622561240,18570,19490,19490,920,4.95,19420,850,4.58,18800,19490,1399-8-11
49,كاوه,فولاد كاوه جنوب كيش,3455,26836104,521807541280,20230,20160,19220,-1010,-4.99,19440,-790,-3.91,19220,20440,1399-8-11
50,وپاسار,بانك  پاسارگاد,3438,35741808,310860945150,9090,9190,8800,-290,-3.19,8700,-390,-4.29,8640,9190,1399-8-11
51,وخارزم,سرمايه گذاري خوارزمي,3199,27129224,267204462730,10350,9840,9840,-510,-4.93,9850,-500,-4.83,9840,9970,1399-8-11
52,وپست,پست بانك ايران,3131,26051280,285610758510,10470,10990,10990,520,4.97,10960,490,4.68,10510,10990,1399-8-11
53,بركت,گروه دارويي بركت,2788,11616395,153498490770,13760,13890,13080,-680,-4.94,13210,-550,-4.0,13080,13890,1399-8-11
54,زقيام,كشت و دام قيام اصفهان,2739,9525027,298996213006,28852,31737,31737,2885,10.0,31391,2539,8.8,29000,31737,1399-8-11
55,ولساپا,ليزينگ رايان‌ سايپا,2722,43586573,151506265960,3620,3580,3440,-180,-4.97,3480,-140,-3.87,3440,3670,1399-8-11
56,شصدفح,ح . صنعتي دوده فام,2687,1033246,18304994024,18058,18020,17741,-317,-1.76,17716,-342,-1.89,17620,18020,1399-8-11
57,خاهن,آهنگري‌ تراكتورسازي‌ ايران‌,2659,11917983,351306831260,28100,29500,29500,1400,4.98,29480,1380,4.91,28370,29500,1399-8-11
58,ختوقا,قطعات‌ اتومبيل‌ ايران‌,2538,33329197,122428067210,3850,3720,3660,-190,-4.94,3670,-180,-4.68,3660,3850,1399-8-11
59,زدشت,كشت و صنعت دشت خرم دره,2500,8195997,310236925745,36293,38050,38107,1814,5.0,37852,1559,4.3,36610,38107,1399-8-11
60,ارفع,شركت آهن و فولاد ارفع,2488,15199338,192525456155,12754,13000,12500,-254,-1.99,12667,-87,-0.68,12117,13010,1399-8-11
61,آگاس,صندوق س.هستي بخش آگاه-س,2429,2191216,137092994967,64872,64500,61006,-3866,-5.96,62565,-2307,-3.56,61000,65400,1399-8-11
62,نوين,بيمه نوين,2407,20441919,131695912801,6317,6400,6341,24,0.38,6442,125,1.98,6172,6600,1399-8-11
63,زشگزا,شير و گوشت زاگرس شهركرد,2384,2358127,253331332598,98301,108120,108131,9830,10.0,107429,9128,9.29,99986,108131,1399-8-11
64,كگل,معدني و صنعتي گل گهر,2317,13271524,200658589760,15270,15920,15300,30,0.2,15120,-150,-0.98,14570,15920,1399-8-11
65,كمند,صندوق س. با درآمد ثابت كمند,2279,106088031,1078748811540,10158,10160,10171,13,0.13,10168,10,0.1,10160,10178,1399-8-11
66,مدير,ص.س.مديريت ثروت ص.بازنشستگي-س,2212,10644152,109685298542,10749,10700,10170,-579,-5.39,10305,-444,-4.13,10161,10700,1399-8-11
67,هاي وب,داده گسترعصرنوين-هاي وب,2184,8318263,190220397140,23990,23990,22800,-1190,-4.96,22870,-1120,-4.67,22800,24190,1399-8-11
68,غپينو,پارس‌ مينو,2161,14098926,93329853720,6700,6890,6450,-250,-3.73,6620,-80,-1.19,6370,6890,1399-8-11
69,ماديرا,صنايع ماشين هاي اداري ايران,2142,6748334,188475060619,29239,29300,27778,-1461,-5.0,27929,-1310,-4.48,27778,29300,1399-8-11
70,چكاپا,گروه صنايع كاغذ پارس,2092,24952396,135950295220,5710,5530,5430,-280,-4.9,5450,-260,-4.55,5430,5740,1399-8-11
71,شبريز,پالايش نفت تبريز,2061,6739071,192792537380,30080,29000,28580,-1500,-4.99,28610,-1470,-4.89,28580,29100,1399-8-11
72,زكوثر,سرمايه گذاري كشاورزي كوثر,2033,3922176,70979153860,18850,17930,17910,-940,-4.99,18100,-750,-3.98,17910,18750,1399-8-11
73,پارسان,گسترش نفت و گاز پارسيان,2009,14081064,277011443970,20580,20030,19560,-1020,-4.96,19670,-910,-4.42,19560,20600,1399-8-11
74,پاكشو,گروه صنعتي پاكشو,1987,2376672,209970027070,90720,90720,87450,-3270,-3.6,88350,-2370,-2.61,86400,91000,1399-8-11
75,كسرام,پارس‌ سرام‌,1955,27328707,156893841060,5770,5490,6050,280,4.85,5740,-30,-0.52,5490,6050,1399-8-11
76,دي,بانك دي,1950,9777458,463823052604,49934,47438,47438,-2496,-5.0,47438,-2496,-5.0,47438,47438,1399-8-11
77,شصدف,صنعتي دوده فام,1881,107908,2520838788,22249,23361,23361,1112,5.0,22302,53,0.24,23361,23361,1399-8-11
78,وصنعت,سرمايه گذاري توسعه صنعت وتجارت,1807,13915674,105296699010,7620,7840,7470,-150,-1.97,7570,-50,-0.66,7320,7840,1399-8-11
79,اخابر,مخابرات ايران,1800,22606232,289591722370,13470,13200,12800,-670,-4.97,12810,-660,-4.9,12800,13200,1399-8-11
80,امين يكم,صندوق درآمد ثابت امين يكم فردا,1778,61188928,624788711726,10210,10215,10206,-4,-0.04,10211,1,0.01,10203,10220,1399-8-11
81,وساخت,سرمايه‌ گذاري‌ ساختمان‌ايران‌,1681,3713022,169610767960,44260,45400,45000,740,1.67,45680,1420,3.21,43500,46470,1399-8-11
82,وتوصا,گروه س توسعه صنعتي ايران,1666,11472280,97310334010,8770,8430,8430,-340,-3.88,8480,-290,-3.31,8340,9000,1399-8-11
83,خرينگ,رينگ‌سازي‌مشهد,1657,4299007,163308666640,36280,38090,38090,1810,4.99,37990,1710,4.71,35440,38090,1399-8-11
84,شرانل,نفت ايرانول,1650,4395277,120513691926,26459,27550,27781,1322,5.0,27419,960,3.63,26000,27781,1399-8-11
85,كترام,توليدي‌ كاشي‌ تكسرام‌,1629,3112955,74332623860,23860,24980,23000,-860,-3.6,23880,20,0.08,22670,24980,1399-8-11
86,شبهرن,نفت‌ بهران‌,1618,4645978,265329006300,54420,57140,57140,2720,5.0,57110,2690,4.94,55200,57140,1399-8-11
87,ومهان,گروه توسعه مالي مهر آيندگان,1617,9012488,125377490432,14417,14550,13697,-720,-4.99,13912,-505,-3.5,13697,14551,1399-8-11
88,رانفور,خدمات‌انفورماتيك‌,1598,7648461,226227374800,29850,29300,29000,-850,-2.85,29580,-270,-0.9,28360,31290,1399-8-11
89,ارزش,صندوق س ارزش آفرين بيدار-سهام,1592,9071809,86521702880,9900,9800,9390,-510,-5.15,9540,-360,-3.64,9350,9800,1399-8-11
90,طلا,صندوق س.پشتوانه طلاي لوتوس,1584,1246382,107011378432,82869,85000,86440,3571,4.31,85858,2989,3.61,84900,86990,1399-8-11
91,اعتماد,صندوق س.اعتماد آفرين پارسيان-د,1575,48238410,1597353570250,33093,33110,33114,21,0.06,33114,21,0.06,33109,33118,1399-8-11
92,سفارس,سيمان فارس و خوزستان,1555,7959716,117737815190,15430,15500,14660,-770,-4.99,14790,-640,-4.15,14660,15500,1399-8-11
93,غگل,گلوكوزان‌,1539,11554309,54704740720,4940,5000,4700,-240,-4.86,4730,-210,-4.25,4700,5000,1399-8-11
94,پكرمان,گروه‌ صنعتي‌ بارز,1521,3994319,101422534500,25910,27200,24640,-1270,-4.9,25390,-520,-2.01,24620,27200,1399-8-11
95,قزوين,كارخانجات‌ قند قزوين‌,1506,11040408,391123111990,33750,35430,35430,1680,4.98,35430,1680,4.98,34010,35430,1399-8-11
96,وبانك,سرمايه گذاري گروه توسعه ملي,1499,6358790,58147798980,9430,9690,9050,-380,-4.03,9260,-170,-1.8,9020,9690,1399-8-11
97,تاصيكو,سرمايه گذاري صدرتامين,1483,11507133,106934662690,9750,9440,9270,-480,-4.92,9330,-420,-4.31,9270,9600,1399-8-11
98,بنو,بيمه تجارت نو,1480,8682462,296088296512,34844,34250,33360,-1484,-4.26,34102,-742,-2.13,33142,35549,1399-8-11
99,شغدير,پتروشيمي غدير,1479,5687276,252177534988,42907,44990,45052,2145,5.0,44341,1434,3.34,41000,45052,1399-8-11
100,زاگرس,پتروشيمي زاگرس,1469,1031204,159569011642,157381,156500,151001,-6380,-4.05,154740,-2641,-1.68,151000,159400,1399-8-11
101,رتاپح,ح.تجارت الكترونيك پارسيان,1453,4709805,20326663330,4410,4730,4250,-160,-3.63,4320,-90,-2.04,4010,4730,1399-8-11
102,چكارن,كارتن‌ ايران‌,1440,14962648,50160755470,3490,3570,3320,-170,-4.87,3350,-140,-4.01,3320,3570,1399-8-11
103,ضصاد1102,اختيارخ وبصادر-3500-1399/11/12,1424,59211,26125076000,621,709,440,-181,-29.15,441,-180,-28.99,351,709,1399-8-11
104,فرابورس,فرابورس ايران,1417,2565496,144628296038,59093,58000,56139,-2954,-5.0,56374,-2719,-4.6,56139,58900,1399-8-11
105,قرن,پديده شيمي قرن,1382,1084819,55854722630,51780,52300,50770,-1010,-1.95,51490,-290,-0.56,50050,53160,1399-8-11
106,هرمز,فولاد هرمزگان جنوب,1379,10359356,118530748134,11661,11700,11439,-222,-1.9,11442,-219,-1.88,11130,11722,1399-8-11
107,شفارس,صنايع‌ شيميايي‌ فارس‌,1356,4314678,163608544710,39810,37820,37820,-1990,-5.0,37920,-1890,-4.75,37820,39900,1399-8-11
108,بپاس,بيمه پاسارگاد,1344,2482854,157451142896,63962,64000,64200,238,0.37,63415,-547,-0.86,61766,64540,1399-8-11
109,سرو,صندوق س سروسودمند مدبران-سهام,1303,1508388,84436535690,57430,58480,55000,-2430,-4.23,55980,-1450,-2.52,54800,58480,1399-8-11
110,افق,فروشگاههاي زنجيره اي افق كوروش,1223,1502885,110967405420,74760,76900,72800,-1960,-2.62,73840,-920,-1.23,72010,76900,1399-8-11
111,غمينو,شركت صنايع غذايي مينو شرق,1210,6481339,121188490423,18633,19564,17702,-931,-5.0,18698,65,0.35,17702,19564,1399-8-11
112,فجر,فولاد اميركبيركاشان,1207,3412365,181260776300,55860,53900,53070,-2790,-4.99,53120,-2740,-4.91,53070,54000,1399-8-11
113,غسالم,سالمين‌,1178,6496699,30003312040,4810,4860,4570,-240,-4.99,4690,-120,-2.49,4570,4860,1399-8-11
114,فاسمين,كالسيمين‌,1135,6973361,97359430620,14660,14300,13930,-730,-4.98,13960,-700,-4.77,13930,14640,1399-8-11
115,رمپنا,گروه مپنا (سهامي عام),1058,4791492,74216931140,16200,16630,15390,-810,-5.0,15760,-440,-2.72,15390,16630,1399-8-11
116,وتوسم,سرمايه‌گذاري‌توسعه‌ملي‌,1056,5176749,58318312530,11130,11660,11200,70,0.63,11270,140,1.26,11000,11660,1399-8-11
117,سجام,مجتمع سيمان غرب آسيا,1053,11472563,123460052859,10779,10779,10784,5,0.05,10761,-18,-0.17,10241,11317,1399-8-11
118,فسپا,گروه‌صنعتي‌سپاهان‌,1006,2177122,88375903400,39820,41220,41000,1180,2.96,40590,770,1.93,38550,41800,1399-8-11
119,كگازح,ح . شيشه‌ و گاز,1002,3056396,40068963100,14010,14030,13080,-930,-6.64,13110,-900,-6.42,12900,14030,1399-8-11
120,همراه,شركت ارتباطات سيار ايران,995,1895687,51752130650,28410,28900,27080,-1330,-4.68,27810,-600,-2.11,27000,28900,1399-8-11
121,زنجان,صنايع كشاورزي وكود زنجان,990,12396209,75664756666,5944,6122,6122,178,2.99,6104,160,2.69,5909,6122,1399-8-11
122,وبيمهح,ح . سرمايه‌ گذاري‌ صنعت‌ بيمه‌,989,26039394,35237587630,1410,1450,1320,-90,-6.38,1350,-60,-4.26,1310,1450,1399-8-11
123,ونفت,سرمايه‌گذاري‌ صنعت‌ نفت‌,976,7444138,89834952240,12610,12900,11990,-620,-4.92,12070,-540,-4.28,11980,12900,1399-8-11
124,بترانس,ايران‌ ترانسفو,967,2424421,64189291280,27780,27030,26400,-1380,-4.97,26480,-1300,-4.68,26400,27670,1399-8-11
125,كبافق,معادن‌ بافق‌,966,1152807,40063685290,35010,35600,34510,-500,-1.43,34810,-200,-0.57,33500,35990,1399-8-11
126,آوا,صندوق س.سهام آواي معيار-س,966,5596244,42914639770,7944,7999,7505,-439,-5.53,7668,-276,-3.47,7500,7999,1399-8-11
127,حريل,ريل پردازسير,950,9900249,35553325376,3766,3760,3578,-188,-4.99,3640,-126,-3.35,3578,3760,1399-8-11
128,زر,صندوق س.پشتوانه سكه طلاي زر,945,2326834,122289558271,49144,50000,51601,2457,5.0,52556,3412,6.94,50000,54058,1399-8-11
129,آسيا,بيمه آسيا,945,2743552,63756652790,24050,24900,22850,-1200,-4.99,23240,-810,-3.37,22850,24900,1399-8-11
130,وسكاب,س.ص.بازنشستگي كاركنان بانكها,942,7589236,47310888600,6350,6400,6230,-120,-1.89,6240,-110,-1.73,6120,6400,1399-8-11
131,كوثر,بيمه كوثر,936,6167998,79519114811,13417,13350,12747,-670,-4.99,12892,-525,-3.91,12747,13500,1399-8-11
132,كاردان,صندوق س تجارت شاخصي كاردان,927,692676,101007878170,155080,150000,142500,-12580,-8.11,145820,-9260,-5.97,142000,151000,1399-8-11
133,والبر,سرمايه‌ گذاري‌ البرز(هلدينگ‌,912,4575249,61171184720,14030,14070,13330,-700,-4.99,13370,-660,-4.7,13330,14070,1399-8-11
134,خمحركه,نيرو محركه‌,897,6967593,47503566590,7140,6850,6790,-350,-4.9,6820,-320,-4.48,6790,7040,1399-8-11
135,وبيمه,سرمايه‌ گذاري‌ صنعت‌ بيمه‌,897,6358414,16927799890,2680,2760,2620,-60,-2.24,2670,-10,-0.37,2560,2760,1399-8-11
136,كلر,كلر پارس,891,750606,41957382502,58573,59700,55645,-2928,-5.0,56261,-2312,-3.95,55645,59700,1399-8-11
137,كپشيرح,ح . پشم‌شيشه‌ايران‌,877,4139488,45528406346,10759,10560,11320,561,5.21,10999,240,2.23,9780,11690,1399-8-11
138,عيار,صندوق س. پشتوانه طلاي مفيد,864,984500,30341766152,30020,30500,30943,923,3.07,30819,799,2.66,30333,31450,1399-8-11
139,جم پيلن,پلي پروپيلن جم - جم پيلن,861,1294233,95407934850,76470,78990,72650,-3820,-5.0,73720,-2750,-3.6,72650,78990,1399-8-11
140,شلعابح,ح . لعابيران‌,847,8230401,35640693060,4670,4500,4320,-350,-7.49,4330,-340,-7.28,4210,4510,1399-8-11
141,كساوه,صنايع‌ كاشي‌ و سراميك‌ سينا,836,7970040,345516368110,41720,41800,43800,2080,4.99,43350,1630,3.91,40010,43800,1399-8-11
142,ريشمك,توليد و صادرات ريشمك,822,1039089,34612585677,34025,34119,32580,-1445,-4.25,33543,-482,-1.42,32324,35000,1399-8-11
143,كپارس,كاشي‌ پارس‌,816,505983,50404945200,97670,98420,99890,2220,2.27,99510,1840,1.88,95160,101890,1399-8-11
144,ودي,بيمه  دي,809,6825028,142571294818,21918,21710,20823,-1095,-5.0,20889,-1029,-4.69,20823,21900,1399-8-11
145,سمازن,سيمان‌مازندران‌,804,4839962,41934930410,8710,8710,8990,280,3.21,8670,-40,-0.46,8280,9000,1399-8-11
146,سرچشمه,سرمايه گذاري مس سرچشمه,791,5543543,39843660660,7446,7600,7140,-306,-4.11,7238,-208,-2.79,7084,7600,1399-8-11
147,آريان,سرمايه گذاري پارس آريان,790,13623465,179380720272,13470,13600,13280,-190,-1.41,13167,-303,-2.25,13066,13600,1399-8-11
148,فاراك,ماشين‌ سازي‌ اراك‌,789,7468870,53774500670,7490,7350,7120,-370,-4.94,7200,-290,-3.87,7120,7390,1399-8-11
149,شاراك,پتروشيمي شازند,773,3744677,70125457560,18660,18980,18500,-160,-0.86,18730,70,0.38,18000,19300,1399-8-11
150,كحافظ,كاشي‌ وسراميك‌ حافظ‌,769,2363908,60870631000,24530,25750,25750,1220,4.97,25750,1220,4.97,25750,25750,1399-8-11
151,شپديس,پتروشيمي پرديس,768,1484476,133518127310,90560,91050,90000,-560,-0.62,89940,-620,-0.68,87010,95050,1399-8-11
152,غويتا,ويتانا,764,1367370,67205157416,51467,49100,48894,-2573,-5.0,49149,-2318,-4.5,48894,50360,1399-8-11
153,زفكا,كشت و دامداري فكا,759,1082106,44032621188,41161,41010,41549,388,0.94,40722,-439,-1.07,39500,41890,1399-8-11
154,وصندوق,سرمايه‌گذاري‌صندوق‌بازنشستگي‌,749,5592409,74185703190,13650,13900,12970,-680,-4.98,13410,-240,-1.76,12970,13900,1399-8-11
155,حكشتي,كشتيراني جمهوري اسلامي ايران,749,818232,22427739120,28850,27410,27410,-1440,-4.99,28550,-300,-1.04,27410,27410,1399-8-11
156,وجامي,سرمايه گذاري جامي,743,7454418,107062996144,14137,14561,14561,424,3.0,14362,225,1.59,13713,14561,1399-8-11
157,ركيش,كارت اعتباري ايران كيش,740,6904146,84192906190,12830,12400,12190,-640,-4.99,12190,-640,-4.99,12190,12700,1399-8-11
158,وسينا,بانك سينا,737,6804914,62990992260,9700,9470,9220,-480,-4.95,9260,-440,-4.54,9220,9700,1399-8-11
159,ساوه,سيمان ساوه,736,265126,13536413058,53520,52420,50844,-2676,-5.0,52801,-719,-1.34,50844,52420,1399-8-11
160,كالا,بورس كالاي ايران,735,1319639,55443057840,43870,42720,41680,-2190,-4.99,42010,-1860,-4.24,41680,42950,1399-8-11
161,وسپه,سرمايه‌گذاري‌ سپه‌,735,2614736,31207149340,12160,12000,11810,-350,-2.88,12020,-140,-1.15,11700,12400,1399-8-11
162,حآسا,آسيا سير ارس,733,2744245,41352129876,14633,15150,15364,731,5.0,14973,340,2.32,14500,15364,1399-8-11
163,سيمرغ,سيمرغ,722,3158456,48660020630,16200,15400,15390,-810,-5.0,15410,-790,-4.88,15390,16140,1399-8-11
164,پاسا,ايران‌ياساتايرورابر,722,4758461,94884585220,20800,20550,19760,-1040,-5.0,19940,-860,-4.13,19760,20750,1399-8-11
165,شنفت,نفت‌ پارس‌,721,699725,36300928300,50730,49600,53000,2270,4.47,51530,800,1.58,49500,53260,1399-8-11
166,رنيك,جنرال مكانيك,716,1867967,45231844044,25467,25400,24194,-1273,-5.0,24324,-1143,-4.49,24194,25400,1399-8-11
167,دارا,صندوق س. دارا الگوريتم-د,716,30500581,305681267625,10000,10005,10005,5,0.05,10022,22,0.22,9999,10025,1399-8-11
168,سفاسي,شركت فارسيت اهواز,712,5494130,61951809880,10948,11276,11276,328,3.0,11276,328,3.0,11276,11276,1399-8-11
169,سخاش,سيمان‌خاش‌,706,452856,33625091290,70850,74390,74390,3540,5.0,73030,2180,3.08,72000,74390,1399-8-11
170,آپ,آسان پرداخت پرشين,703,3026614,44455483710,15400,15150,14630,-770,-5.0,14740,-660,-4.29,14630,15200,1399-8-11
171,ضپاس1002,اختيارخ وپارس-3000-1399/10/30,697,30522,18722960000,688,710,531,-157,-22.82,613,-75,-10.9,531,710,1399-8-11
172,شيراز,پتروشيمي‌شيراز,696,1018922,49063748950,47830,49800,48420,590,1.23,47990,160,0.33,46500,49830,1399-8-11
173,ثاخت,بين‌المللي‌توسعه‌ساختمان,695,6349042,24956196310,4100,4010,3900,-200,-4.88,4010,-90,-2.2,3900,4050,1399-8-11
174,ميدكو,هلدينگ صنايع  معدني خاورميانه,686,3522434,79378256904,22702,23000,22800,98,0.43,22591,-111,-0.49,21710,23000,1399-8-11
175,كنور,توسعه معدني و صنعتي صبانور,684,960103,34583890440,35870,36200,35800,-70,-0.2,35970,100,0.28,34080,36770,1399-8-11
176,بورس,بورس اوراق بهادار تهران,684,1307617,69965811810,56190,54190,53390,-2800,-4.98,54000,-2190,-3.9,53390,55000,1399-8-11
177,واعتبار,سرمايه گذاري اعتبار ايران,667,7866918,35760797660,4710,4610,4620,-90,-1.91,4590,-120,-2.55,4480,4770,1399-8-11
178,ثباغ,شهر سازي و خانه سازي باغميشه,661,1311420,46974560773,36271,37000,34458,-1813,-5.0,35862,-409,-1.13,34458,37000,1399-8-11
179,فاما,صنعتي‌ آما,645,2340790,53022599070,22100,23200,22550,450,2.04,22650,550,2.49,21800,23200,1399-8-11
180,كطبس,ذغال‌سنگ‌ نگين‌ ط‌بس‌,643,856829,37000293370,42340,43480,44450,2110,4.98,42950,610,1.44,41010,44450,1399-8-11
181,گنجين2,صندوق س. گنجينه يكم آويد-د,640,64000000,64000000,11536,1,1,-11535,-99.99,1,-11535,-99.99,1,1,1399-8-11
182,حتوكا,حمل‌ونقل‌توكا,638,3996720,77180695930,17520,18500,19420,1900,10.84,19310,1790,10.22,18500,19420,1399-8-11
183,شخارك,پتروشيمي‌ خارك‌,637,829394,31054581030,37270,38330,37240,-30,-0.08,37330,60,0.16,36240,38950,1399-8-11
184,پرديس,سرمايه گذاري پرديس,636,4683888,30841996090,6890,6750,6550,-340,-4.93,6700,-190,-2.76,6550,6850,1399-8-11
185,پتاير,ايران‌ تاير,633,458059,41216805410,92200,93000,89500,-2700,-2.93,90410,-1790,-1.94,88000,93000,1399-8-11
186,پارس,پتروشيمي پارس,624,594581,79106929930,132540,137000,131630,-910,-0.69,132930,390,0.29,131110,139000,1399-8-11
187,جم,پتروشيمي جم,620,1697144,67391445000,40480,39100,40300,-180,-0.44,39950,-530,-1.31,38460,42500,1399-8-11
188,سصوفي,سيمان‌ صوفيان‌,619,3084068,38002872840,12950,12310,12310,-640,-4.94,12450,-500,-3.86,12310,12700,1399-8-11
189,اپرداز,آتيه داده پرداز,617,2072407,61661940624,31221,30500,29660,-1561,-5.0,29754,-1467,-4.7,29660,31000,1399-8-11
190,سكه9912پ04,سكه تمام بهارتحويل1روزه صادرات,612,371000,465333747900,1238617,1250000,1249990,11373,0.92,1254269,15652,1.26,1237000,1265000,1399-8-11
191,وآوا,سرمايه گذاري آوا نوين,611,1737846,20332509151,11935,12299,11520,-415,-3.48,11842,-93,-0.78,11440,12299,1399-8-11
192,رتاپ,تجارت الكترونيك  پارسيان,605,2701651,16305448560,6320,6290,6020,-300,-4.75,6220,-100,-1.58,6010,6290,1399-8-11
193,پارند,صندوق س. پارند پايدار سپهر,583,18885322,221074181978,11708,11709,11702,-6,-0.05,11706,-2,-0.02,11701,11739,1399-8-11
194,كيان,صندوق س. با درآمد ثابت كيان,574,14567320,375012390904,25723,25743,25750,27,0.1,25743,20,0.08,25741,25750,1399-8-11
195,وخاور,بانك خاورميانه,570,3914976,39376083210,10290,10290,10040,-250,-2.43,10140,-150,-1.46,10000,10290,1399-8-11
196,تيپيكو,سرمايه گذاري دارويي تامين,558,987577,48619707250,49830,49920,48500,-1330,-2.67,49490,-340,-0.68,47510,50370,1399-8-11
197,كرماشا,صنايع پتروشيمي كرمانشاه,551,1322833,47119978150,36620,36770,35000,-1620,-4.42,35690,-930,-2.54,34790,36770,1399-8-11
198,كروي,توسعه‌ معادن‌ روي‌ ايران‌,548,1424163,36251245200,26740,26600,25410,-1330,-4.97,25790,-950,-3.55,25410,26600,1399-8-11
199,سكه0012پ01,سكه تمام بهارتحويلي 1روزه رفاه,548,220700,277314225800,1238822,1269875,1249898,11076,0.89,1256521,17699,1.43,1239258,1275000,1399-8-11
200,شپاكسا,پاكسان‌,546,1458318,37302183190,26690,26930,26000,-690,-2.59,25830,-860,-3.22,25360,26930,1399-8-11
201,پكوير,كوير تاير,544,2058968,28774143130,14430,14800,14000,-430,-2.98,14170,-260,-1.8,13710,14800,1399-8-11
202,شلرد,كود شيميايي اوره لردگان,535,4199632,34231848645,8350,8150,8100,-250,-2.99,8151,-199,-2.38,8100,8290,1399-8-11
203,كسرا,سراميك‌هاي‌صنعتي‌اردكان‌,534,2460506,48163664290,20600,19940,19570,-1030,-5.0,19570,-1030,-5.0,19570,19940,1399-8-11
204,حتايد,تايدواترخاورميانه,533,4302716,68205037040,16670,16010,15840,-830,-4.98,15850,-820,-4.92,15840,16670,1399-8-11
205,كهمدا,شيشه‌ همدان‌,532,930867,8859507190,9680,10000,9520,-160,-1.65,9650,-30,-0.31,9250,10000,1399-8-11
206,دشيمي,شيمي‌ داروئي‌ داروپخش‌,531,908239,59486946580,66820,67800,63480,-3340,-5.0,65500,-1320,-1.98,63480,69930,1399-8-11
207,ضصاد8015,اختيارخ وبصادر-3400-1399/08/11,530,24651,163029000,40,15,1,-39,-97.5,7,-33,-82.5,1,28,1399-8-11
208,سامان,بانك سامان,527,12052513,106301820826,9078,9079,8806,-272,-3.0,8820,-258,-2.84,8806,9090,1399-8-11
209,زمگسا,كشاورزي‌ ودامپروي‌ مگسال‌,521,1405855,35648772620,26460,25140,25150,-1310,-4.95,25620,-840,-3.17,25140,26690,1399-8-11
210,ثفارس,عمران‌وتوسعه‌فارس‌,520,3791596,27991065090,7740,7740,7360,-380,-4.91,7520,-220,-2.84,7360,7740,1399-8-11
211,ولبهمن,شركت بهمن ليزينگ,519,1468935,13183691625,9447,8975,8975,-472,-5.0,9315,-132,-1.4,8975,8975,1399-8-11
212,غگلستا,شير پاستوريزه پگاه گلستان,511,2220273,33665381452,15874,15081,15081,-793,-5.0,15372,-502,-3.16,15081,16000,1399-8-11
213,سپ,پرداخت الكترونيك سامان كيش,503,2314015,32028565980,14540,13880,13880,-660,-4.54,14070,-470,-3.23,13820,14390,1399-8-11
214,كاريس,صندوق س.سپهر كاريزما-س,496,245951,42526427995,180852,171200,171991,-8861,-4.9,172906,-7946,-4.39,170000,181900,1399-8-11
215,قشكر,شكرشاهرود,493,625015,22813218160,38120,39440,36220,-1900,-4.98,37380,-740,-1.94,36220,39440,1399-8-11
216,شوينده,مديريت صنعت شوينده ت.ص.بهشهر,492,1476572,50948680030,36110,37000,35180,-930,-2.58,34500,-1610,-4.46,34310,37000,1399-8-11
217,زملارد,كشاورزي و دامپروري ملارد شير,487,203321,8950393741,46337,44021,44021,-2316,-5.0,45889,-448,-0.97,44021,44021,1399-8-11
218,فباهنر,مس‌ شهيدباهنر,482,454610,21767874620,50290,50270,47780,-2510,-4.99,49220,-1070,-2.13,47780,50270,1399-8-11
219,وپترو,سرمايه‌گذاري صنايع پتروشيمي‌,480,2552703,36094706440,14760,15200,14030,-730,-4.95,14300,-460,-3.12,14030,15200,1399-8-11
220,گنجين,صندوق س. گنجينه يكم آويد-د,478,32765556,377900529826,11536,11535,11530,-6,-0.05,11533,-3,-0.03,11530,11554,1399-8-11
221,شفن,پتروشيمي فناوران,477,200372,52990323140,265060,270000,258350,-6710,-2.53,264740,-320,-0.12,257000,274450,1399-8-11
222,فولاژ,فولاد آلياژي ايران,468,918793,20122683350,22930,22240,21790,-1140,-4.97,22540,-390,-1.7,21790,22350,1399-8-11
223,دزهراوي,داروسازي‌زهراوي‌,466,1913162,18739850230,10290,10100,9780,-510,-4.96,10090,-200,-1.94,9780,10100,1399-8-11
224,صايند,صندوق س. گنجينه آينده روشن-د,460,15368510,152557018180,10100,9963,9926,-174,-1.72,9927,-173,-1.71,9910,9963,1399-8-11
225,خكرمان,گروه اقتصادي كرمان خودرو,453,8003492,37883518737,4858,4830,4713,-145,-2.98,4733,-125,-2.57,4713,4840,1399-8-11
226,توريل,توکاريل,449,1414614,25445851744,18858,18200,17916,-942,-5.0,18378,-480,-2.55,17916,18900,1399-8-11
227,زگلدشت,كشت و دام گلدشت نمونه اصفهان,448,829272,27162488900,34316,32650,32800,-1516,-4.42,33404,-912,-2.66,32601,34000,1399-8-11
228,فسازان,غلتك سازان سپاهان,441,2675932,73660651290,28910,29200,27470,-1440,-4.98,27530,-1380,-4.77,27470,29200,1399-8-11
229,بكام,كارخانجات توليدي شهيد قندي,440,3239521,17266646930,5610,5330,5330,-280,-4.99,5500,-110,-1.96,5330,5330,1399-8-11
230,فايرا,آلومينيوم‌ايران‌,436,1569143,28468856990,18720,18440,18450,-270,-1.44,18380,-340,-1.82,17790,18550,1399-8-11
231,دتوليد,داروسازي توليد دارو,435,656980,20774309874,33173,31603,31515,-1658,-5.0,32464,-709,-2.14,31515,33000,1399-8-11
232,بساما,بيمه سامان,434,1562958,32671455334,21671,22000,20588,-1083,-5.0,21172,-499,-2.3,20588,22400,1399-8-11
233,بفجر,فجر انرژي خليج فارس,429,1317228,39280940990,29800,30710,29940,140,0.47,29810,10,0.03,29040,30710,1399-8-11
234,زعف9908پ10,زعفران9908نگين طلاي سرخ(پ),424,297028,23285388195,75393,76000,79162,3769,5.0,78395,3002,3.98,76000,79162,1399-8-11
235,كگهر,سنگ آهن گهرزمين,416,948626,37389796611,39398,39500,38463,-935,-2.37,39403,5,0.01,38110,40100,1399-8-11
236,سصفها,سيمان‌اصفهان‌,414,200730,23351545420,122410,116290,116290,-6120,-5.0,119450,-2960,-2.42,116290,122390,1399-8-11
237,گوهران,سرمايه گذاري توسعه گوهران اميد,414,3104728,24063946833,8152,7785,7745,-407,-4.99,7942,-210,-2.58,7745,7928,1399-8-11
238,وسبحان,سرمايه گذاري سبحان,410,5179171,45498651720,9221,8830,8760,-461,-5.0,8785,-436,-4.73,8760,9000,1399-8-11
239,وبوعلي,سرمايه‌گذاري‌بوعلي‌,404,3437637,25886102480,7920,7530,7530,-390,-4.92,7710,-210,-2.65,7530,7590,1399-8-11
240,ثمسكن,سرمايه‌گذاري‌ مسكن‌,403,3420368,19455193490,5960,5960,5670,-290,-4.87,5850,-110,-1.85,5670,5960,1399-8-11
241,اطلس,صندوق س.توسعه اندوخته آينده-س,400,82121,14419348407,181106,180000,174750,-6356,-3.51,175587,-5519,-3.05,174320,180999,1399-8-11
242,سمگا,گروه سرمايه گذاري ميراث فرهنگي,397,2479326,45347370948,18879,18800,17936,-943,-4.99,18318,-561,-2.97,17936,18800,1399-8-11
243,ياقوت,صندوق س ياقوت آگاه-ثابت,383,16547827,184974162881,11186,11200,11178,-8,-0.07,11178,-8,-0.07,11178,11200,1399-8-11
244,وآذر,سرمايه‌گذاري‌توسعه‌آذربايجان‌,378,195778,27682090740,147530,149630,140160,-7370,-5.0,144150,-3380,-2.29,140160,151900,1399-8-11
245,تسه9902,امتياز تسهيلات مسكن ارديبهشت99,378,11035,9358663169,869402,825932,829999,-39403,-4.53,848089,-21313,-2.45,825932,900000,1399-8-11
246,آرمان,بيمه آرمان,377,7686677,47200004125,6314,6130,6290,-24,-0.38,6140,-174,-2.76,6125,6400,1399-8-11
247,وآرين,شركت توسعه اقتصادي آرين,376,2661296,15145321859,5805,5800,5631,-174,-3.0,5719,-86,-1.48,5631,5930,1399-8-11
248,وتوكا,سرمايه‌گذاري‌توكافولاد(هلدينگ,375,2880317,26176798990,9550,9080,9080,-470,-4.92,9300,-250,-2.62,9080,9300,1399-8-11
249,فيروزه,صندوق شاخص30 شركت فيروزه- سهام,373,242663,37127645920,158780,157060,150000,-8780,-5.53,153000,-5780,-3.64,150000,157060,1399-8-11
250,مارون,پتروشيمي مارون,369,448202,55076370188,128800,133500,123000,-5800,-4.5,125382,-3418,-2.65,122360,133500,1399-8-11
251,پارسيانح,ح.بيمه پارسيان,366,1879651,17117680570,9730,10000,9060,-670,-6.89,9110,-620,-6.37,8790,10000,1399-8-11
252,ملت,بيمه ملت,355,1236356,15267701390,12870,12830,12230,-640,-4.97,12710,-160,-1.24,12230,12830,1399-8-11
253,قشرين,قند شيرين خراسان,353,3605081,56770402083,16154,16200,15940,-214,-1.32,15747,-407,-2.52,15670,16200,1399-8-11
254,ستران,سيمان‌ تهران‌,351,624788,19117680410,31930,30400,30340,-1590,-4.98,31380,-550,-1.72,30340,31930,1399-8-11
255,كوير,توليدي فولاد سپيد فراب كوير,346,2358172,32150090340,14330,13710,13620,-710,-4.95,13950,-380,-2.65,13620,14210,1399-8-11
256,گوهر,صندوق سكه طلاي كيان,346,307089,19693415384,61964,63110,63500,1536,2.48,64129,2165,3.49,63001,66500,1399-8-11
257,كخاكح,ح . صنايع‌خاك‌چيني‌ايران‌,344,371541,15071327240,43450,40010,39110,-4340,-9.99,40560,-2890,-6.65,39110,43650,1399-8-11
258,دتمادح,ح . توليدمواداوليه‌داروپخش‌,343,337291,11714596080,36800,36700,34700,-2100,-5.71,34730,-2070,-5.63,34350,36700,1399-8-11
259,وبشهر,توسعه‌ صنايع‌ بهشهر(هلدينگ,342,1558756,21927439960,14720,15340,13990,-730,-4.96,14430,-290,-1.97,13990,15340,1399-8-11
260,خزر,فنرسازي‌زر,340,2290787,26641852810,11080,11630,11630,550,4.96,11350,270,2.44,11630,11630,1399-8-11
261,دبالك,مواد اوليه دارويي البرز بالك,340,1778560,24366581511,14420,13699,13699,-721,-5.0,14037,-383,-2.66,13699,14190,1399-8-11
262,ثترانح,ح سرمايه گذاري مسكن تهران,336,4044290,11674001308,3016,2920,2866,-150,-4.97,2887,-129,-4.28,2866,3048,1399-8-11
263,ثالوند,سرمايه گذاري مسكن الوند,334,2035245,26302568704,13565,12900,12887,-678,-5.0,13207,-358,-2.64,12887,13491,1399-8-11
264,تاپكيش,تجارت الكترونيك پارسيان كيش,332,2948693,37001562981,11984,12583,12583,599,5.0,12375,391,3.26,11999,12583,1399-8-11
265,ولراز,ليزينگ رازي,331,1055964,24631056240,22996,23685,23685,689,3.0,23326,330,1.44,22307,23685,1399-8-11
266,خاتم,صندوق س خاتم ايساتيس پويا-ثابت,331,6219205,62192050000,10000,10000,10000,0,0.0,10000,0,0.0,10000,10000,1399-8-11
267,سخوز,سيمان خوزستان,330,1225370,25785662290,21510,22090,21480,-30,-0.14,21270,-240,-1.12,20440,22090,1399-8-11
268,سيدكو,سرمايه گذاري توسعه صنايع سيمان,330,1289789,8471846130,6830,6660,6570,-260,-3.81,6780,-50,-0.73,6490,6830,1399-8-11
269,كشرق,صنعتي و معدني شمال شرق شاهرود,321,298152,15459363856,52608,55000,50670,-1938,-3.68,52372,-236,-0.45,50600,55000,1399-8-11
270,دعبيد,لابراتوارداروسازي‌  دكترعبيدي‌,321,420931,12177710120,29990,30000,28500,-1490,-4.97,29740,-250,-0.83,28500,30000,1399-8-11
271,واميد,گروه مديريت سرمايه گذاري اميد,318,874283,30127288800,34980,34050,33540,-1440,-4.12,34850,-130,-0.37,33240,35980,1399-8-11
272,افق ملت,صندوق س در سهام افق ملت,310,113419,13366265960,122390,123100,116200,-6190,-5.06,117850,-4540,-3.71,116200,123100,1399-8-11
273,سشرق,سيمان‌ شرق‌,307,2486549,14734762460,6230,5930,5920,-310,-4.98,6130,-100,-1.61,5920,5950,1399-8-11
274,شاوان,پالايش نفت لاوان,305,531793,48525686037,96043,91250,91241,-4802,-5.0,91249,-4794,-4.99,91241,93380,1399-8-11
275,سكه0011پ02,سكه تمام بهارتحويلي 1روزه ملت,295,140300,175070310900,1238394,1300000,1247700,9306,0.75,1247828,9434,0.76,1238508,1300000,1399-8-11
276,شپارس,بين‌ المللي‌ محصولات‌  پارس‌,291,692703,10028554310,15120,15130,14380,-740,-4.89,14990,-130,-0.86,14380,15130,1399-8-11
277,چدن,توليدي چدن سازان,291,619124,16308766690,27710,26330,26330,-1380,-4.98,27230,-480,-1.73,26330,26800,1399-8-11
278,ثشاهد,سرمايه‌ گذاري‌ شاهد,290,384927,11366894310,31080,29530,29530,-1550,-4.99,30710,-370,-1.19,29530,29530,1399-8-11
279,مبين,مبين انرژي خليج فارس,288,1308385,27751640500,21480,21500,20900,-580,-2.7,21410,-70,-0.33,20870,21500,1399-8-11
280,غگرجي,بيسكويت‌  گرجي‌,285,1068042,27997121410,27580,26210,26210,-1370,-4.97,26750,-830,-3.01,26210,27000,1399-8-11
281,درهآور,دارويي ره آورد تامين,284,252359,7479440533,30577,30999,29890,-687,-2.25,30433,-144,-0.47,29050,30999,1399-8-11
282,وكار,بانك‌ كارآفرين‌,284,6457119,28157697930,4580,4380,4360,-220,-4.8,4450,-130,-2.84,4360,4380,1399-8-11
283,تايرا,تراكتورسازي‌ايران‌,279,1584777,33228307510,22000,22000,20900,-1100,-5.0,21280,-720,-3.27,20900,22000,1399-8-11
284,سكارون,سيمان كارون,278,286371,34214798980,116098,119580,119580,3482,3.0,119477,3379,2.91,116500,119580,1399-8-11
285,سيستم,همكاران سيستم,278,1007812,28162831390,27530,27600,27100,-430,-1.56,27770,240,0.87,26500,28800,1399-8-11
286,آتيمس,صندوق س.آرمان آتيه درخشان مس-س,275,97410,17760328249,188653,188600,180010,-8643,-4.58,182326,-6327,-3.35,177155,188600,1399-8-11
287,وپويا,سرمايه گذاري پويا,275,988549,10581428496,11267,10704,10704,-563,-5.0,11139,-128,-1.14,10704,10704,1399-8-11
288,شگل,گلتاش‌,273,758909,17918779730,24490,24000,24000,-490,-2.0,24170,-320,-1.31,23270,24500,1399-8-11
289,خراسان,پتروشيمي خراسان,271,790241,53448456050,69860,70000,67120,-2740,-3.92,67640,-2220,-3.18,66660,72990,1399-8-11
290,دارا2,صندوق س. دارا الگوريتم-د,271,27100000,27100000,10000,1,1,-9999,-99.99,1,-9999,-99.99,1,1,1399-8-11
291,دالبر,البرزدارو,271,796898,14433069280,18620,18840,18260,-360,-1.93,18470,-150,-0.81,17840,18840,1399-8-11
292,ومعلم,بيمه معلم,270,2220034,13659940052,6460,6429,6137,-323,-5.0,6368,-92,-1.42,6137,6429,1399-8-11
293,وارس,سرمايه گذاري ارس صبا,268,1066145,76056380424,72411,70240,74583,2172,3.0,71338,-1073,-1.48,70239,74583,1399-8-11
294,تسه9904,امتياز تسهيلات مسكن تير99,259,2731,2288610594,864970,821722,830000,-34970,-4.04,838012,-26958,-3.12,821722,908218,1399-8-11
295,شاملاح,ح . معدني‌ املاح‌  ايران‌,254,173615,9351647350,58500,54530,53010,-5490,-9.38,53860,-4640,-7.93,52710,57490,1399-8-11
296,ضصاد8014,اختيارخ وبصادر-3200-1399/08/11,254,11177,286398000,155,100,1,-154,-99.35,26,-129,-83.23,1,100,1399-8-11
297,وآفري,بيمه كارآفرين,253,2592357,41286879152,15985,16464,15506,-479,-3.0,15926,-59,-0.37,15506,16464,1399-8-11
298,ساروم,سيمان‌اروميه‌,252,755814,16598096040,23060,22300,21910,-1150,-4.99,22670,-390,-1.69,21910,22460,1399-8-11
299,لوتوس,تامين سرمايه لوتوس پارسيان,248,1321813,18422314330,14530,14570,13810,-720,-4.96,14310,-220,-1.51,13810,14570,1399-8-11
300,شدوص,دوده‌ صنعتي‌ پارس‌,244,647720,12794872130,20300,20400,19540,-760,-3.74,20150,-150,-0.74,19290,20400,1399-8-11
301,تسه9906,امتياز تسهيلات مسكن شهريور99,242,2868,2418297617,887477,843104,843104,-44373,-5.0,843200,-44277,-4.99,843104,850000,1399-8-11
302,دامين,داروسازي‌ امين‌,241,940359,11118014880,12330,12000,11720,-610,-4.95,12210,-120,-0.97,11720,12220,1399-8-11
303,دسبحان,سبحان دارو,239,475932,7793047680,17220,16430,16360,-860,-4.99,17080,-140,-0.81,16360,17000,1399-8-11
304,تسه9903,امتياز تسهيلات مسكن خرداد99,236,3846,3191570609,869356,825889,830010,-39346,-4.53,829842,-39514,-4.55,825889,859998,1399-8-11
305,وسرمد,بيمه  سرمد,236,1506330,8639852264,5722,5850,5651,-71,-1.24,5728,6,0.1,5631,5890,1399-8-11
306,بخاور,بيمه زندگي خاورميانه,232,921821,6738437621,7575,7251,7276,-299,-3.95,7538,-37,-0.49,7201,7619,1399-8-11
307,پخش,پخش البرز,232,628223,18448664659,30722,32230,29190,-1532,-4.99,30216,-506,-1.65,29186,32230,1399-8-11
308,ولصنم,ليزينگ‌صنعت‌ومعدن‌,232,1292970,9369614260,7590,7280,7220,-370,-4.87,7520,-70,-0.92,7220,7400,1399-8-11
309,آساس,صندوق س.آسمان آرماني سهام-س,230,124048,18394093317,150294,151990,147102,-3192,-2.12,148282,-2012,-1.34,146790,151990,1399-8-11
310,شپلي,پلي اكريل ايران,230,2095130,12538956496,6159,6010,5975,-184,-2.99,6046,-113,-1.83,5975,6090,1399-8-11
311,فزرين,زرين معدن آسيا,227,1027088,18543229294,18966,18300,18018,-948,-5.0,18596,-370,-1.95,18018,18500,1399-8-11
312,آبين,كشت و صنعت آبشيرين,227,2686793,9259125296,3552,3446,3446,-106,-2.98,3500,-52,-1.46,3446,3500,1399-8-11
313,بموتو,موتوژن‌,222,558541,23834762390,44900,43100,42660,-2240,-4.99,43780,-1120,-2.49,42660,44890,1399-8-11
314,وسبوشهر,شركت س استان بوشهر,222,2520135,3287324050,1260,1300,1320,60,4.76,1260,0,0.0,1270,1320,1399-8-11
315,تاپكيشح,ح.تجارت الكترونيك پارسيان كيش,220,1209445,8460373772,6710,6710,7045,335,4.99,6995,285,4.25,6710,7045,1399-8-11
316,قهكمت,قندهكمتان‌,218,175728,7276157660,42480,43000,42000,-480,-1.13,42320,-160,-0.38,40750,43000,1399-8-11
317,قپيرا,فرآورده‌هاي‌غدايي‌وقندپيرانشهر,218,458920,39607471900,82210,86320,86320,4110,5.0,85290,3080,3.75,83000,86320,1399-8-11
318,حسينا,توسعه خدمات دريايي وبندري سينا,217,414551,23375130585,59083,57030,56370,-2713,-4.59,57800,-1283,-2.17,56129,57899,1399-8-11
319,دتوزيع,توزيع دارو پخش,216,338197,13413664516,41733,39647,39647,-2086,-5.0,41135,-598,-1.43,39647,40000,1399-8-11
320,اوان,مبين وان كيش,216,544308,26458061321,49661,50550,49600,-61,-0.12,49109,-552,-1.11,47334,50551,1399-8-11
321,سباقر,سيمان باقران,215,1505987,22195755488,15189,14734,14734,-455,-3.0,14738,-451,-2.97,14734,15000,1399-8-11
322,ما,بيمه  ما,211,5826477,35193125450,6240,6520,5930,-310,-4.97,6100,-140,-2.24,5930,6520,1399-8-11
323,دلر,داروسازي‌ اكسير,211,166550,16667719160,104540,104980,99330,-5210,-4.98,103000,-1540,-1.47,99320,104980,1399-8-11
324,غمارگ,مارگارين‌,211,890710,21592436770,25510,24240,24240,-1270,-4.98,24910,-600,-2.35,24240,25000,1399-8-11
325,دكوثر,داروسازي‌ كوثر,209,794024,15116412210,20020,19030,19020,-1000,-5.0,19710,-310,-1.55,19020,19600,1399-8-11
326,كفرا,فراورده‌ هاي‌ نسوزايران‌,209,164108,7629559600,48890,47000,46450,-2440,-4.99,48510,-380,-0.78,46450,47000,1399-8-11
327,دمعيار,صندوق س. توازن معيار-د,204,8308155,83088303048,10009,10010,10000,-9,-0.09,10001,-8,-0.08,10000,10015,1399-8-11
328,اتكاي,بيمه اتكايي ايرانيان,203,901784,11427548561,12642,12999,12640,-2,-0.02,12649,7,0.06,12200,12999,1399-8-11
329,غبهنوش,بهنوش‌ ايران‌,201,226410,13031311690,60340,62970,57360,-2980,-4.94,59560,-780,-1.29,57330,62970,1399-8-11
330,دابور,داروسازي‌ ابوريحان‌,201,394565,16341582850,42650,40530,42020,-630,-1.48,42230,-420,-0.98,40520,42400,1399-8-11
331,درازك,دارويي‌ رازك‌,199,346311,10798354430,32660,31360,31070,-1590,-4.87,32320,-340,-1.04,31030,31800,1399-8-11
332,كرمان,س. توسعه و عمران استان كرمان,197,291880,22546562480,81311,77246,77246,-4065,-5.0,79381,-1930,-2.37,77246,77246,1399-8-11
333,آكورد,صندوق س. آرمان آتي كوثر-د,195,3448318,100519232255,29132,29145,29154,22,0.08,29150,18,0.06,29145,29300,1399-8-11
334,فيروزا,صندوق بادرآمد ثابت فيروزه آسيا,194,3841883,80789670139,21145,21130,21000,-145,-0.69,21029,-116,-0.55,20990,21218,1399-8-11
335,سكرما,سيمان‌ كرمان‌,193,1425397,19109815750,14090,13880,13690,-400,-2.84,13810,-280,-1.99,13390,14200,1399-8-11
336,وآيند,بانك  آينده,191,1372415,37826502230,28124,27562,27562,-562,-2.0,27904,-220,-0.78,27562,27562,1399-8-11
337,ورنا,سرمايه‌گذاري‌ رنا(هلدينگ‌,188,2977175,26050281250,9210,8750,8750,-460,-4.99,8950,-260,-2.82,8750,8750,1399-8-11
338,ضصاد8012,اختيارخ وبصادر-2800-1399/08/11,184,5312,1602539000,514,401,300,-214,-41.63,302,-212,-41.25,230,401,1399-8-11
339,ضپاس1003,اختيارخ وپارس-3500-1399/10/30,183,7917,3623659000,482,510,400,-82,-17.01,458,-24,-4.98,400,510,1399-8-11
340,ضشنا1035,اختيارخ شپنا-14000-1399/10/23,179,6027,13703761000,2901,2751,2120,-781,-26.92,2274,-627,-21.61,2120,2970,1399-8-11
341,بكاب,صنايع‌جوشكاب‌يزد,179,275993,45351169760,156500,164320,164320,7820,5.0,162960,6460,4.13,164320,164320,1399-8-11
342,قصفها,قنداصفهان‌,178,90819,13869012230,160280,152270,152270,-8010,-5.0,157970,-2310,-1.44,152270,160000,1399-8-11
343,وساپا,سرمايه‌گذاري‌ سايپا,172,774067,6711160890,9120,8670,8670,-450,-4.93,9050,-70,-0.77,8670,8670,1399-8-11
344,غدام,خوراك‌  دام‌ پارس‌,171,104493,23691697890,215940,226730,226730,10790,5.0,220680,4740,2.2,226730,226730,1399-8-11
345,وصنا,گروه‌صنايع‌بهشهرايران‌,171,1798050,19293076500,11290,10730,10730,-560,-4.96,11060,-230,-2.04,10730,10730,1399-8-11
346,غصينو,صنعتي مينو,167,1544058,58759127190,33533,38055,38055,4522,13.49,37575,4042,12.05,38055,38055,1399-8-11
347,كيميا,معدني كيمياي زنجان گستران,166,509928,11089233326,22850,22020,21708,-1142,-5.0,22586,-264,-1.16,21708,22040,1399-8-11
348,پارسيان,بيمه پارسيان,164,1850036,20953540230,11830,12000,11240,-590,-4.99,11620,-210,-1.78,11240,12010,1399-8-11
349,ضصاد8011,اختيارخ وبصادر-2600-1399/08/11,159,6133,3068073000,707,505,500,-207,-29.28,500,-207,-29.28,452,680,1399-8-11
350,لابسا,آبسال‌,159,264206,8032067650,31980,30510,30390,-1590,-4.97,31710,-270,-0.84,30390,31800,1399-8-11
351,اميد,تامين سرمايه اميد,157,1589906,18133125930,11960,11600,11370,-590,-4.93,11740,-220,-1.84,11370,11600,1399-8-11
352,اخزا815,اسنادخزانه-م15بودجه98-010406,156,309930,227346617035,730274,730274,739999,9725,1.33,733542,3268,0.45,730000,739999,1399-8-11
353,فپنتا,سپنتا,156,50862,19043241420,356590,374410,374410,17820,5.0,362940,6350,1.78,374410,374410,1399-8-11
354,سكه0112پ03,سكه تمام بهارتحويلي1روزه سامان,156,48800,61340592800,1238414,1270000,1250000,11586,0.94,1256979,18565,1.5,1242687,1280000,1399-8-11
355,فسرب,ملي‌ سرب‌وروي‌ ايران‌,155,97490,11494399460,122960,122940,116820,-6140,-4.99,121690,-1270,-1.03,116820,122940,1399-8-11
356,داسوه,داروسازي‌ اسوه‌,154,336979,8561901940,26270,25350,25000,-1270,-4.83,26120,-150,-0.57,25000,26270,1399-8-11
357,تسه9810,امتياز تسهيلات مسكن دي98,152,2813,2335216067,873774,830086,830086,-43688,-5.0,830151,-43623,-4.99,830086,873771,1399-8-11
358,مفاخر,توسعه فناوري اطلاعات خوارزمي,149,206223,9251056005,47072,44719,44719,-2353,-5.0,46635,-437,-0.93,44719,47000,1399-8-11
359,ضصاد8013,اختيارخ وبصادر-3000-1399/08/11,144,4278,510103000,333,101,96,-237,-71.17,119,-214,-64.26,85,200,1399-8-11
360,سبجنو,سيمان‌ بجنورد,144,265354,8226513040,31010,32460,30700,-310,-1.0,31010,0,0.0,30030,32460,1399-8-11
361,وسيزد,شركت س استان يزد,142,1976090,2647960600,1280,1340,1340,60,4.69,1280,0,0.0,1340,1340,1399-8-11
362,خفولا,خدمات فني فولاد يزد,142,374886,9564405160,26812,25500,25472,-1340,-5.0,26151,-661,-2.47,25472,26800,1399-8-11
363,كدما,معدني‌ دماوند,142,38924,8295872120,202990,213130,213130,10140,5.0,204520,1530,0.75,213130,213130,1399-8-11
364,زپارس,ملي كشت و صنعت و دامپروري پارس,142,106897,6533946950,63480,61000,60460,-3020,-4.76,63160,-320,-0.5,60310,62890,1399-8-11
365,وگستر,گسترش سرمايه گذاري ايرانيان,142,309831,6160679604,20930,19884,19884,-1046,-5.0,20788,-142,-0.68,19884,19884,1399-8-11
366,سبهان,سيمان‌ بهبهان‌,139,61891,3420589160,57460,55710,54850,-2610,-4.54,57300,-160,-0.28,54590,57490,1399-8-11
367,غشهداب,كشت و صنعت شهداب ناب خراسان,137,692553,3234222510,4915,4670,4670,-245,-4.98,4898,-17,-0.35,4670,4670,1399-8-11
368,لسرما,سرما آفرين‌,137,519876,15263559360,27970,29360,29360,1390,4.97,28370,400,1.43,29360,29360,1399-8-11
369,كمرجان,بازرگاني و توليدي مرجان كار,136,337647,18645204987,52592,55221,55221,2629,5.0,53521,929,1.77,55221,55221,1399-8-11
370,ثزاگرس,سرمايه گذاري توسعه عمران زاگرس,133,182900,6943066900,36856,37961,37961,1105,3.0,37224,368,1.0,37961,37961,1399-8-11
371,پرداخت,به پرداخت ملت,131,141794,5998226630,43750,41590,44000,250,0.57,43570,-180,-0.41,41570,44000,1399-8-11
372,سهگمت,سيمان‌هگمتان‌,130,383067,7309433550,20000,19040,19100,-900,-4.5,19860,-140,-0.7,19000,19600,1399-8-11
373,كلوند,كاشي‌ الوند,129,763192,14649687870,20200,19200,19190,-1010,-5.0,19870,-330,-1.63,19190,19700,1399-8-11
374,شصفها,پتروشيمي‌ اصفهان‌,126,276846,24630510067,90304,92109,88498,-1806,-2.0,88968,-1336,-1.48,88498,92109,1399-8-11
375,ضچاد1014,اختيارخ كچاد-14000-1399/10/02,126,1914,4778918000,2838,2207,2300,-538,-18.96,2497,-341,-12.02,2202,2950,1399-8-11
376,تسه9901,امتياز تسهيلات مسكن فروردين99,125,2758,2304368822,860098,817094,830000,-30098,-3.5,835522,-24576,-2.86,817094,890000,1399-8-11
377,ثنوسا,نوسازي‌وساختمان‌تهران‌,124,1966053,16396882020,8770,8340,8340,-430,-4.9,8610,-160,-1.82,8340,8340,1399-8-11
378,اخزا808,اسنادخزانه-م8بودجه98-000817,124,101614,85610012170,840980,840000,847600,6620,0.79,842502,1522,0.18,839351,848000,1399-8-11
379,بذر,صندوق س بذر اميد آفرين-سهام,124,91120,9081855970,103860,102970,98880,-4980,-4.79,99670,-4190,-4.03,98860,102970,1399-8-11
380,تسه9709,امتياز تسهيلات مسكن آذر97,122,1299,1075502951,865142,822030,822088,-43054,-4.98,827947,-37195,-4.3,821899,849998,1399-8-11
381,وپخش,داروپخش‌ (هلدينگ‌,122,99694,10942839090,115460,112000,109690,-5770,-5.0,114120,-1340,-1.16,109690,114890,1399-8-11
382,غشهد,شهد ايران ‌,121,647649,3924899390,6370,6060,6060,-310,-4.87,6340,-30,-0.47,6060,6080,1399-8-11
383,اخزا817,اسنادخزانه-م17بودجه98-010512,121,281164,202017101642,715707,715010,720999,5292,0.74,718503,2796,0.39,714520,720999,1399-8-11
384,شجم,صنايع پتروشيمي تخت جمشيد,115,1379384,10902461032,8142,7898,7898,-244,-3.0,8016,-126,-1.55,7898,8100,1399-8-11
385,هبركت912,اختيارف ت بركت-22100-99/12/17,115,222063,1447850760,7028,6520,6520,-508,-7.23,6520,-508,-7.23,6520,6520,1399-8-11
386,تسه9711,امتياز تسهيلات مسكن بهمن 97,115,1154,967265656,876456,832666,833000,-43456,-4.96,838185,-38271,-4.37,832634,849998,1399-8-11
387,سهرمز,سيمان‌هرمزگان‌,114,381088,5927619440,16320,15530,15510,-810,-4.96,16220,-100,-0.61,15510,15950,1399-8-11
388,سپاها,سيمان‌سپاهان‌,111,286881,2340948960,8580,8160,8160,-420,-4.9,8560,-20,-0.23,8160,8160,1399-8-11
389,ساذريح,ح . آذريت‌,111,1092548,6461189528,6077,5895,5895,-182,-2.99,5914,-163,-2.68,5895,6190,1399-8-11
390,دماوند,توليد نيروي برق دماوند,110,45952,3178545792,72811,69171,69171,-3640,-5.0,72659,-152,-0.21,69171,69171,1399-8-11
391,ساينا,صنايع بهداشتي ساينا,110,33579,5584768994,174554,165827,165827,-8727,-5.0,173573,-981,-0.56,165827,170550,1399-8-11
392,سدبير,س. تدبيرگران فارس وخوزستان,110,356137,11147800374,29812,31302,31302,1490,5.0,30126,314,1.05,31302,31302,1399-8-11
393,ددام,داروسازي زاگرس فارمد پارس,109,730737,9383447050,13510,12870,12840,-670,-4.96,13380,-130,-0.96,12840,12900,1399-8-11
394,شيران,س. صنايع‌شيميايي‌ايران,107,174776,5652255840,34040,32340,32340,-1700,-4.99,33940,-100,-0.29,32340,32340,1399-8-11
395,سمتاز,سيمان ممتازان كرمان,106,164193,3572789686,21511,22156,22156,645,3.0,21555,44,0.2,20950,22156,1399-8-11
396,خكار,ايركا پارت صنعت,105,155944,4817110160,34320,30890,30890,-3430,-9.99,33950,-370,-1.08,30890,30890,1399-8-11
397,ضصاد8008,اختيارخ وبصادر-2000-1399/08/11,104,2557,2817228000,1312,1227,1100,-212,-16.16,1102,-210,-16.01,1020,1250,1399-8-11
398,فخاس,فولاد خراسان,103,287692,9215832000,33660,33310,31980,-1680,-4.99,33500,-160,-0.48,31980,33310,1399-8-11
399,وثخوز,سرمايه گذاري و توسعه خوزستان,102,132510,4359050212,33696,32686,32686,-1010,-3.0,33515,-181,-0.54,32686,34300,1399-8-11
400,وتوشه,سرمايه‌ گذاري‌ پارس‌ توشه‌,102,279740,5306326660,19920,19050,18930,-990,-4.97,19810,-110,-0.55,18930,19700,1399-8-11
401,قنيشا,قند  نيشابور,101,87764,7457307080,94410,84970,84970,-9440,-10.0,92840,-1570,-1.66,84970,84970,1399-8-11
402,سپاس,صندوق س. پاداش سهامداري توسعه1,101,2797475,28393611850,10148,10150,10150,2,0.02,10150,2,0.02,10141,10150,1399-8-11
403,شراز,پالايش نفت شيراز,101,39695,3677116210,97451,99600,92579,-4872,-5.0,97070,-381,-0.39,92579,99600,1399-8-11
404,ضغدر1119,اختيارخ وغدير-10000-1399/11/26,100,3702,10645141000,3365,3000,2550,-815,-24.22,2876,-489,-14.53,2510,3240,1399-8-11
405,مداران,داده‌پردازي‌ايران‌,100,792490,18078610910,23990,23900,22800,-1190,-4.96,23530,-460,-1.92,22800,23900,1399-8-11
406,تشتاد,صنايع توليدي اشتاد ايران‌,97,321688,4544486376,14563,14127,14127,-436,-2.99,14459,-104,-0.71,14127,14127,1399-8-11
407,بهپاك,صنعتي بهپاك,97,118335,3630926970,32297,30683,30683,-1614,-5.0,32170,-127,-0.39,30683,30700,1399-8-11
408,كي بي سي,شركت كي بي سي,96,444094,13931549780,33021,31370,31370,-1651,-5.0,32533,-488,-1.48,31370,31690,1399-8-11
409,تسه9803,امتياز تسهيلات مسكن خرداد98,93,1205,999343534,864241,822000,830000,-34241,-3.96,829331,-34910,-4.04,821029,850000,1399-8-11
410,وسناح,ح. سرمايه گذاري نيروگاهي ايران,93,266417,2939238547,11137,11471,10803,-334,-3.0,11032,-105,-0.94,10803,11471,1399-8-11
411,شفا,سرمايه گذاري شفادارو,91,37343,2151171930,60590,59990,57570,-3020,-4.98,60450,-140,-0.23,57570,59990,1399-8-11
412,تسه9708,امتياز تسهيلات مسكن آبان97,91,1150,934832832,855681,812910,812897,-42784,-5.0,812898,-42783,-5.0,812897,813000,1399-8-11
413,تسه9710,امتياز تسهيلات مسكن دي 97,91,499,422476748,866724,825030,826001,-40723,-4.7,846647,-20077,-2.32,825030,879958,1399-8-11
414,دفرا,فرآورده‌هاي‌ تزريقي‌ ايران‌,90,598226,13945631100,24410,24410,23200,-1210,-4.96,24090,-320,-1.31,23190,24410,1399-8-11
415,دسبحا,گروه دارويي سبحان,90,197035,3175189580,16940,16350,16100,-840,-4.96,16880,-60,-0.35,16100,16350,1399-8-11
416,جوين,كشت و صنعت جوين,89,488829,9327834978,18527,19082,19082,555,3.0,18771,244,1.32,19082,19082,1399-8-11
417,وشمال,س. چشم انداز توسعه شمال,89,81113,8704236030,110628,107310,107310,-3318,-3.0,109132,-1496,-1.35,107310,107310,1399-8-11
418,شپترو,پتروشيمي آبادان,89,1443064,6677057128,4870,4627,4627,-243,-4.99,4784,-86,-1.77,4627,4627,1399-8-11
419,خديزل,بهمن  ديزل,88,241481,10120854756,43308,43308,41143,-2165,-5.0,43002,-306,-0.71,41143,45380,1399-8-11
420,زكشت,كشاورزي مكانيزه اصفهان كشت,87,126898,3561103914,29351,28050,27884,-1467,-5.0,29253,-98,-0.33,27884,28900,1399-8-11
421,فلات,گروه صنايع معادن فلات ايرانيان,87,947725,12000658152,12945,13199,12557,-388,-3.0,12770,-175,-1.35,12557,13199,1399-8-11
422,تسه9811,امتياز تسهيلات مسكن بهمن98,86,784,643961849,855986,813187,813200,-42786,-5.0,821380,-34606,-4.04,813187,835000,1399-8-11
423,هصيكو402,اختيارف ت تاصيكو13500-00/02/20,84,339231,1024138389,3085,3019,3019,-66,-2.14,3019,-66,-2.14,3019,3019,1399-8-11
424,تصميم,صندوق س با درآمد ثابت تصميم,84,2219132,32743674542,14759,14750,14803,44,0.3,14755,-4,-0.03,14740,14849,1399-8-11
425,فنوال,نورد آلومينيوم‌,83,81842,2617307160,35530,31980,31980,-3550,-9.99,35320,-210,-0.59,31980,31980,1399-8-11
426,واحصا,احياء صنايع خراسان,82,233773,4603224143,19118,19691,19691,573,3.0,19245,127,0.66,19691,19691,1399-8-11
427,هترول911,اختيارف ت پترول-14730-99/11/15,82,500000,709000000,1931,1418,1418,-513,-26.57,1418,-513,-26.57,1418,1418,1399-8-11
428,ثجوان,تامين مسكن جوانان,82,350950,2174178653,6507,6182,6300,-207,-3.18,6471,-36,-0.55,6182,6598,1399-8-11
429,كاسپين,داروسازي كاسپين تامين,81,163552,3865759655,24879,23636,23636,-1243,-5.0,24775,-104,-0.42,23636,24858,1399-8-11
430,تسه9801,امتياز تسهيلات مسكن فروردين98,80,735,611314125,851753,809166,830000,-21753,-2.55,831720,-20033,-2.35,809166,850000,1399-8-11
431,وهنر,گروه توسعه هنر ايران,80,1703612,7054658722,4258,4300,4131,-127,-2.98,4214,-44,-1.03,4131,4300,1399-8-11
432,شتوكا,توكا رنگ فولاد سپاهان,79,86646,2183230288,26427,25120,25106,-1321,-5.0,26370,-57,-0.22,25106,26106,1399-8-11
433,پيزد,مجتمع صنايع لاستيك يزد,78,9339,890585718,100381,95362,95362,-5019,-5.0,100286,-95,-0.09,95362,95362,1399-8-11
434,هجرت,پخش هجرت,78,171349,9496675627,58339,55423,55423,-2916,-5.0,57749,-590,-1.01,55423,55423,1399-8-11
435,اخزا818,اسنادخزانه-م18بودجه98-010614,78,210055,148456205568,702231,702203,708000,5769,0.82,706749,4518,0.64,701012,709923,1399-8-11
436,اخزا809,اسنادخزانه-م9بودجه98-000923,76,133818,110393350030,823950,822025,825001,1051,0.13,824951,1001,0.12,822025,827000,1399-8-11
437,سقاين,سيمان‌ قائن‌,75,77938,3000579400,40400,38520,38580,-1820,-4.5,40280,-120,-0.3,38380,39550,1399-8-11
438,سبزوا,سيمان لار سبزوار,74,423792,2555889552,6348,6031,6031,-317,-4.99,6331,-17,-0.27,6031,6031,1399-8-11
439,غمهرا,توليدي‌مهرام‌,73,12943,614217310,49700,49700,48380,-1320,-2.66,49670,-30,-0.06,47220,49700,1399-8-11
440,كخاك,صنايع‌خاك‌چيني‌ايران‌,73,50682,2415729180,49650,51000,47170,-2480,-4.99,49550,-100,-0.2,47170,51000,1399-8-11
441,سنوين,سرمايه گذاري اقتصاد نوين,73,668967,6775587654,10053,10154,10154,101,1.0,10104,51,0.51,9866,10249,1399-8-11
442,شلعاب,لعابيران‌,72,387134,3042873240,8270,7860,7860,-410,-4.96,8240,-30,-0.36,7860,7860,1399-8-11
443,سفانو,سيمان فارس نو,72,326702,9699782380,31250,29690,29690,-1560,-4.99,30930,-320,-1.02,29690,29690,1399-8-11
444,كماسه,تامين‌ ماسه‌ ريخته‌گري‌,72,69703,3528365860,53280,50620,50620,-2660,-4.99,53080,-200,-0.38,50620,50620,1399-8-11
445,تسه9809,امتياز تسهيلات مسكن آذر98,72,875,719898933,857228,814367,814367,-42861,-5.0,822742,-34486,-4.02,814367,839000,1399-8-11
446,خصدرا,صنعتي‌ دريايي‌ ايران‌,71,247127,1385393962,5779,5606,5606,-173,-2.99,5775,-4,-0.07,5606,5606,1399-8-11
447,فرآور,فرآوري‌موادمعدني‌ايران‌,70,290945,6162671300,22290,21180,21180,-1110,-4.98,22140,-150,-0.67,21180,21450,1399-8-11
448,دسانكو,داروسازي سبحان انكولوژي,70,382499,5743030475,15792,15050,15003,-789,-5.0,15695,-97,-0.61,15003,15400,1399-8-11
449,شكف,كف,69,443745,33987317040,75091,76592,76592,1501,2.0,76592,1501,2.0,76592,76592,1399-8-11
450,ولشرق,ليزينگ ايران و شرق,68,1485993,10051256652,7120,6764,6764,-356,-5.0,7044,-76,-1.07,6764,6764,1399-8-11
451,ضفار1125,اختيارخ فارس-17826-1399/11/07,67,1269,1397628000,779,750,470,-309,-39.67,551,-228,-29.27,450,750,1399-8-11
452,تسه9808,امتياز تسهيلات مسكن آبان98,65,1268,1047787636,856363,813545,830000,-26363,-3.08,826331,-30032,-3.51,813545,830000,1399-8-11
453,سدشت,صنايع سيمان دشتستان,64,50761,1921050490,38100,40000,37000,-1100,-2.89,38090,-10,-0.03,36500,40000,1399-8-11
454,مرقام,ايران‌ارقام‌,64,179064,4114890720,24180,22980,22980,-1200,-4.96,24070,-110,-0.45,22980,22980,1399-8-11
455,ونيرو,سرمايه‌گذاري‌نيرو,61,440910,1966458600,4690,4460,4460,-230,-4.9,4680,-10,-0.21,4460,4460,1399-8-11
456,آساميد,صندوق س.مشترك آسمان اميد -د,60,1271422,13877093926,10910,10921,10915,5,0.05,10915,5,0.05,10913,10926,1399-8-11
457,ثعمرا,عمران و توسعه شاهد,59,531116,8929122192,17696,16812,16812,-884,-5.0,17522,-174,-0.98,16812,16812,1399-8-11
458,اخزا814,اسنادخزانه-م14بودجه98-010318,59,72791,54057800727,740586,740591,742250,1664,0.22,742644,2058,0.28,740591,749000,1399-8-11
459,دارو,كارخانجات‌داروپخش‌,59,427602,23342793180,57460,54590,54590,-2870,-4.99,56040,-1420,-2.47,54590,54590,1399-8-11
460,اخزا903,اسنادخزانه-م3بودجه99-011110,59,117388,76266230912,650357,648509,650024,-333,-0.05,649694,-663,-0.1,648000,651900,1399-8-11
461,حفارس,حمل و نقل بين المللي خليج فارس,57,560194,2448047780,4590,4370,4370,-220,-4.79,4580,-10,-0.22,4370,4370,1399-8-11
462,پكويرح,ح. كوير تاير,56,114018,1370783100,11030,12130,12000,970,8.79,12020,990,8.98,12000,12130,1399-8-11
463,تشتادح,ح.صنايع توليدي اشتاد ايران‌,56,103022,1065149958,9756,10341,10339,583,5.98,10339,583,5.98,10338,10341,1399-8-11
464,داوه,داروسازي آوه سينا,56,96027,1517130573,16630,15799,15799,-831,-5.0,16603,-27,-0.16,15799,15799,1399-8-11
465,افران,صندوق س افرا نماد پايدار-ثابت,55,185822,2217842684,11885,11930,11930,45,0.38,11935,50,0.42,11920,11940,1399-8-11
466,خكمك,كمك‌فنرايندامين‌,55,24767,1240826700,55660,50100,50100,-5560,-9.99,55510,-150,-0.27,50100,50100,1399-8-11
467,ولانا,شركت ليزينگ آريا دانا,55,306302,6614929755,22257,21705,21590,-667,-3.0,22028,-229,-1.03,21590,22257,1399-8-11
468,كيان2,صندوق س. با درآمد ثابت كيان,54,5400000,5400000,25723,1,1,-25722,-100.0,1,-25722,-100.0,1,1,1399-8-11
469,خچرخش,چرخشگر,54,127385,2207582050,19250,17330,17330,-1920,-9.97,19160,-90,-0.47,17330,17330,1399-8-11
470,تسه9812,امتياز تسهيلات مسكن اسفند98,53,685,588010961,894245,894245,849533,-44712,-5.0,858410,-35835,-4.01,849533,894248,1399-8-11
471,اخزا806,اسنادخزانه-م6بودجه98-000519,53,134768,118286687691,874297,873782,876304,2007,0.23,877706,3409,0.39,873782,883990,1399-8-11
472,غبشهر,صنعتي‌ بهشهر,52,147123,3319094880,23740,22560,22560,-1180,-4.97,23650,-90,-0.38,22560,22560,1399-8-11
473,اخزا812,اسنادخزانه-م12بودجه98-001111,52,247583,199261163159,803342,802791,805000,1658,0.21,804826,1484,0.18,802791,808914,1399-8-11
474,سشمال,سيمان‌ شمال‌,52,271385,2475181360,9590,9130,9120,-470,-4.9,9570,-20,-0.21,9120,9130,1399-8-11
475,نگين,ص.س. زمين و ساختمان نگين شهرري,51,156228,7812540840,50390,50010,50020,-370,-0.73,50010,-380,-0.75,50000,50200,1399-8-11
476,وبهمن,سرمايه‌گذاري‌بهمن‌,51,576434,7107431220,12970,12330,12330,-640,-4.93,12870,-100,-0.77,12330,12330,1399-8-11
477,خمهر,مهركام‌پارس‌,51,224047,1541443360,7240,6880,6880,-360,-4.97,7230,-10,-0.14,6880,6880,1399-8-11
478,كمنگنز,معادن‌منگنزايران‌,51,101924,9730684280,100490,95470,95470,-5020,-5.0,99430,-1060,-1.05,95470,95470,1399-8-11
479,ضترا1118,اختيارخ شتران-12000-1399/11/14,50,604,1150023000,2692,2110,1800,-892,-33.14,1904,-788,-29.27,1600,2450,1399-8-11
480,اخزا811,اسنادخزانه-م11بودجه98-001013,50,264475,216188045125,814714,813438,819000,4286,0.53,817423,2709,0.33,813438,820000,1399-8-11
481,دپارس,پارس‌ دارو,50,162373,16954988660,109910,104420,104420,-5490,-4.99,107930,-1980,-1.8,104420,104420,1399-8-11
482,وبرق,س.کارکنان صنعت برق زنجان وقزوي,49,11939,2432057873,210007,203707,203707,-6300,-3.0,209205,-802,-0.38,203707,203707,1399-8-11
483,اخزا816,اسنادخزانه-م16بودجه98-010503,49,109562,79315638285,719610,721800,729800,10190,1.42,723934,4324,0.6,718506,730000,1399-8-11
484,شكبير,پتروشيمي اميركبير,47,256193,14611095004,58794,57036,57031,-1763,-3.0,58480,-314,-0.53,57031,57100,1399-8-11
485,وسخراش,شركت س استان خراسان شمالي,46,723693,911853180,1390,1260,1260,-130,-9.35,1390,0,0.0,1260,1260,1399-8-11
486,شبصير,توليدات پتروشيمي قائد بصير,46,45440,4660417280,107959,102562,102562,-5397,-5.0,107403,-556,-0.52,102562,102562,1399-8-11
487,سفار,سيمان‌فارس‌,46,20720,1800568000,91470,86900,86900,-4570,-5.0,91300,-170,-0.19,86900,86900,1399-8-11
488,دتماد,توليدمواداوليه‌داروپخش‌,45,534055,23728063650,46760,44430,44430,-2330,-4.98,45590,-1170,-2.5,44430,44430,1399-8-11
489,ضصاد8010,اختيارخ وبصادر-2400-1399/08/11,45,1003,706985000,836,720,700,-136,-16.27,705,-131,-15.67,680,750,1399-8-11
490,تسه9806,امتياز تسهيلات مسكن شهريور98,45,640,532117066,856696,813862,830000,-26696,-3.12,831433,-25263,-2.95,813862,856696,1399-8-11
491,سرود,سيمان‌شاهرود,45,158026,2172857500,14470,13750,13750,-720,-4.98,14440,-30,-0.21,13750,13750,1399-8-11
492,زعف9908پ14,زعفران9908پوشالمعمول نوين(پ),45,10933,865617517,77384,73515,81253,3869,5.0,79175,1791,2.31,73515,81253,1399-8-11
493,خريخت,صنايع‌ريخته‌گري‌ايران‌,44,1090246,5244083260,5060,4810,4810,-250,-4.94,5030,-30,-0.59,4810,4810,1399-8-11
494,تسه9807,امتياز تسهيلات مسكن مهر98,44,486,401481832,852849,810207,830000,-22849,-2.68,826094,-26755,-3.14,810207,839000,1399-8-11
495,كفپارس,فرآورده‌هاي‌ نسوز پارس‌,43,107974,1005237940,9790,9310,9310,-480,-4.9,9780,-10,-0.1,9310,9310,1399-8-11
496,وملي,گروه‌ صنعتي‌ ملي‌ (هلدينگ‌,42,2326,876273980,396550,376730,376730,-19820,-5.0,396180,-370,-0.09,376730,376730,1399-8-11
497,ضملي1148,اختيارخ فملي-10140-1399/11/05,41,342,1548362000,4999,4500,3810,-1189,-23.78,4527,-472,-9.44,3810,5000,1399-8-11
498,ديران,ايران‌دارو,41,129837,2299413270,18640,17710,17710,-930,-4.99,18590,-50,-0.27,17710,17710,1399-8-11
499,تسه9712,امتياز تسهيلات مسكن اسفند97,40,271,230282864,892677,848044,870000,-22677,-2.54,849752,-42925,-4.81,848044,870000,1399-8-11
500,دفارا,داروسازي‌ فارابي‌,39,253304,16386235760,68090,64690,64690,-3400,-4.99,66910,-1180,-1.73,64690,64690,1399-8-11
501,صنوين,صندوق سرمايه‌گذاري صنوين-مختلط,38,8284,828883470,100420,100010,100020,-400,-0.4,100060,-360,-0.36,100000,100580,1399-8-11
502,تسه9802,امتياز تسهيلات مسكن ارديبهشت98,38,286,240898016,877903,834008,850000,-27903,-3.18,842301,-35602,-4.06,834008,850000,1399-8-11
503,ضفلا8079,اختيارخ فولاد-10775-1399/08/28,37,288,679223000,3068,2800,2050,-1018,-33.18,2358,-710,-23.14,2050,2801,1399-8-11
504,سدور,سيمان‌ دورود,37,76055,580299650,8030,7630,7630,-400,-4.98,8030,0,0.0,7630,7630,1399-8-11
505,كسعدي,كاشي‌ سعدي‌,37,27195,1560449100,60390,57380,57380,-3010,-4.98,60290,-100,-0.17,57380,57380,1399-8-11
506,ضفلا8085,اختيارخ فولاد-16775-1399/08/28,37,268,28946000,287,231,65,-222,-77.35,108,-179,-62.37,30,240,1399-8-11
507,پست9908-02,پسته فندقي32-30طلاسبززرند9908,37,5169,6781499891,1270287,1210001,1310000,39713,3.13,1311956,41669,3.28,1210001,1333801,1399-8-11
508,اخزا810,اسنادخزانه-م10بودجه98-001006,36,112562,92795304462,819259,817234,820000,741,0.09,824393,5134,0.63,817234,827000,1399-8-11
509,ارمغان,ص سرمايه گذاري ارمغان ايرانيان,36,715762,7262628101,10139,10147,10148,9,0.09,10147,8,0.08,10142,10148,1399-8-11
510,بزاگرس,نيروگاه زاگرس كوثر,36,349098,4978137480,15010,14260,14260,-750,-5.0,14930,-80,-0.53,14260,14260,1399-8-11
511,دسينا,داروسازي‌ سينا,36,80186,1987973920,26090,24810,24790,-1300,-4.98,26040,-50,-0.19,24790,25000,1399-8-11
512,ختراك,ريخته‌گري‌ تراكتورسازي‌ ايران‌,36,90292,960706880,11200,10640,10640,-560,-5.0,11190,-10,-0.09,10640,10640,1399-8-11
513,غفارس,شير پاستوريزه پگاه فارس,35,52983,496344744,9861,9368,9368,-493,-5.0,9856,-5,-0.05,9368,9368,1399-8-11
514,الماس,صندوق س.امين تدبيرگران فردا-س,35,10805,1189241179,112078,112080,109900,-2178,-1.94,110064,-2014,-1.8,109900,112080,1399-8-11
515,غچين,كشت‌ و صنعت‌ چين‌ چين,34,26184,1063594080,42750,40620,40620,-2130,-4.98,42700,-50,-0.12,40620,40620,1399-8-11
516,قشهد,شهد,34,119667,3388047800,29780,28300,28300,-1480,-4.97,29680,-100,-0.34,28300,28700,1399-8-11
517,دكيمي,كيميدارو,33,41215,886946800,22650,21520,21520,-1130,-4.99,22630,-20,-0.09,21520,21520,1399-8-11
518,اخزا821,اسنادخزانه-م21بودجه98-020906,33,67586,37962451348,564262,560001,562000,-2262,-0.4,561691,-2571,-0.46,560001,564500,1399-8-11
519,اخزا813,اسنادخزانه-م13بودجه98-010219,33,59220,44897902369,756386,756500,757874,1488,0.2,758154,1768,0.23,756500,770000,1399-8-11
520,هفارس912,اختيارف ت فارس-14576-99/12/13,31,1000000,33000000,1,33,33,32,3200.0,33,32,3200.0,33,33,1399-8-11
521,وگردش,بانك گردشگري,31,246189,4185213000,17044,17000,17000,-44,-0.26,17042,-2,-0.01,17000,17000,1399-8-11
522,اعتلا,شركت سرمايه گذاري اعتلاء البرز,31,447435,4252422240,10004,9504,9504,-500,-5.0,9959,-45,-0.45,9504,9504,1399-8-11
523,هاباد912,اختيارف ت آبادا-30100-99/12/12,31,95405,781462355,8473,8191,8191,-282,-3.33,8191,-282,-3.33,8191,8191,1399-8-11
524,شرنگي,شيميايي رنگين,31,80161,9036389208,116214,112728,112728,-3486,-3.0,114568,-1646,-1.42,112728,112728,1399-8-11
525,ضشنا1036,اختيارخ شپنا-16000-1399/10/23,31,136,242958000,2368,1901,1700,-668,-28.21,1786,-582,-24.58,1700,1901,1399-8-11
526,قاسم,قاسم ايران,30,55747,709324828,13393,12724,12724,-669,-5.0,13383,-10,-0.07,12724,12724,1399-8-11
527,غنوش,نوش‌ مازندران‌,30,40512,2848398720,74010,70310,70310,-3700,-5.0,73790,-220,-0.3,70310,70310,1399-8-11
528,وسكهبو,س.عدالت ا. كهگيلويه وبويراحمد,30,453153,489405240,1130,1080,1080,-50,-4.42,1130,0,0.0,1080,1080,1399-8-11
529,آكورد2,صندوق س. آرمان آتي كوثر-د,30,3000000,3000000,29132,1,1,-29131,-100.0,1,-29131,-100.0,1,1,1399-8-11
530,دشيري,شيرين دارو,28,80984,14231239968,181160,175726,175726,-5434,-3.0,177174,-3986,-2.2,175726,180000,1399-8-11
531,داريك,صندوق س.اعتماد داريك-د,28,417448,4182935581,10046,10021,10020,-26,-0.26,10020,-26,-0.26,10020,10045,1399-8-11
532,قشير,قند شيروان قوچان و بجنورد,27,67581,1561932072,24328,23112,23112,-1216,-5.0,24288,-40,-0.16,23112,23112,1399-8-11
533,اخزا721,اسنادخزانه-م21بودجه97-000728,27,258663,220024058966,847779,847630,853000,5221,0.62,850621,2842,0.34,847630,859990,1399-8-11
534,حخزر,كشتيراني درياي خزر,27,247341,5151237269,21922,20836,20826,-1096,-5.0,21801,-121,-0.55,20826,21139,1399-8-11
535,ضترا8023,اختيارخ شتران-4886-1399/08/11,26,86,806655960,6185,5300,5446,-739,-11.95,5501,-684,-11.06,5300,6100,1399-8-11
536,ثتران,سرمايه گذاري مسكن تهران,26,191828,1021100444,5603,5323,5323,-280,-5.0,5597,-6,-0.11,5323,5323,1399-8-11
537,تملي703,تسهيلات مسكن ب. ملي-خرداد97,26,681,570617391,798011,837911,837911,39900,5.0,837911,39900,5.0,837911,837911,1399-8-11
538,دقاضي,داروسازي شهيد قاضي,26,40223,3623569401,92873,90087,90087,-2786,-3.0,92352,-521,-0.56,90087,90087,1399-8-11
539,اوصتا,صندوق انديشه ورزان صباتامين -د,25,209845,3537725292,16819,16860,16840,21,0.12,16859,40,0.24,16701,16890,1399-8-11
540,كپشير,پشم‌شيشه‌ايران‌,25,301466,5130951320,17910,17020,17020,-890,-4.97,17810,-100,-0.56,17020,17020,1399-8-11
541,ضصاد8000,اختيارخ وبصادر-1200-1399/08/11,25,344,684097000,2164,2200,1900,-264,-12.2,1989,-175,-8.09,1900,2200,1399-8-11
542,ضملي1153,اختيارخ فملي-20280-1399/11/05,25,526,286155000,735,650,550,-185,-25.17,544,-191,-25.99,450,650,1399-8-11
543,تماوند,تامين سرمايه دماوند,25,66513,1016119101,16081,15277,15277,-804,-5.0,16038,-43,-0.27,15277,15277,1399-8-11
544,وتعاون,بيمه  تعاون,25,214244,1296818932,6240,6053,6053,-187,-3.0,6227,-13,-0.21,6053,6053,1399-8-11
545,وملت,سرمايه گذاري ملت,24,54726,283918488,5293,5188,5188,-105,-1.98,5290,-3,-0.06,5188,5188,1399-8-11
546,ضسپا8016,اختيارخ خساپا-2000-1399/08/26,24,152,68785000,499,450,480,-19,-3.81,453,-46,-9.22,403,480,1399-8-11
547,وتوس,توسعه‌شهري‌توس‌گستر,24,47826,1545736320,34020,32320,32320,-1700,-5.0,33960,-60,-0.18,32320,32320,1399-8-11
548,سخند,صندوق س.سپهرخبرگان نفت-د,24,88400,896256040,10126,10110,10125,-1,-0.01,10139,13,0.13,10110,10140,1399-8-11
549,تسه9804,امتياز تسهيلات مسكن تير98,23,327,273242142,858036,850000,830000,-28036,-3.27,835603,-22433,-2.61,815135,858036,1399-8-11
550,زعف9908پ17,زعفران9908پوشالمعمول بيرجند(پ),23,15701,1164369231,71810,73515,73515,1705,2.37,74159,2349,3.27,73515,81252,1399-8-11
551,آ س پ,آ.س.پ,23,147270,1688597820,12069,11466,11466,-603,-5.0,12046,-23,-0.19,11466,11466,1399-8-11
552,شساخت,مهندسي و ساختمان صنايع نفت,23,15562,598483396,40482,38458,38458,-2024,-5.0,40451,-31,-0.08,38458,38458,1399-8-11
553,شكربن,كربن‌ ايران‌,23,112897,8262931430,77040,73190,73190,-3850,-5.0,76360,-680,-0.88,73190,73190,1399-8-11
554,ميهن,بيمه ميهن,23,171881,859748762,5265,5002,5002,-263,-5.0,5260,-5,-0.09,5002,5002,1399-8-11
555,غپونه,نوش پونه مشهد,23,58355,918566055,16227,15741,15741,-486,-3.0,16204,-23,-0.14,15741,15741,1399-8-11
556,دجابر,داروسازي‌ جابرابن‌حيان‌,23,11435,412346100,37950,36060,36060,-1890,-4.98,37930,-20,-0.05,36060,36060,1399-8-11
557,اتكام,شركت بيمه اتكايي امين,22,45134,346177780,8073,7670,7670,-403,-4.99,8070,-3,-0.04,7670,7670,1399-8-11
558,شاملا,معدني‌ املاح‌  ايران‌,22,225990,15078052800,70230,66720,66720,-3510,-5.0,69110,-1120,-1.59,66720,66720,1399-8-11
559,فلوله,لوله‌وماشين‌سازي‌ايران‌,22,45679,992604670,22870,21730,21730,-1140,-4.98,22850,-20,-0.09,21730,21730,1399-8-11
560,بميلا,توسعه بازرگاني آهن وفولادميلاد,21,429402,7756717728,18622,18064,18064,-558,-3.0,18396,-226,-1.21,18064,18064,1399-8-11
561,زعف9908پ13,زعفران9908پوشالمعمول روستا(پ),21,5288,407430700,72759,73515,73515,756,1.04,77048,4289,5.89,73515,81000,1399-8-11
562,كابگن,توليدي و صنعتي آبگينه‌,21,248248,1196307112,4772,4819,4819,47,0.98,4783,11,0.23,4819,4819,1399-8-11
563,ضصاد8009,اختيارخ وبصادر-2200-1399/08/11,20,618,561730000,1136,902,900,-236,-20.77,909,-227,-19.98,880,990,1399-8-11
564,ضصاد1107,اختيارخ وبصادر-7000-1399/11/12,20,1238,119796000,120,71,110,-10,-8.33,97,-23,-19.17,71,120,1399-8-11
565,خاذين,سايپاآذين‌,20,233008,1584454400,7150,6800,6800,-350,-4.9,7140,-10,-0.14,6800,6800,1399-8-11
566,تسه9905,امتياز تسهيلات مسكن مرداد99,20,448,379737792,892241,847629,847629,-44612,-5.0,847629,-44612,-5.0,847629,847629,1399-8-11
567,زر2,صندوق س.پشتوانه سكه طلاي زر,20,2000000,2000000,49144,1,1,-49143,-100.0,1,-49143,-100.0,1,1,1399-8-11
568,ثروتم,صندوق س. ثروت آفرين پارسيان-س,20,11400,1030496000,91412,91010,90000,-1412,-1.54,90394,-1018,-1.11,89500,91010,1399-8-11
569,كگاز,شيشه‌ و گاز,19,19512,465751440,25120,23870,23870,-1250,-4.98,25110,-10,-0.04,23870,23870,1399-8-11
570,وكادو,تكادو,19,35190,578277270,16941,16433,16433,-508,-3.0,16925,-16,-0.09,16433,16433,1399-8-11
571,زعف9908پ06,زعفران 9908پوشالمعمول زرين(پ),19,6297,485566159,77526,73515,73515,-4011,-5.17,77111,-415,-0.54,73515,81251,1399-8-11
572,غپاك,لبنيات‌ پاك‌,19,31529,389067860,12980,12340,12340,-640,-4.93,12970,-10,-0.08,12340,12340,1399-8-11
573,اخزا804,اسنادخزانه-م4بودجه98-000421,18,21117,18750040125,887446,887859,887900,454,0.05,887912,466,0.05,887859,888000,1399-8-11
574,ولملت,واسپاري ملت,18,129678,1418677320,11510,10940,10940,-570,-4.95,11490,-20,-0.17,10940,10940,1399-8-11
575,فنورد,نوردوقطعات‌ فولادي‌,18,51500,7860445000,145370,152630,152630,7260,4.99,146450,1080,0.74,152630,152630,1399-8-11
576,وسين,بيمه سينا,18,41820,822139380,20267,19659,19659,-608,-3.0,20241,-26,-0.13,19659,19659,1399-8-11
577,جهرم,پتروشيمي جهرم,17,257611,807352874,3298,3134,3134,-164,-4.97,3291,-7,-0.21,3134,3134,1399-8-11
578,شتولي,تولي‌پرس‌,17,54796,1234225104,22083,22524,22524,441,2.0,22136,53,0.24,22524,22524,1399-8-11
579,خشرق,الكتريك‌ خودرو شرق‌,17,32219,616349470,20130,19130,19130,-1000,-4.97,20120,-10,-0.05,19130,19130,1399-8-11
580,ساراب,سيمان‌ داراب‌,17,36269,414191980,12020,11420,11420,-600,-4.99,12010,-10,-0.08,11420,11420,1399-8-11
581,كصدف,كاشي صدف سرام استقلال آباده,17,111544,2172542488,18910,19477,19477,567,3.0,18970,60,0.32,19477,19477,1399-8-11
582,اخزا902,اسنادخزانه-م2بودجه99-011019,17,88643,58393884993,658113,658202,658306,193,0.03,658753,640,0.1,658201,660000,1399-8-11
583,ضصاد8001,اختيارخ وبصادر-1300-1399/08/11,17,274,513438000,2061,2100,1800,-261,-12.66,1874,-187,-9.07,1711,2100,1399-8-11
584,غدشت,دشت‌ مرغاب‌,16,1359,366101010,283560,269390,269390,-14170,-5.0,283450,-110,-0.04,269390,269390,1399-8-11
585,اخزا820,اسنادخزانه-م20بودجه98-020806,16,31184,18046067084,569938,570000,578999,9061,1.59,578696,8758,1.54,570000,579000,1399-8-11
586,خمحور,توليدمحورخودرو,16,101029,5660654870,58970,56030,56030,-2940,-4.99,58620,-350,-0.59,56030,56030,1399-8-11
587,ضچاد1015,اختيارخ كچاد-16000-1399/10/02,16,201,386290000,2144,2000,1730,-414,-19.31,1922,-222,-10.35,1720,2050,1399-8-11
588,ضترا8031,اختيارخ شتران-8701-1399/08/11,16,99,305433700,2129,2000,1900,-229,-10.76,1809,-320,-15.03,1750,2400,1399-8-11
589,تكنار,مجتمع معادن مس تكنار,16,5650,539648450,98466,95513,95513,-2953,-3.0,98384,-82,-0.08,95513,95513,1399-8-11
590,تبرك,گروه كارخانجات صنعتي تبرك,16,65414,1737330426,27956,26559,26559,-1397,-5.0,27905,-51,-0.18,26559,26559,1399-8-11
591,ضچاد1012,اختيارخ كچاد-10000-1399/10/02,15,40,226941000,5846,5500,5750,-96,-1.64,5674,-172,-2.94,5200,6200,1399-8-11
592,گپارس,امور رفاهي كارگزاران پارس,15,8183,1070688269,127033,130843,130843,3810,3.0,127230,197,0.16,130843,130843,1399-8-11
593,ضترا8028,اختيارخ شتران-6941-1399/08/11,15,28,167951025,4000,3506,3520,-480,-12.0,3518,-482,-12.05,3506,3650,1399-8-11
594,وساربيل,شركت س استان اردبيل,15,233626,285023720,1280,1220,1220,-60,-4.69,1280,0,0.0,1220,1220,1399-8-11
595,تسه9805,امتياز تسهيلات مسكن مرداد98,15,286,243789151,897013,852163,852163,-44850,-5.0,852410,-44603,-4.97,852163,860000,1399-8-11
596,خاور,ايران خودرو ديزل,15,31906,204198400,6597,6400,6400,-197,-2.99,6595,-2,-0.03,6400,6400,1399-8-11
597,بمپنا,توليد برق عسلويه  مپنا,15,4535,358373840,83183,79024,79024,-4159,-5.0,83152,-31,-0.04,79024,79024,1399-8-11
598,آسام,صندوق س.آرمان سپهر آشنا-م,15,5960,574820290,98233,96005,96999,-1234,-1.26,96446,-1787,-1.82,94002,98970,1399-8-11
599,فجام,جام‌دارو,15,5785,287919450,52380,49770,49770,-2610,-4.98,52360,-20,-0.04,49770,49770,1399-8-11
600,خوساز,محورسازان‌ايران‌خودرو,15,21864,191091360,9190,8740,8740,-450,-4.9,9190,0,0.0,8740,8740,1399-8-11
601,شپاس,نفت پاسارگاد,14,84377,1835706012,22901,21756,21756,-1145,-5.0,22856,-45,-0.2,21756,21756,1399-8-11
602,طمخا7070,اختيارف اخابر-20000-1400/07/28,14,27,57300000,2000,2500,2100,100,5.0,2122,122,6.1,2100,2500,1399-8-11
603,فولاي,صنايع فولاد آلياژي يزد,14,21701,1070879247,51944,49347,49347,-2597,-5.0,51885,-59,-0.11,49347,49347,1399-8-11
604,پسهند,صنايع‌ لاستيكي‌  سهند,14,113145,5513555850,51290,48730,48730,-2560,-4.99,50990,-300,-0.58,48730,48730,1399-8-11
605,سايرا,ايرانيت‌,14,6443,232555330,36045,36150,36160,115,0.32,36046,1,0.0,36000,36160,1399-8-11
606,نطرين,عطرين نخ قم,13,49566,753502332,16002,15202,15202,-800,-5.0,15989,-13,-0.08,15202,15202,1399-8-11
607,شستا991,اجاره تامين اجتماعي-امين991226,13,387,389944286,1012148,990099,1000000,-12148,-1.2,1007608,-4540,-0.45,990099,1019990,1399-8-11
608,دكپسول,توليد ژلاتين كپسول ايران,13,138236,4757115468,36224,34413,34413,-1811,-5.0,36042,-182,-0.5,34413,34413,1399-8-11
609,زعف9908پ15,زعفران9908پوشالمعمول طلاسرخ(پ),13,1314,103572226,78636,79354,81253,2617,3.33,78822,186,0.24,73515,81253,1399-8-11
610,ضفلا8081,اختيارخ فولاد-12775-1399/08/28,13,77,63799000,1107,1107,820,-287,-25.93,829,-278,-25.11,800,1108,1399-8-11
611,خعمرا,توسعه و عمران شهرستان نائين,13,45996,749320836,15516,16291,16291,775,4.99,15544,28,0.18,16291,16291,1399-8-11
612,زماهان,مجتمع توليد گوشت مرغ ماهان,13,9471,208314645,23152,21995,21995,-1157,-5.0,23147,-5,-0.02,21995,21995,1399-8-11
613,هصادر912,اختيارف ت صادرات-3750-99/12/23,13,1000000,18000000,155,18,18,-137,-88.39,18,-137,-88.39,18,18,1399-8-11
614,وليز,ليزينگ‌ايران‌,12,14794,131370720,9340,8880,8880,-460,-4.93,9340,0,0.0,8880,8880,1399-8-11
615,ضبدر8056,اختيارخ شبندر-21580-1399/08/18,12,137,468415000,5125,4200,4190,-935,-18.24,3419,-1706,-33.29,3010,4200,1399-8-11
616,زشريف,كشت وصنعت شريف آباد,12,13380,316851780,24927,23681,23681,-1246,-5.0,24919,-8,-0.03,23681,23681,1399-8-11
617,خكاوه,سايپا ديزل,12,194090,1105148460,5870,5694,5694,-176,-3.0,5860,-10,-0.17,5694,5694,1399-8-11
618,ضترا8027,اختيارخ شتران-6353-1399/08/11,12,189,1325664780,4223,4110,4130,-93,-2.2,4114,-109,-2.58,4100,4390,1399-8-11
619,اخزا704,اسنادخزانه-م4بودجه97-991022,12,5125,5007336000,971945,970000,977000,5055,0.52,977041,5096,0.52,970000,978000,1399-8-11
620,سكرد,سيمان كردستان,11,11406,108927300,10050,9550,9550,-500,-4.98,10050,0,0.0,9550,9550,1399-8-11
621,كقزوي,شيشه‌ قزوين‌,11,58900,523738800,9359,8892,8892,-467,-4.99,9346,-13,-0.14,8892,8892,1399-8-11
622,كمينا,شيشه سازي مينا,11,11359,330660490,30642,29110,29110,-1532,-5.0,30615,-27,-0.09,29110,29110,1399-8-11
623,هغدير912,اختيارف ت غدير-17380-99/12/16,11,78198,362734224,4633,4966,4633,0,0.0,4639,6,0.13,4633,4966,1399-8-11
624,ضغدر1120,اختيارخ وغدير-12000-1399/11/26,11,291,454500000,2174,2100,1500,-674,-31.0,1562,-612,-28.15,1500,2199,1399-8-11
625,ساربيل,سيمان آرتا اردبيل,11,1339,82763590,65060,61810,61810,-3250,-5.0,65050,-10,-0.02,61810,61810,1399-8-11
626,گكيش,توريستي ورفاهي آبادگران كيش,11,19976,1404352752,72476,70302,70302,-2174,-3.0,72318,-158,-0.22,70302,70302,1399-8-11
627,اخزا723,اسنادخزانه-م23بودجه97-000824,11,152493,128341535670,838923,843000,839500,577,0.07,841622,2699,0.32,839500,843000,1399-8-11
628,كپرور,فرآوري زغال سنگ پروده طبس,11,8361,378059337,47596,45217,45217,-2379,-5.0,47577,-19,-0.04,45217,45217,1399-8-11
629,ضمخا1024,اختيارخ اخابر-14000-1399/10/30,11,546,1077094000,2377,2001,1999,-378,-15.9,1973,-404,-17.0,1850,2001,1399-8-11
630,ضترا8033,اختيارخ شتران-9873-1399/08/11,11,93,94059735,1934,701,572,-1362,-70.42,593,-1341,-69.34,572,701,1399-8-11
631,ثاصفا,شركت‌ ساختمان‌ اصفهان‌,10,5240,139384000,27422,26600,26600,-822,-3.0,27416,-6,-0.02,26600,26600,1399-8-11
632,فسا,پتروشيمي فسا,10,35887,103426334,3033,2882,2882,-151,-4.98,3032,-1,-0.03,2882,2882,1399-8-11
633,عيار2,صندوق س. پشتوانه طلاي مفيد,10,100000,100000,30020,1,1,-30019,-100.0,1,-30019,-100.0,1,1,1399-8-11
634,لبوتان,گروه‌صنعتي‌بوتان‌,10,4602,309070320,70690,67160,67160,-3530,-4.99,70670,-20,-0.03,67160,67160,1399-8-11
635,چكاوه,صنايع‌كاغذسازي‌كاوه‌,10,16888,601888320,37510,35640,35640,-1870,-4.99,37490,-20,-0.05,35640,35640,1399-8-11
636,بايكا,كارخانجات كابلسازي ‌ايران‌,10,6076,246971172,41904,40647,40647,-1257,-3.0,41888,-16,-0.04,40647,40647,1399-8-11
637,قلرست,قند لرستان‌,10,32041,704581590,23140,21990,21990,-1150,-4.97,23120,-20,-0.09,21990,21990,1399-8-11
638,كيسون,شركت كيسون,10,10579,202482060,19731,19140,19140,-591,-3.0,19728,-3,-0.02,19140,19140,1399-8-11
639,ثپرديس,سرمايه گذاري مسكن پرديس,9,14310,158254290,11641,11059,11059,-582,-5.0,11639,-2,-0.02,11059,11059,1399-8-11
640,كتوكا,توليدي و خدمات صنايع نسوز توكا,9,1189,143116363,126702,120367,120367,-6335,-5.0,126683,-19,-0.01,120367,120367,1399-8-11
641,ضصاد8002,اختيارخ وبصادر-1400-1399/08/11,9,291,527805000,2000,2000,1801,-199,-9.95,1814,-186,-9.3,1800,2000,1399-8-11
642,ضترا8030,اختيارخ شتران-8113-1399/08/11,9,46,227552710,3352,3400,2372,-980,-29.24,2901,-451,-13.45,2350,3400,1399-8-11
643,فوكا,فولاد كاويان,9,19850,405237750,21046,20415,20415,-631,-3.0,21041,-5,-0.02,20415,20415,1399-8-11
644,ضملت8037,اختيارخ وبملت-8204-1399/08/28,9,556,84178248,66,20,40,-26,-39.39,37,-29,-43.94,20,40,1399-8-11
645,وسنا,سرمايه گذاري نيروگاهي ايران,9,19083,288401379,15580,15113,15113,-467,-3.0,15574,-6,-0.04,15113,15113,1399-8-11
646,تكمبا,كمباين‌ سازي‌ ايران‌,9,44375,426000000,10100,9600,9600,-500,-4.95,10100,0,0.0,9600,9600,1399-8-11
647,غاذر,كشت‌وصنعت‌پياذر,9,3870,289359900,78700,74770,74770,-3930,-4.99,78680,-20,-0.03,74770,74770,1399-8-11
648,واتي,سرمايه‌ گذاري‌ آتيه‌ دماوند,9,10673,144512420,14250,13540,13540,-710,-4.98,14250,0,0.0,13540,13540,1399-8-11
649,وثنو,سرمايه گذاري ساختماني نوين,9,7945,116211515,15079,14627,14627,-452,-3.0,15076,-3,-0.02,14627,14627,1399-8-11
650,غپآذر,شير پگاه آذربايجان شرقي,9,4220,220824160,55082,52328,52328,-2754,-5.0,55069,-13,-0.02,52328,52328,1399-8-11
651,ثنام,س ساختماني ب نام آوران مهندسي,9,7851,159563724,21393,20324,20324,-1069,-5.0,21384,-9,-0.04,20324,20324,1399-8-11
652,پست0008پ08,پسته فندقي32-30مه ولات0008(پ),9,120,191809000,1670000,1586500,1586500,-83500,-5.0,1598408,-71592,-4.29,1586500,1610000,1399-8-11
653,ضملي1152,اختيارخ فملي-18252-1399/11/05,9,64,46326000,997,750,701,-296,-29.69,724,-273,-27.38,701,800,1399-8-11
654,بنيرو,نيروترانس‌,9,2160,119361600,58160,55260,55260,-2900,-4.99,58150,-10,-0.02,55260,55260,1399-8-11
655,نتوس,پشم‌ بافي‌ توس,9,7123,75311479,11129,10573,10573,-556,-5.0,11127,-2,-0.02,10573,10573,1399-8-11
656,خلنت,لنت‌ ترمزايران‌,9,3055,266579300,91850,87260,87260,-4590,-5.0,91820,-30,-0.03,87260,87260,1399-8-11
657,سيلام,سيمان‌ ايلام‌,9,58400,595680000,10730,10200,10200,-530,-4.94,10720,-10,-0.09,10200,10200,1399-8-11
658,ضترا8022,اختيارخ شتران-4593-1399/08/11,9,32,337499635,6853,6900,5853,-1000,-14.59,6186,-667,-9.73,5853,6900,1399-8-11
659,خنصير,مهندسي‌نصيرماشين‌,9,52613,2499643630,50010,47510,47510,-2500,-5.0,49880,-130,-0.26,47510,47510,1399-8-11
660,وحكمت,بيمه حكمت صبا,8,53961,307901466,5882,5706,5706,-176,-2.99,5879,-3,-0.05,5706,5706,1399-8-11
661,ضفلا8076,اختيارخ فولاد-8775-1399/08/28,8,26,104112000,4928,4011,4000,-928,-18.83,4004,-924,-18.75,4000,4011,1399-8-11
662,ثشرق,سرمايه گذاري مسكن شمال شرق,8,8824,49149680,5860,5570,5570,-290,-4.95,5860,0,0.0,5570,5570,1399-8-11
663,ضسپا1102,اختيارخ خساپا-2000-1399/11/26,8,25,27559000,1,1500,1100,1099,109900.0,1102,1101,110100.0,950,1500,1399-8-11
664,رتكو,كنترل‌خوردگي‌تكين‌كو,8,111477,1716745800,16210,15400,15400,-810,-5.0,16180,-30,-0.19,15400,15400,1399-8-11
665,اخزا807,اسنادخزانه-م7بودجه98-000719,8,7590,6520228730,853294,852282,870000,16706,1.96,859055,5761,0.68,852282,870000,1399-8-11
666,لكما,كارخانجات‌مخابراتي‌ايران‌,8,15000,159690000,10975,10646,10646,-329,-3.0,10972,-3,-0.03,10646,10646,1399-8-11
667,سمايه,بانك سرمايه,8,12928,120139904,9580,9293,9293,-287,-3.0,9578,-2,-0.02,9293,9293,1399-8-11
668,اشاد10,مشاركت دولتي10-شرايط خاص001226,8,39500,37484510300,956455,954800,942501,-13954,-1.46,948975,-7480,-0.78,942501,954800,1399-8-11
669,غالبر,لبنيات‌ كالبر,8,4409,53481170,12760,12130,12130,-630,-4.94,12760,0,0.0,12130,12130,1399-8-11
670,داراب,پتروشيمي داراب,8,39112,117688008,3167,3009,3009,-158,-4.99,3166,-1,-0.03,3009,3009,1399-8-11
671,ضصاد1101,اختيارخ وبصادر-3000-1399/11/12,8,45,33000000,1110,1000,700,-410,-36.94,733,-377,-33.96,700,1000,1399-8-11
672,تكشا,گسترش‌صنايع‌وخدمات‌كشاورزي‌,8,7398,537612660,76490,72670,72670,-3820,-4.99,76440,-50,-0.07,72670,72670,1399-8-11
673,ضترا8018,اختيارخ شتران-3421-1399/08/11,8,41,491507170,8117,7100,7025,-1092,-13.45,7031,-1086,-13.38,7024,7100,1399-8-11
674,پست0008پ09,پسته بادامي30-28مه ولات0008(پ),8,220,353437450,1567647,1600000,1606644,38997,2.49,1606534,38887,2.48,1600000,1625000,1399-8-11
675,ضفلا8088,اختيارخ فولاد-19775-1399/08/28,7,20,453000,11,23,38,27,245.45,23,12,109.09,21,38,1399-8-11
676,پلاسك,پلاسكوكار,7,15734,132008260,8830,8390,8390,-440,-4.98,8830,0,0.0,8390,8390,1399-8-11
677,حاريا,كشتيراني آريا,7,6110,188841770,31862,30907,30907,-955,-3.0,31853,-9,-0.03,30907,30907,1399-8-11
678,ضترا8035,اختيارخ شتران-11046-1399/08/11,7,184,111588840,537,600,1,-536,-99.81,356,-181,-33.71,1,600,1399-8-11
679,ضملي1149,اختيارخ فملي-12168-1399/11/05,7,112,236521000,3210,2051,2200,-1010,-31.46,2112,-1098,-34.21,2020,2300,1399-8-11
680,وسيلام,شركت س استان ايلام,7,27755,32750900,1240,1180,1180,-60,-4.84,1240,0,0.0,1180,1180,1399-8-11
681,زعف9908پ16,زعفران9908نگين بيرجند(پ),7,1950,151730500,77168,76010,79162,1994,2.58,77811,643,0.83,76000,79162,1399-8-11
682,پارتا,مجتمع‌صنعتي‌آرتاويل‌تاير,7,10233,623414826,62806,60922,60922,-1884,-3.0,62766,-40,-0.06,60922,60922,1399-8-11
683,كساپا,سايپاشيشه‌,7,21000,405300000,20310,19300,19300,-1010,-4.97,20300,-10,-0.05,19300,19300,1399-8-11
684,دلقما,دارويي‌ لقمان‌,7,2570,84630100,34660,32930,32930,-1730,-4.99,34660,0,0.0,32930,32930,1399-8-11
685,ضچاد1017,اختيارخ كچاد-20000-1399/10/02,7,101,80525000,876,800,755,-121,-13.81,797,-79,-9.02,755,830,1399-8-11
686,گوهر2,صندوق سكه طلاي كيان,7,70000,70000,61964,1,1,-61963,-100.0,1,-61963,-100.0,1,1,1399-8-11
687,وايران,ليزينگ ايرانيان,7,6264,57942000,9730,9250,9250,-480,-4.93,9730,0,0.0,9250,9250,1399-8-11
688,شرق1400,مشاركت ليزينگ ايران وشرق140010,7,1690,1727563000,1029423,1020000,1030000,577,0.06,1022227,-7196,-0.7,1015000,1030000,1399-8-11
689,وسخراج,شركت س استان خراسان جنوبي,7,34723,74307220,2250,2140,2140,-110,-4.89,2250,0,0.0,2140,2140,1399-8-11
690,تصميم2,صندوق س با درآمد ثابت تصميم,7,700000,700000,14759,1,1,-14758,-99.99,1,-14758,-99.99,1,1,1399-8-11
691,وسگلستا,شركت س استان گلستان,6,19721,23270780,1240,1180,1180,-60,-4.84,1240,0,0.0,1180,1180,1399-8-11
692,حپارسا,توسعه حمل و نقل ريلي پارسيان,6,8984,265270568,31081,29527,29527,-1554,-5.0,31072,-9,-0.03,29527,29527,1399-8-11
693,خپويش,سازه‌ پويش‌,6,15384,593207040,40580,38560,38560,-2020,-4.98,40550,-30,-0.07,38560,38560,1399-8-11
694,زعف9908پ05,زعفران9908نگين زرين(پ),6,1221,96656802,78004,79162,79162,1158,1.48,79162,1158,1.48,79162,79162,1399-8-11
695,فسديد,لوله‌وتجهيزات‌ سديد - ورشكسته,6,42145,4814012625,116556,114225,114225,-2331,-2.0,114263,-2293,-1.97,114225,114225,1399-8-11
696,اشاد9,مشاركت دولتي9-شرايط خاص990909,6,104400,104079280000,996972,980400,997000,28,0.0,996928,-44,0.0,980400,997000,1399-8-11
697,ضصاد8023,اختيارخ وبصادر-5000-1399/08/11,6,400,85230000,1,1,500,499,49900.0,213,212,21200.0,1,500,1399-8-11
698,ضترا8024,اختيارخ شتران-5181-1399/08/11,6,18,180578255,6146,6100,5500,-646,-10.51,5884,-262,-4.26,5270,6100,1399-8-11
699,ضفار1126,اختيارخ فارس-19826-1399/11/07,6,17,15982000,830,450,498,-332,-40.0,470,-360,-43.37,450,500,1399-8-11
700,صايپا203,صكوك مرابحه سايپا203-3ماهه 16%,6,561,546922424,968600,931349,980000,11400,1.18,974906,6306,0.65,931349,980000,1399-8-11
701,حبندر,دريايي و کشتيراني خط دريابندر,6,3254,73013252,23618,22438,22438,-1180,-5.0,23613,-5,-0.02,22438,22438,1399-8-11
702,تملي705,تسهيلات مسكن ب. ملي-مرداد97,6,65,63291605,927350,973717,973717,46367,5.0,973717,46367,5.0,973717,973717,1399-8-11
703,سغرب,سيمان‌غرب‌,6,2807,51676870,19370,18410,18410,-960,-4.96,19370,0,0.0,18410,18410,1399-8-11
704,بسويچ,پارس‌سويچ‌,6,3521,143515960,42900,40760,40760,-2140,-4.99,42890,-10,-0.02,40760,40760,1399-8-11
705,ثتوسا,س.توسعه و عمران استان اردبيل,5,587,41128742,73753,70066,70066,-3687,-5.0,73745,-8,-0.01,70066,70066,1399-8-11
706,ضترا8029,اختيارخ شتران-7526-1399/08/11,5,71,364375550,4000,3010,3010,-990,-24.75,3010,-990,-24.75,3010,3010,1399-8-11
707,پلاست,كارخانجات توليدي پلاستيران,5,4831,198283564,43204,41044,41044,-2160,-5.0,43181,-23,-0.05,41044,41044,1399-8-11
708,افرا,افرانت,5,594,35092332,62187,59078,59078,-3109,-5.0,62185,-2,0.0,59078,59078,1399-8-11
709,اخزا713,اسنادخزانه-م13بودجه97-000518,5,889,777144979,871817,876998,874200,2383,0.27,874179,2362,0.27,871151,876998,1399-8-11
710,فنرژي,گسترش صنايع انرژي آذرآب,5,5527,58818334,10859,10642,10642,-217,-2.0,10858,-1,-0.01,10642,10642,1399-8-11
711,غشاذر,پگاه‌آذربايجان‌غربي‌,5,27293,526481970,20300,19290,19290,-1010,-4.98,20290,-10,-0.05,19290,19290,1399-8-11
712,فنفت,صنايع تجهيزات نفت,5,2726,38496572,14558,14122,14122,-436,-2.99,14557,-1,-0.01,14122,14122,1399-8-11
713,اخزا718,اسنادخزانه-م18بودجه97-000525,5,32643,28479574280,871864,872500,872455,591,0.07,872456,592,0.07,872432,872500,1399-8-11
714,هافق406,اختيارف ت افق-90000-00/06/30,5,6931,11581701,3191,1671,1671,-1520,-47.63,1671,-1520,-47.63,1671,1671,1399-8-11
715,ضترا8021,اختيارخ شتران-4301-1399/08/11,5,250,3060475000,1,7180,7180,7179,717900.0,7180,7179,717900.0,7180,7180,1399-8-11
716,شستا993,اجاره ت.اجتماعي-كاردان991226,5,630,623560104,995167,998000,975003,-20164,-2.03,989778,-5389,-0.54,975003,998000,1399-8-11
717,ولتجار,واسپاري تجارت وسرمايه ايرانيان,5,5132,30504608,6127,5944,5944,-183,-2.99,6127,0,0.0,5944,5944,1399-8-11
718,ساروج,بين المللي ساروج بوشهر,5,1595,30740715,19823,19500,19229,-594,-3.0,19822,-1,-0.01,19229,19500,1399-8-11
719,اخزا805,اسنادخزانه-م5بودجه98-000422,5,7079,6288354323,889521,887912,888311,-1210,-0.14,888311,-1210,-0.14,887912,889000,1399-8-11
720,ضملت8033,اختيارخ وبملت-6272-1399/08/28,5,45,11615505,28,65,60,32,114.29,62,34,121.43,60,65,1399-8-11
721,نيرو,نيرو سرمايه,5,5107,241423211,48735,47273,47273,-1462,-3.0,48717,-18,-0.04,47273,47273,1399-8-11
722,ثاژن,سخت آژند,5,15813,134568630,8683,8510,8510,-173,-1.99,8681,-2,-0.02,8510,8510,1399-8-11
723,حسير,ريل سير كوثر,5,2099,54851068,27507,26132,26132,-1375,-5.0,27505,-2,-0.01,26132,26132,1399-8-11
724,ضچاد1013,اختيارخ كچاد-12000-1399/10/02,5,85,403400000,4002,5000,4000,-2,-0.05,4746,744,18.59,4000,5000,1399-8-11
725,تملي706,تسهيلات مسكن ب. ملي-شهريور97,5,96,69141408,685927,720223,720223,34296,5.0,720223,34296,5.0,720223,720223,1399-8-11
726,صايپا908,صكوك مرابحه سايپا908-3ماهه 18%,5,100,99150000,972025,992000,990000,17975,1.85,991500,19475,2.0,990000,995000,1399-8-11
727,ضسپا8033,اختيارخ خساپا-6000-1399/08/26,5,35,10865000,1,361,1,0,0.0,310,309,30900.0,1,364,1399-8-11
728,فبستم,صنايع ‌بسته‌بندي‌ مشهد,4,31960,26079360,793,816,816,23,2.9,793,0,0.0,816,816,1399-8-11
729,ضفلا8084,اختيارخ فولاد-15775-1399/08/28,4,26,5312000,300,201,205,-95,-31.67,204,-96,-32.0,201,206,1399-8-11
730,اخزا722,اسنادخزانه-م22بودجه97-000428,4,757,669872908,883921,884950,885000,1079,0.12,884905,984,0.11,884887,885000,1399-8-11
731,لپيام,گسترش صنايع پيام,4,1169,34968297,30838,29913,29913,-925,-3.0,30836,-2,-0.01,29913,29913,1399-8-11
732,حپترو,حمل و نقل پتروشيمي( سهامي عام,4,2274,66923820,30970,29430,29430,-1540,-4.97,30970,0,0.0,29430,29430,1399-8-11
733,ضفلا8068,اختيارخ فولاد-4751-1399/08/28,4,19,226888800,7825,7500,7400,-425,-5.43,7426,-399,-5.1,6900,7500,1399-8-11
734,ضصاد8019,اختيارخ وبصادر-4200-1399/08/11,4,201,201000,1,1,1,0,0.0,1,0,0.0,1,1,1399-8-11
735,صگل411,ص اجاره گل گهر 411- 3 ماهه 17%,4,80,79099750,980000,1097990,980000,0,0.0,988747,8747,0.89,980000,1000000,1399-8-11
736,وسزنجان,شركت س استان زنجان,4,22554,30673440,1430,1360,1360,-70,-4.9,1430,0,0.0,1360,1360,1399-8-11
737,تپمپي,پمپ‌ سازي‌ ايران‌,4,8585,305540150,37460,35590,35590,-1870,-4.99,37450,-10,-0.03,35590,35590,1399-8-11
738,ضخوز1013,اختيارخ فخوز-10667-1399/10/16,4,22,216008000,8333,10000,8003,-330,-3.96,9819,1486,17.83,8003,10000,1399-8-11
739,ضمخا7067,اختيارخ اخابر-14000-1400/07/28,4,14,62600000,1715,4500,4000,2285,133.24,4471,2756,160.7,4000,4600,1399-8-11
740,ضبدر1149,اختيارخ شبندر-28000-1399/11/19,4,12,51500000,5886,5700,4100,-1786,-30.34,4292,-1594,-27.08,4000,5700,1399-8-11
741,بالبر,كابل‌ البرز,4,11239,254900520,23870,22680,22680,-1190,-4.99,23860,-10,-0.04,22680,22680,1399-8-11
742,ثعتما,س. ساختماني اعتماد گستر,4,1682,52530542,32196,31231,31231,-965,-3.0,32193,-3,-0.01,31231,31231,1399-8-11
743,سخزر,سيمان‌ خزر,4,1202,29689400,25990,24700,24700,-1290,-4.96,25990,0,0.0,24700,24700,1399-8-11
744,كايتاح,ح.ايتالران‌,4,3567,46895349,13553,13147,13147,-406,-3.0,13147,-406,-3.0,13147,13147,1399-8-11
745,ضسپا8015,اختيارخ خساپا-1900-1399/08/26,4,48,28800000,525,600,600,75,14.29,600,75,14.29,600,600,1399-8-11
746,غشوكو,شوكو پارس,4,580,25069340,45497,43223,43223,-2274,-5.0,45494,-3,-0.01,43223,43223,1399-8-11
747,ضترا8036,اختيارخ شتران-11633-1399/08/11,3,95,161975,404,1,1,-403,-99.75,1,-403,-99.75,1,1,1399-8-11
748,لازما,كارخانه هاي صنعتي آزمايش,3,25412,776641544,31185,30562,30562,-623,-2.0,31135,-50,-0.16,30562,30562,1399-8-11
749,ضگل8066,اختيارخ كگل-25100-1399/08/21,3,25,25000,9,1,1,-8,-88.89,1,-8,-88.89,1,1,1399-8-11
750,ضشنا1037,اختيارخ شپنا-18000-1399/10/23,3,9,13091000,1610,1499,1299,-311,-19.32,1455,-155,-9.63,1299,1499,1399-8-11
751,سخواف,سيمان مجد خواف,3,1230,19823910,16615,16117,16117,-498,-3.0,16614,-1,-0.01,16117,16117,1399-8-11
752,ضترا8032,اختيارخ شتران-9286-1399/08/11,3,8,28644000,1834,2100,2100,266,14.5,2100,266,14.5,2100,2100,1399-8-11
753,ضفلا8089,اختيارخ فولاد-21775-1399/08/28,3,35,4013000,39,115,114,75,192.31,115,76,194.87,114,115,1399-8-11
754,لخزر,پارس‌ خزر,3,100,20460000,215360,204600,204600,-10760,-5.0,215360,0,0.0,204600,204600,1399-8-11
755,غشصفا,شيرپاستوريزه‌پگاه‌اصفهان‌,3,3348,100841760,31700,30120,30120,-1580,-4.98,31700,0,0.0,30120,30120,1399-8-11
756,ضگل1142,اختيارخ كگل-16000-1399/11/21,3,150,370600000,2605,2600,2400,-205,-7.87,2471,-134,-5.14,2400,2600,1399-8-11
757,ضصاد1100,اختيارخ وبصادر-2500-1399/11/12,3,22,28200000,1479,1400,1200,-279,-18.86,1282,-197,-13.32,1100,1400,1399-8-11
758,داريك2,صندوق س.اعتماد داريك-د,3,300000,300000,10046,1,1,-10045,-99.99,1,-10045,-99.99,1,1,1399-8-11
759,ضغدر8043,اختيارخ وغدير-16000-1399/08/26,3,49,267000,150,1,11,-139,-92.67,5,-145,-96.67,1,100,1399-8-11
760,صينا205,صكوك منفعت سينا دارو-3ماهه 19%,3,310,310000678,1000003,1000003,1000000,-3,0.0,1000002,-1,0.0,1000000,1000003,1399-8-11
761,ضصاد1103,اختيارخ وبصادر-4000-1399/11/12,3,62,21700000,599,355,300,-299,-49.92,350,-249,-41.57,300,355,1399-8-11
762,خفنر,فنرسازي‌خاور,3,11378,211744580,19580,18610,18610,-970,-4.95,19580,0,0.0,18610,18610,1399-8-11
763,ضسپا8018,اختيارخ خساپا-2400-1399/08/26,3,101,21410000,200,212,210,10,5.0,212,12,6.0,210,212,1399-8-11
764,ضسپا8022,اختيارخ خساپا-3200-1399/08/26,3,101,110000,527,1,1,-526,-99.81,1,-526,-99.81,1,10,1399-8-11
765,قمرو,قند مرودشت‌,3,900,30123000,35230,33470,33470,-1760,-5.0,35230,0,0.0,33470,33470,1399-8-11
766,ضملت8021,اختيارخ وبملت-2650-1399/08/28,3,6,44432930,2300,1700,2130,-170,-7.39,1788,-512,-22.26,1700,2130,1399-8-11
767,ضترا8034,اختيارخ شتران-10459-1399/08/11,3,90,15345000,11,100,100,89,809.09,100,89,809.09,100,100,1399-8-11
768,ثغرب,شركت سرمايه گذاري مسكن شمالغرب,3,7759,100308352,13608,12928,12928,-680,-5.0,13607,-1,-0.01,12928,12928,1399-8-11
769,فمراد,آلومراد,3,133,18943190,149920,142430,142430,-7490,-5.0,149920,0,0.0,142430,142430,1399-8-11
770,ضسپا8020,اختيارخ خساپا-2800-1399/08/26,3,6,362000,61,60,61,0,0.0,60,-1,-1.64,60,61,1399-8-11
771,سلامت6,مرابحه سلامت6واجدشرايط خاص1400,3,4500,4304350600,970001,921523,990000,19999,2.06,956522,-13479,-1.39,921523,990000,1399-8-11
772,ضملت8029,اختيارخ وبملت-4582-1399/08/28,3,12,14493500,720,250,300,-420,-58.33,292,-428,-59.44,250,300,1399-8-11
773,بالاس,مهندسي ساختمان تاسيسات راه آهن,3,581,26578426,48153,45746,45746,-2407,-5.0,48152,-1,0.0,45746,45746,1399-8-11
774,شستا992,اجاره تامين اجتماعي-سپهر991226,3,5022,5022000022,1020000,1000001,1000000,-20000,-1.96,1000000,-20000,-1.96,1000000,1000001,1399-8-11
775,ضپاس1001,اختيارخ وپارس-2500-1399/10/30,2,3,3100000,1195,1000,1050,-145,-12.13,1033,-162,-13.56,1000,1050,1399-8-11
776,ضغدر8044,اختيارخ وغدير-17000-1399/08/26,2,122,554000,6,2,7,1,16.67,5,-1,-16.67,2,7,1399-8-11
777,وايرا,سرمايه گذاري صنايع ايران,2,3862,33869740,9041,8770,8770,-271,-3.0,9041,0,0.0,8770,8770,1399-8-11
778,ضصاد8024,اختيارخ وبصادر-5500-1399/08/11,2,81,81000,1,1,1,0,0.0,1,0,0.0,1,1,1399-8-11
779,ضبدر8058,اختيارخ شبندر-25580-1399/08/18,2,36,51500000,2170,1500,1000,-1170,-53.92,1431,-739,-34.06,1000,1500,1399-8-11
780,ضمخا1023,اختيارخ اخابر-12000-1399/10/30,2,13,34000000,4000,2800,2500,-1500,-37.5,2615,-1385,-34.63,2500,2800,1399-8-11
781,ضسپا8017,اختيارخ خساپا-2200-1399/08/26,2,70,33000000,426,400,500,74,17.37,471,45,10.56,400,500,1399-8-11
782,ضفار1120,اختيارخ فارس-8826-1399/11/07,2,2,24000000,13500,6000,6000,-7500,-55.56,6000,-7500,-55.56,6000,6000,1399-8-11
783,ضپاس1004,اختيارخ وپارس-4000-1399/10/30,2,10,2023000,300,203,202,-98,-32.67,202,-98,-32.67,202,203,1399-8-11
784,غگلپا,شير پاستوريزه پگاه گلپايگان,2,575,40843400,74770,71032,71032,-3738,-5.0,74767,-3,0.0,71032,71032,1399-8-11
785,آينده,بازرگاني آينده سازان بهشت پارس,2,473,10432488,22738,22056,22056,-682,-3.0,22738,0,0.0,22056,22056,1399-8-11
786,شفارا,پتروشيمي فارابي,2,4170,21583920,5336,5176,5176,-160,-3.0,5336,0,0.0,5176,5176,1399-8-11
787,ضفلا8060,اختيارخ فولاد-3507-1399/08/28,2,15,209040000,9000,9000,8500,-500,-5.56,8667,-333,-3.7,8500,9000,1399-8-11
788,اخزا716,اسنادخزانه-م16بودجه97-000407,2,335,298826000,890556,893000,892000,1444,0.16,892018,1462,0.16,892000,893000,1399-8-11
789,غنيلي,مجتمع توليدي نيلي صنعت كرمان,2,100000,1744200000,17982,17442,17442,-540,-3.0,17442,-540,-3.0,17442,17442,1399-8-11
790,ضسان1040,اختيارخ پارسان-24000-99/10/14,2,117,183983000,3983,1500,1999,-1984,-49.81,1573,-2410,-60.51,1500,1999,1399-8-11
791,ضمخا7071,اختيارخ اخابر-24000-1400/07/28,2,154593,158303232000,1,1024,1024,1023,102300.0,1024,1023,102300.0,1024,1024,1399-8-11
792,ضگل8065,اختيارخ كگل-23100-1399/08/21,2,13,13000,2,1,1,-1,-50.0,1,-1,-50.0,1,1,1399-8-11
793,ضسپا8038,اختيارخ خساپا-8500-1399/08/26,2,40,4000000,1,100,100,99,9900.0,100,99,9900.0,100,100,1399-8-11
794,ضغدر8042,اختيارخ وغدير-15000-1399/08/26,2,66,660000,12,10,10,-2,-16.67,10,-2,-16.67,10,10,1399-8-11
795,حرهشا,رهشاد سپاهان (سهامي عام,2,170,10053290,62249,59137,59137,-3112,-5.0,62247,-2,0.0,59137,59137,1399-8-11
796,ضترا8026,اختيارخ شتران-5766-1399/08/11,2,5,41944705,40000,5000,4601,-35399,-88.5,4920,-35080,-87.7,4601,5000,1399-8-11
797,ضغدر8033,اختيارخ وغدير-8010-1399/08/26,2,6,15500000,2777,2600,2550,-227,-8.17,2583,-194,-6.99,2550,2600,1399-8-11
798,ضمخا7072,اختيارخ اخابر-28000-1400/07/28,2,103217,82986468000,1,804,804,803,80300.0,804,803,80300.0,804,804,1399-8-11
799,زير0003پ01,زيره سبز0003كيميابذر(پ),2,30,15200000,491480,500000,510000,18520,3.77,506667,15187,3.09,500000,510000,1399-8-11
800,چافست,افست‌,2,453,11402010,26490,25170,25170,-1320,-4.98,26490,0,0.0,25170,25170,1399-8-11
801,پدرخش,درخشان‌ تهران‌,2,1153,248875050,227210,215850,215850,-11360,-5.0,227150,-60,-0.03,215850,215850,1399-8-11
802,بشهاب,لامپ‌  پارس‌ شهاب‌,2,1050,66076500,66240,62930,62930,-3310,-5.0,66240,0,0.0,62930,62930,1399-8-11
803,اطلس2,صندوق س.توسعه اندوخته آينده-س,2,20000,20000,181106,1,1,-181105,-100.0,1,-181105,-100.0,1,1,1399-8-11
804,ضپاس1000,اختيارخ وپارس-2000-1399/10/30,2,102,153000000,1573,1500,1500,-73,-4.64,1500,-73,-4.64,1500,1500,1399-8-11
805,كمند2,صندوق س. با درآمد ثابت كمند,2,40000000,40000000,10158,1,1,-10157,-99.99,1,-10157,-99.99,1,1,1399-8-11
806,وثوق,سرمايه گذاري وثوق امين,2,750,11149500,15325,14866,14866,-459,-3.0,15325,0,0.0,14866,14866,1399-8-11
807,ضپنا1021,اختيارخ رمپنا-16106-1399/10/09,2,10,37261960,2500,2516,2516,16,0.64,2516,16,0.64,2516,2516,1399-8-11
808,پست9908-08,پسته فندقي32-30زرينمه ولات9908,2,8,10667112,1337040,1333789,1332989,-4051,-0.3,1333389,-3651,-0.27,1332989,1333789,1399-8-11
809,مبين014,اجاره اعتماد مبين لوتوس011019,2,2020,1898393000,938113,919650,940000,1887,0.2,939798,1685,0.18,919650,940000,1399-8-11
810,گندم2,مرابحه گندم2-واجدشرايط خاص1400,2,500,495010000,980000,950100,1000000,20000,2.04,990020,10020,1.02,950100,1000000,1399-8-11
811,ضترا1119,اختيارخ شتران-14000-1399/11/14,2,25,25000000,1,1000,1000,999,99900.0,1000,999,99900.0,1000,1000,1399-8-11
812,ساذري,آذريت‌,2,15293,91222745,5792,5965,5965,173,2.99,5793,1,0.02,5965,5965,1399-8-11
813,ثامان,سامان‌ گستراصفهان‌,2,8663,185214940,22500,21380,21380,-1120,-4.98,22500,0,0.0,21380,21380,1399-8-11
814,طمخا7071,اختيارف اخابر-24000-1400/07/28,2,154593,292180770000,1,1890,1890,1889,188900.0,1890,1889,188900.0,1890,1890,1399-8-11
815,ضگل8067,اختيارخ كگل-26000-1399/08/21,2,15,15000,200,1,1,-199,-99.5,1,-199,-99.5,1,1,1399-8-11
816,ضخوز1014,اختيارخ فخوز-12191-1399/10/16,2,22,187000000,7279,8500,8500,1221,16.77,8500,1221,16.77,8500,8500,1399-8-11
817,ضمخا7068,اختيارخ اخابر-16000-1400/07/28,2,154190,485698500000,1,3150,3150,3149,314900.0,3150,3149,314900.0,3150,3150,1399-8-11
818,صايپا012,صكوك مرابحه سايپا012-3ماهه 16%,2,44,43901965,1000000,980393,1000000,0,0.0,997772,-2228,-0.22,980393,1000000,1399-8-11
819,خموتور,موتورسازان‌تراكتورسازي‌ايران‌,2,940,10904000,12210,11600,11600,-610,-5.0,12210,0,0.0,11600,11600,1399-8-11
820,كرونا2,تامين مالي جمعي صرفا اهداي سود,2,201,2010000,10000,10000,10000,0,0.0,10000,0,0.0,10000,10000,1399-8-11
821,تملي708,تسهيلات مسكن ب. ملي-آبان97,2,20,10701440,509593,535072,535072,25479,5.0,535072,25479,5.0,535072,535072,1399-8-11
822,زعف9908پ12,زعفران9908پوشالمعمول سحرخيز(پ),2,131,10644143,79354,81253,81253,1899,2.39,81253,1899,2.39,81253,81253,1399-8-11
823,طمخا7068,اختيارف اخابر-16000-1400/07/28,2,154190,32996660000,1,214,214,213,21300.0,214,213,21300.0,214,214,1399-8-11
824,فبيرا,بسته‌ بندي‌ ايران‌,2,4627,22760213,5071,4919,4919,-152,-3.0,5071,0,0.0,4919,4919,1399-8-11
825,اجاد22,اجاره دولتي آپرورش-لوتوس991118,2,2008,2027922000,1010000,990250,1010000,0,0.0,1009921,-79,-0.01,990250,1010000,1399-8-11
826,صمسكن912,ص دين مسكن جنوب-ماهانه16درصد,2,120,9909980,83465,82929,82099,-1366,-1.64,82583,-882,-1.06,82099,82929,1399-8-11
827,طمخا7072,اختيارف اخابر-28000-1400/07/28,2,103217,366213916000,1,3548,3548,3547,354700.0,3548,3547,354700.0,3548,3548,1399-8-11
828,تابا,تابان نيرو سپاهان,1,208,6607120,32747,31765,31765,-982,-3.0,32747,0,0.0,31765,31765,1399-8-11
829,اخزا8142,اسنادخزانه-م14بودجه98-010318,1,196138,145730534000,740586,743000,743000,2414,0.33,743000,2414,0.33,743000,743000,1399-8-11
830,ضفار1127,اختيارخ فارس-23826-1399/11/07,1,40,72000000,2538,900,900,-1638,-64.54,900,-1638,-64.54,900,900,1399-8-11
831,ضملي1154,اختيارخ فملي-24336-1399/11/05,1,10,2100000,780,210,210,-570,-73.08,210,-570,-73.08,210,210,1399-8-11
832,اجاد26,اجاره دولتي آپرورش-اميد991118,1,19,19000000,1000002,1000000,1000000,-2,0.0,1000000,-2,0.0,1000000,1000000,1399-8-11
833,ضپار8019,اختيارخ خپارس-3800-1399/08/18,1,1,2500000,2183,2500,2500,317,14.52,2500,317,14.52,2500,2500,1399-8-11
834,صفارس307,صكوك اجاره فارس307- 3ماهه18%,1,99,98752500,970000,997500,997500,27500,2.84,997500,27500,2.84,997500,997500,1399-8-11
835,ضسپا8011,اختيارخ خساپا-1500-1399/08/26,1,3,3450000,800,1150,1150,350,43.75,1150,350,43.75,1150,1150,1399-8-11
836,اراد44,مرابحه عام دولت4-ش.خ 0007,1,500,503450000,983900,1006900,1006900,23000,2.34,1006900,23000,2.34,1006900,1006900,1399-8-11
837,خفناور,مهندسي صنعتي روان فن آور,1,425,10247600,24857,24112,24112,-745,-3.0,24857,0,0.0,24112,24112,1399-8-11
838,تملي702,تسهيلات مسكن ب. ملي-ارديبهشت97,1,4,5460676,1365169,1365169,1365169,0,0.0,1365169,0,0.0,1365169,1365169,1399-8-11
839,لخانه,لوازم‌ خانگي‌ پارس‌,1,90,5009400,58589,55660,55660,-2929,-5.0,58588,-1,0.0,55660,55660,1399-8-11
840,فن آوا,گروه فن آوا,1,1000,14117000,14553,14117,14117,-436,-3.0,14553,0,0.0,14117,14117,1399-8-11
841,زنگان,صنعت روي زنگان,1,214,32740288,161044,152992,152992,-8052,-5.0,161038,-6,0.0,152992,152992,1399-8-11
842,افاد14,منفعت دولت-با شرايط خاص140006,1,499000,501175640000,1000008,1004360,1004360,4352,0.44,1004360,4352,0.44,1004360,1004360,1399-8-11
843,ضسپا8014,اختيارخ خساپا-1800-1399/08/26,1,1,1000000,2161,1000,1000,-1161,-53.73,1000,-1161,-53.73,1000,1000,1399-8-11
844,اخزا8152,اسنادخزانه-م15بودجه98-010406,1,130595,95987325000,730274,735000,735000,4726,0.65,735000,4726,0.65,735000,735000,1399-8-11
845,فولاد2,فولاد مباركه اصفهان,1,16000000,200480000000,13010,12530,12530,-480,-3.69,12530,-480,-3.69,12530,12530,1399-8-11
846,پارسا306,صكوك اجاره پارسيان-6ماهه16%,1,200,187400000,947000,937000,937000,-10000,-1.06,937000,-10000,-1.06,937000,937000,1399-8-11
847,ثاباد,توريستي ورفاهي آبادگران ايران,1,177,5410890,32170,30570,30570,-1600,-4.97,32170,0,0.0,30570,30570,1399-8-11
848,صفارس037,صكوك اجاره فارس037- 3ماهه18%,1,10,10500000,1000000,1050000,1050000,50000,5.0,1050000,50000,5.0,1050000,1050000,1399-8-11
849,وسكرشا,س.سهام عدالت استان كرمانشاه,1,10000,12400000,1300,1240,1240,-60,-4.62,1300,0,0.0,1240,1240,1399-8-11
850,شسم,توليد سموم‌ علف‌ كش,1,221,18352282,81414,83042,83042,1628,2.0,81417,3,0.0,83042,83042,1399-8-11
851,ضگل1141,اختيارخ كگل-14000-1399/11/21,1,10,38000000,2787,3800,3800,1013,36.35,3800,1013,36.35,3800,3800,1399-8-11
852,مگچسا104,مشاركت گچساران- 3 ماهه 18%,1,5,4880000,985760,976000,976000,-9760,-0.99,976000,-9760,-0.99,976000,976000,1399-8-11
853,ضملت8031,اختيارخ وبملت-5306-1399/08/28,1,10,6625600,301,160,160,-141,-46.84,160,-141,-46.84,160,160,1399-8-11
854,ضترا8017,اختيارخ شتران-3126-1399/08/11,1,1,14577750,8001,8550,8550,549,6.86,8550,549,6.86,8550,8550,1399-8-11
855,شلرد02,كود شيميايي اوره لردگان,1,10,9920000,992000,992000,992000,0,0.0,992000,0,0.0,992000,992000,1399-8-11
856,اخزا8092,اسنادخزانه-م9بودجه98-000923,1,240993,198939721500,823950,825500,825500,1550,0.19,825500,1550,0.19,825500,825500,1399-8-11
857,ضترا1117,اختيارخ شتران-10000-1399/11/14,1,1,3100000,4500,3100,3100,-1400,-31.11,3100,-1400,-31.11,3100,3100,1399-8-11
858,ضغدر8047,اختيارخ وغدير-20000-1399/08/26,1,87,87000,8,1,1,-7,-87.5,1,-7,-87.5,1,1,1399-8-11
859,ضترا8040,اختيارخ شتران-16326-1399/08/11,1,9,15345,4,1,1,-3,-75.0,1,-3,-75.0,1,1,1399-8-11
860,افاد51,منفعت دولت5-ش.خاص كاردان0108,1,1000,966000000,920000,966000,966000,46000,5.0,966000,46000,5.0,966000,966000,1399-8-11
861,ضملت8032,اختيارخ وبملت-5789-1399/08/28,1,1,409959,151,99,99,-52,-34.44,99,-52,-34.44,99,99,1399-8-11
862,ضبدر8067,اختيارخ شبندر-47580-1399/08/18,1,4,4000,1699,1,1,-1698,-99.94,1,-1698,-99.94,1,1,1399-8-11
863,ضفلا8090,اختيارخ فولاد-23775-1399/08/28,1,30,300000,10,10,10,0,0.0,10,0,0.0,10,10,1399-8-11
864,اخزا8202,اسنادخزانه-م20بودجه98-020806,1,145021,82952012000,569938,572000,572000,2062,0.36,572000,2062,0.36,572000,572000,1399-8-11
865,دروز,داروسازي‌ روزدارو,1,254,4541520,18820,17880,17880,-940,-4.99,18820,0,0.0,17880,17880,1399-8-11
866,ضفلا8080,اختيارخ فولاد-11775-1399/08/28,1,15,19050000,2774,1270,1270,-1504,-54.22,1270,-1504,-54.22,1270,1270,1399-8-11
867,ضفار1123,اختيارخ فارس-13826-1399/11/07,1,2,8000000,799,2000,2000,1201,150.31,2000,1201,150.31,2000,2000,1399-8-11
868,مفاخر4,توسعه فناوري اطلاعات خوارزمي,1,1200000,55962000000,47072,46635,46635,-437,-0.93,46635,-437,-0.93,46635,46635,1399-8-11
869,حريل02,اجاره ريل پردازسير021212,1,200,198813200,974066,994066,994066,20000,2.05,994066,20000,2.05,994066,994066,1399-8-11
870,زدشت4,كشت و صنعت دشت خرم دره,1,5500000,208186000000,36293,37852,37852,1559,4.3,37852,1559,4.3,37852,37852,1399-8-11
871,ضغدر8030,اختيارخ وغدير-6510-1399/08/26,1,2,7000000,4001,3500,3500,-501,-12.52,3500,-501,-12.52,3500,3500,1399-8-11
872,ومشان,س. فني و مهندسي مشانير,1,100,5747000,59247,57470,57470,-1777,-3.0,59246,-1,0.0,57470,57470,1399-8-11
873,ثنظام,س. ساختماني نظام مهندسي ايران,1,2000,85126000,43879,42563,42563,-1316,-3.0,43873,-6,-0.01,42563,42563,1399-8-11
874,طمخا7069,اختيارف اخابر-18000-1400/07/28,1,1,1000000,1,1000,1000,999,99900.0,1000,999,99900.0,1000,1000,1399-8-11
875,عفولاد2,اوراق سلف ورق گرم فولاد مباركه,1,2,1140924,559029,570462,570462,11433,2.05,570462,11433,2.05,570462,570462,1399-8-11
876,فارس2,صنايع پتروشيمي خليج فارس,1,15400000,199430000000,13630,12950,12950,-680,-4.99,12950,-680,-4.99,12950,12950,1399-8-11
877,ضبدر8060,اختيارخ شبندر-29580-1399/08/18,1,1,3000000,1491,3000,3000,1509,101.21,3000,1509,101.21,3000,3000,1399-8-11
878,كاوه2,فولاد كاوه جنوب كيش,1,42000000,821100000000,20230,19550,19550,-680,-3.36,19550,-680,-3.36,19550,19550,1399-8-11
879,دكوثر2,داروسازي‌ كوثر,1,5000000,100100000000,20020,20020,20020,0,0.0,20020,0,0.0,20020,20020,1399-8-11
880,وسالت,بانك قرض الحسنه رسالت,1,1300,5567900,4159,4283,4283,124,2.98,4159,0,0.0,4283,4283,1399-8-11
881,زعف9908پ08,زعفران9908نگين روستا(پ),1,48,3799776,78129,79162,79162,1033,1.32,79162,1033,1.32,79162,79162,1399-8-11
882,ثرود,سرمايه‌گذاري مسكن زاينده رود,1,450,5379750,12584,11955,11955,-629,-5.0,12584,0,0.0,11955,11955,1399-8-11
883,وسمركز,شركت س استان مركزي,1,3816,5075280,1400,1330,1330,-70,-5.0,1400,0,0.0,1330,1330,1399-8-11
884,ضگل8063,اختيارخ كگل-19100-1399/08/21,1,2,2000,2000,1,1,-1999,-99.95,1,-1999,-99.95,1,1,1399-8-11
885,ضپنا1022,اختيارخ رمپنا-18806-1399/10/09,1,5,19993500,1500,2700,2700,1200,80.0,2700,1200,80.0,2700,2700,1399-8-11
886,زير0003پ04,زيره سبز0003شركت مينوبذر(پ),1,11,5170000,460645,470000,470000,9355,2.03,470000,9355,2.03,470000,470000,1399-8-11
887,پست9908-04,پسته فندقي32-30سبزدانه9908,1,5,6611860,1322373,1322372,1322372,-1,0.0,1322372,-1,0.0,1322372,1322372,1399-8-11
888,وآتوس,س.آرين توسكا قيمت اسمي 350ريال,1,2000,68450000,36026,34225,34225,-1801,-5.0,36019,-7,-0.02,34225,34225,1399-8-11
889,افاد1,منفعت دولت-با شرايط خاص140006,1,1000,1004360000,1000008,1004360,1004360,4352,0.44,1004360,4352,0.44,1004360,1004360,1399-8-11
890,ضسپا1100,اختيارخ خساپا-1600-1399/11/26,1,1,1500000,1,1500,1500,1499,149900.0,1500,1499,149900.0,1500,1500,1399-8-11
891,ضچاد1016,اختيارخ كچاد-18000-1399/10/02,1,10,6000000,1045,600,600,-445,-42.58,600,-445,-42.58,600,600,1399-8-11
892,ضفلا8070,اختيارخ فولاد-5775-1399/08/28,1,1,5002000,6013,5002,5002,-1011,-16.81,5002,-1011,-16.81,5002,5002,1399-8-11
893,ضسان1038,اختيارخ پارسان-18000-99/10/14,1,1,6000000,13700,6000,6000,-7700,-56.2,6000,-7700,-56.2,6000,6000,1399-8-11
894,كشم0001پ01,كشمش سبز0001خليل آباد(پ),1,12,4663404,409070,388617,388617,-20453,-5.0,388617,-20453,-5.0,388617,388617,1399-8-11
895,تابان02,اجاره تابان لوتوس14021206,1,3000,2805000000,912000,935000,935000,23000,2.52,935000,23000,2.52,935000,935000,1399-8-11
896,طمخا7066,اختيارف اخابر-12000-1400/07/28,1,1,1500000,2000,1500,1500,-500,-25.0,1500,-500,-25.0,1500,1500,1399-8-11
897,ضصاد8016,اختيارخ وبصادر-3600-1399/08/11,1,10,10000,3,1,1,-2,-66.67,1,-2,-66.67,1,1,1399-8-11
898,گنجين4,صندوق س. گنجينه يكم آويد-د,1,64000000,739392000000,11536,11553,11553,17,0.15,11553,17,0.15,11553,11553,1399-8-11
899,فخوز2,فولاد  خوزستان,1,6000000,199740000000,35040,33290,33290,-1750,-4.99,33290,-1750,-4.99,33290,33290,1399-8-11
900,وپسا,س. پتروشيمي ساختمان  خليج فارس,1,1096,5486576,5160,5006,5006,-154,-2.98,5160,0,0.0,5006,5006,1399-8-11
