,نماد,نام,تعداد,حجم,ارزش,دیروز,اولین,آخرین معامله - مقدار,آخرین معامله - تغییر,آخرین معامله - درصد,قیمت پایانی - مقدار,قیمت پایانی - تغییر,قیمت پایانی - درصد,کمترین,بیشترین,تاریخ
0,پالايش,صندوق پالايشي يکم-سهام,137382,134793270,12254536742610,86860,89030,92750,5890,6.78,90910,4050,4.66,83040,94470,1399-11-8
1,دارا يكم,صندوق واسطه گري مالي يكم-سهام,84083,65786166,9972065145080,152030,147550,150120,-1910,-1.26,151580,-450,-0.3,141100,158000,1399-11-8
2,وكبهمن,مديريت سرمايه گذاري كوثربهمن,54655,34990512,533824721920,15484,14900,15729,245,1.58,15256,-228,-1.47,14710,16000,1399-11-8
3,شستا,سرمايه گذاري تامين اجتماعي,49360,304243085,6574431151930,21960,21200,22600,640,2.91,21610,-350,-1.59,20870,22600,1399-11-8
4,شتران,پالايش نفت تهران,35660,346486742,3240986210650,9180,8990,9630,450,4.9,9350,170,1.85,8730,9630,1399-11-8
5,شپنا,پالايش نفت اصفهان,33508,430685488,4949107863370,11190,11000,11740,550,4.92,11490,300,2.68,10710,11740,1399-11-8
6,سپيدار,سپيدار سيستم آسيا,29716,190287,10197099756,51037,53588,53588,2551,5.0,51479,442,0.87,53588,53588,1399-11-8
7,خساپا,سايپا,26351,1192783505,2529954144910,2170,2130,2160,-10,-0.46,2120,-50,-2.3,2070,2200,1399-11-8
8,بوعلي,پتروشيمي بوعلي سينا,26100,9482611,424488647430,43420,43530,45590,2170,5.0,44760,1340,3.09,42320,45590,1399-11-8
9,خودرو,ايران‌ خودرو,24164,743555656,1943092142940,2670,2620,2640,-30,-1.12,2610,-60,-2.25,2540,2720,1399-11-8
10,ولپارس,ليزينگ پارسيان,19974,46115502,312959019330,7010,6660,6690,-320,-4.56,6790,-220,-3.14,6660,7200,1399-11-8
11,خگستر,گسترش‌سرمايه‌گذاري‌ايران‌خودرو,19698,620603189,1767792699920,2970,2830,2850,-120,-4.04,2850,-120,-4.04,2830,2940,1399-11-8
12,شبندر,پالايش نفت بندرعباس,18829,86880461,1955869732810,22380,22000,22980,600,2.68,22510,130,0.58,21270,23240,1399-11-8
13,چخزر,صنايع چوب خزر كاسپين,18570,334685,20391018310,58025,60926,60926,2901,5.0,58999,974,1.68,60926,60926,1399-11-8
14,فملي,ملي‌ صنايع‌ مس‌ ايران‌,18509,100657723,1085584207400,10930,10700,10980,50,0.46,10780,-150,-1.37,10390,11180,1399-11-8
15,شاروم,پتروشيمي اروميه,17184,15870761,360942260690,22698,23120,22250,-448,-1.97,22743,45,0.2,21980,23647,1399-11-8
16,ثاميد,توسعه و عمران اميد,16759,118592196,214973294390,1850,1810,1840,-10,-0.54,1810,-40,-2.16,1760,1870,1399-11-8
17,بركت,گروه دارويي بركت,14150,63688055,1153419583650,18970,18030,18030,-940,-4.96,18110,-860,-4.53,18030,18800,1399-11-8
18,سيتا,سرمايه گذاري سيمان تامين,13327,22837366,347033143530,15040,15050,15240,200,1.33,15200,160,1.06,15000,15390,1399-11-8
19,ذوب,سهامي ذوب آهن  اصفهان,12966,190042651,856646183420,4686,4470,4584,-102,-2.18,4508,-178,-3.8,4452,4640,1399-11-8
20,فولاد,فولاد مباركه اصفهان,12415,90083984,1051001762850,11680,11580,11820,140,1.2,11670,-10,-0.09,11190,11940,1399-11-8
21,وبصادر,بانك صادرات ايران,11887,419357504,1097667998220,2670,2610,2670,0,0.0,2620,-50,-1.87,2540,2710,1399-11-8
22,بپيوند,برق و انرژي پيوندگستر پارس,11769,14086146,223743021568,16273,16273,16150,-123,-0.76,15884,-389,-2.39,15480,16540,1399-11-8
23,آبادا,توليد نيروي برق آبادان,11187,5557217,93324365120,17100,16410,16600,-500,-2.92,16790,-310,-1.81,16250,17330,1399-11-8
24,آريا,پليمر آريا ساسول,10919,3967434,316633124894,81272,77600,81000,-272,-0.33,79808,-1464,-1.8,77260,83335,1399-11-8
25,آسيا,بيمه آسيا,10731,367114869,1076357814860,2920,2780,3060,140,4.79,2930,10,0.34,2780,3060,1399-11-8
26,امين,تامين سرمايه امين,10248,9098431,94989373870,10400,10400,10420,20,0.19,10440,40,0.38,10400,10690,1399-11-8
27,غزر,صنعتي زر ماكارون,10090,4789942,137451841980,27400,27890,28770,1370,5.0,28700,1300,4.74,27600,28770,1399-11-8
28,ثبهساز,بهساز كاشانه تهران,9739,161497125,451354925010,2930,2790,2790,-140,-4.78,2790,-140,-4.78,2790,2850,1399-11-8
29,كاما,باما,9698,54934049,899666210750,17220,16360,16360,-860,-4.99,16380,-840,-4.88,16360,16650,1399-11-8
30,بگيلان,توسعه مسير برق گيلان,9423,4212724,94969927548,22068,21600,22397,329,1.49,22544,476,2.16,21516,23000,1399-11-8
31,حكشتي,كشتيراني جمهوري اسلامي ايران,9189,34820271,644584611410,19280,18360,18610,-670,-3.48,18510,-770,-3.99,18320,19120,1399-11-8
32,پترول,گروه پتروشيمي س. ايرانيان,9153,48059448,494171771350,10270,9910,10460,190,1.85,10280,10,0.1,9770,10580,1399-11-8
33,وخارزم,سرمايه گذاري خوارزمي,9086,69576148,616953123480,9210,8800,8770,-440,-4.78,8870,-340,-3.69,8750,9150,1399-11-8
34,كلوند,كاشي‌ الوند,9052,24642698,970330312830,37650,39530,39530,1880,4.99,39380,1730,4.59,38290,39530,1399-11-8
35,انرژي3,سايراشخاص بورس انرژي,8580,2213638,748872480120,354420,350000,336700,-17720,-5.0,338300,-16120,-4.55,336700,350200,1399-11-8
36,فمراد,آلومراد,8557,3721712,704288381630,192950,202590,183310,-9640,-5.0,189240,-3710,-1.92,183310,202590,1399-11-8
37,پيزد,مجتمع صنايع لاستيك يزد,8482,2034494,138086914172,67347,68694,70494,3147,4.67,67873,526,0.78,63980,70699,1399-11-8
38,آوا,صندوق س.سهام آواي معيار-س,8215,88272197,669017631356,7789,7350,7600,-189,-2.43,7579,-210,-2.7,7080,7990,1399-11-8
39,حآسا,آسيا سير ارس,8030,19571460,783850784455,39554,37577,41531,1977,5.0,40051,497,1.26,37577,41531,1399-11-8
40,وبملت,بانك ملت,7774,192830905,777674486900,4050,4040,4090,40,0.99,4030,-20,-0.49,3860,4150,1399-11-8
41,شگويا,پتروشيمي تندگويان,7688,33090492,287011268561,8955,8650,8750,-205,-2.29,8674,-281,-3.14,8508,8970,1399-11-8
42,غگل,گلوكوزان‌,7664,98904170,412088148680,4040,4150,4240,200,4.95,4170,130,3.22,3950,4240,1399-11-8
43,خبهمن,گروه‌بهمن‌,7297,37563273,801301487880,22190,21090,21480,-710,-3.2,21330,-860,-3.88,21090,21960,1399-11-8
44,بكاب,صنايع‌جوشكاب‌يزد,7247,2154641,968191912050,443810,421620,466000,22190,5.0,449350,5540,1.25,421620,466000,1399-11-8
45,وپارس,بانك‌پارسيان‌,6981,167617021,513392609060,3070,3010,3110,40,1.3,3060,-10,-0.33,2920,3150,1399-11-8
46,وهنر,گروه توسعه هنر ايران,6976,56952139,419900419522,7511,7655,7286,-225,-3.0,7373,-138,-1.84,7286,7655,1399-11-8
47,فارس,صنايع پتروشيمي خليج فارس,6956,50011566,468391877860,9510,9200,9700,190,2.0,9370,-140,-1.47,9040,9700,1399-11-8
48,فروي,ذوب روي اصفهان,6770,5969831,382411122693,66171,63360,64590,-1581,-2.39,64057,-2114,-3.19,62863,67000,1399-11-8
49,وپويا,سرمايه گذاري پويا,6713,11987248,64924823886,5553,5350,5398,-155,-2.79,5416,-137,-2.47,5276,5667,1399-11-8
50,رافزا,رايان هم افزا,6647,40120,1706303600,40505,42530,42530,2025,5.0,40570,65,0.16,42530,42530,1399-11-8
51,غپينو,پارس‌ مينو,6537,67203671,525052011640,8190,7790,7850,-340,-4.15,7810,-380,-4.64,7790,7930,1399-11-8
52,ثشاهد,سرمايه‌ گذاري‌ شاهد,6427,28686179,492602306910,17690,16980,17630,-60,-0.34,17170,-520,-2.94,16810,17650,1399-11-8
53,دانا,بيمه دانا,6365,88091109,629293063320,7500,7130,7150,-350,-4.67,7140,-360,-4.8,7130,7300,1399-11-8
54,وساپا,سرمايه‌گذاري‌ سايپا,6156,76911914,469635063140,6390,6080,6080,-310,-4.85,6110,-280,-4.38,6080,6350,1399-11-8
55,خنصير,مهندسي‌نصيرماشين‌,5827,4636158,454668473910,97660,98800,96300,-1360,-1.39,98070,410,0.42,95000,101500,1399-11-8
56,ديران,ايران‌دارو,5822,12156245,395004683250,33480,34130,31810,-1670,-4.99,32490,-990,-2.96,31810,34310,1399-11-8
57,شبريز,پالايش نفت تبريز,5726,31556904,896466541640,27630,27150,29010,1380,4.99,28410,780,2.82,26500,29010,1399-11-8
58,كاذر,فرآورده‌هاي‌نسوزآذر,5715,10145035,392552617940,37580,37680,39450,1870,4.98,38690,1110,2.95,36010,39450,1399-11-8
59,وغدير,سرمايه‌گذاري‌غدير(هلدينگ‌,5475,37363113,414471479490,11120,11200,11310,190,1.71,11090,-30,-0.27,10590,11500,1399-11-8
60,خزاميا,زامياد,5388,58779490,454678448630,8100,7700,7700,-400,-4.94,7740,-360,-4.44,7700,8020,1399-11-8
61,چكاپا,گروه صنايع كاغذ پارس,5208,52088451,302137047790,6060,5800,5800,-260,-4.29,5800,-260,-4.29,5760,5980,1399-11-8
62,خپارس,پارس‌ خودرو,5096,72079631,398853801680,5690,5430,5620,-70,-1.23,5530,-160,-2.81,5410,5770,1399-11-8
63,فنورد,نوردوقطعات‌ فولادي‌,4837,1564897,358228656640,231240,224000,224000,-7240,-3.13,228920,-2320,-1.0,219680,242000,1399-11-8
64,سبزوا,سيمان لار سبزوار,4824,60310343,280369117579,4373,4800,4600,227,5.19,4649,276,6.31,4560,5040,1399-11-8
65,خودكفا,اقتصادي و خودكفايي آزادگان,4807,14634622,459632794883,32319,32000,31350,-969,-3.0,31407,-912,-2.82,31350,32199,1399-11-8
66,ساروم,سيمان‌اروميه‌,4804,15536550,438361519120,28520,27100,29100,580,2.03,28210,-310,-1.09,27100,29670,1399-11-8
67,افق,فروشگاههاي زنجيره اي افق كوروش,4801,6251446,534098447750,82740,86870,84390,1650,1.99,85440,2700,3.26,83600,86870,1399-11-8
68,فرابورس,فرابورس ايران,4796,12617605,470807971437,39201,37241,37400,-1801,-4.59,37314,-1887,-4.81,37241,39000,1399-11-8
69,كترام,توليدي‌ كاشي‌ تكسرام‌,4737,9817136,441371292390,43190,44080,45340,2150,4.98,44960,1770,4.1,43500,45340,1399-11-8
70,صبا,سرمايه گذاري صبا تامين,4713,19348477,137247278651,7198,6920,7180,-18,-0.25,7093,-105,-1.46,6839,7300,1399-11-8
71,بترانس,ايران‌ ترانسفو,4603,110729080,336982282420,3200,3040,3040,-160,-5.0,3040,-160,-5.0,3040,3100,1399-11-8
72,نوري,پتروشيمي نوري,4582,6688394,362786990600,55520,54000,55080,-440,-0.79,54240,-1280,-2.31,52750,56500,1399-11-8
73,غصينو,صنعتي مينو,4581,11592418,1002748154659,86331,85890,87500,1169,1.35,86500,169,0.2,82015,88804,1399-11-8
74,گكوثر,هتل پارسيان كوثر اصفهان,4525,93782804,272231456354,3048,2896,2896,-152,-4.99,2903,-145,-4.76,2896,2976,1399-11-8
75,فلامي,لاميران‌,4509,6260042,314332782010,48700,51130,51130,2430,4.99,50210,1510,3.1,47220,51130,1399-11-8
76,تملت,تامين سرمايه بانك ملت,4468,36958671,224200934660,6350,6080,6090,-260,-4.09,6070,-280,-4.41,6040,6300,1399-11-8
77,وهور,مديريت انرژي اميد  تابان هور,4422,9183193,362345267452,38705,39900,38000,-705,-1.82,39457,752,1.94,38000,39990,1399-11-8
78,وپاسار,بانك  پاسارگاد,4402,61748027,758623135500,12270,12270,12490,220,1.79,12290,20,0.16,11660,12570,1399-11-8
79,سرو,صندوق س سروسودمند مدبران-سهام,4368,6175423,416903166200,66830,66000,68540,1710,2.56,67510,680,1.02,63500,69950,1399-11-8
80,قثابت,قند ثابت‌ خراسان‌,4355,6937746,386181198920,54190,56890,56890,2700,4.98,55660,1470,2.71,52030,56890,1399-11-8
81,حريل,ريل پردازسير,4214,81340702,460887578430,5953,5656,5656,-297,-4.99,5666,-287,-4.82,5656,5770,1399-11-8
82,كمند,صندوق س. با درآمد ثابت كمند,4142,186865416,1892443115101,10123,10126,10128,5,0.05,10127,4,0.04,10126,10130,1399-11-8
83,تليسه,دامداري تليسه نمونه,4122,36328587,153788388964,4444,4222,4222,-222,-5.0,4233,-211,-4.75,4222,4380,1399-11-8
84,حفارس,حمل و نقل بين المللي خليج فارس,4118,49473879,280929552730,5570,5470,5840,270,4.85,5680,110,1.97,5300,5840,1399-11-8
85,زمگسا,كشاورزي‌ ودامپروي‌ مگسال‌,4085,7772721,245955952240,32280,30670,31200,-1080,-3.35,31640,-640,-1.98,30670,33330,1399-11-8
86,غديس,پاكديس,4062,18710601,244675960346,12875,13518,12719,-156,-1.21,13077,202,1.57,12422,13518,1399-11-8
87,شلعاب,لعابيران‌,3992,16102244,230423201700,14510,13790,14410,-100,-0.69,14310,-200,-1.38,13790,15100,1399-11-8
88,بكام,كارخانجات توليدي شهيد قندي,3968,56287534,189752736380,3530,3370,3360,-170,-4.82,3370,-160,-4.53,3360,3500,1399-11-8
89,كبافق,معادن‌ بافق‌,3960,4923492,256373177910,51070,49650,53620,2550,4.99,52070,1000,1.96,48520,53620,1399-11-8
90,ساوه,سيمان ساوه,3959,3134514,165475442614,51282,49500,53846,2564,5.0,52791,1509,2.94,49100,53846,1399-11-8
91,فالوم,آلومتك‌,3958,13392589,510709019762,37270,37500,38388,1118,3.0,38134,864,2.32,36900,38388,1399-11-8
92,توريل,توکاريل,3938,13846430,374841955303,27172,25816,27600,428,1.58,27071,-101,-0.37,25816,28200,1399-11-8
93,غشهداب,كشت و صنعت شهداب ناب خراسان,3925,53007684,198419075499,3911,3730,3799,-112,-2.86,3743,-168,-4.3,3716,3840,1399-11-8
94,كماسه,تامين‌ ماسه‌ ريخته‌گري‌,3913,6052669,283541108310,49030,48000,46380,-2650,-5.4,46850,-2180,-4.45,46360,50520,1399-11-8
95,ومعادن,توسعه‌معادن‌وفلزات‌,3845,27319493,319771083510,11930,11780,11610,-320,-2.68,11700,-230,-1.93,11380,12100,1399-11-8
96,لپيام,گسترش صنايع پيام,3761,6699856,368076121286,54366,52740,55450,1084,1.99,54938,572,1.05,52736,55996,1399-11-8
97,كسرا,سراميك‌هاي‌صنعتي‌اردكان‌,3732,20214051,453402244500,23210,22150,23060,-150,-0.65,22430,-780,-3.36,22050,23650,1399-11-8
98,زدشت,كشت و صنعت دشت خرم دره,3721,7908361,256298929030,31461,29888,33034,1573,5.0,32409,948,3.01,29888,33034,1399-11-8
99,تبرك,گروه كارخانجات صنعتي تبرك,3717,13058874,207430480941,15677,14894,16460,783,4.99,15884,207,1.32,14894,16460,1399-11-8
100,فزرين,زرين معدن آسيا,3715,15200429,307001103808,21023,19972,20700,-323,-1.54,20197,-826,-3.93,19972,21000,1399-11-8
101,ونيكي,سرمايه‌گذاري‌ ملي‌ايران‌,3695,19225794,229680683480,12520,12000,11900,-620,-4.95,11950,-570,-4.55,11900,12400,1399-11-8
102,غسالم,سالمين‌,3689,40366447,177707777900,4290,4120,4500,210,4.9,4400,110,2.56,4120,4500,1399-11-8
103,حفاري,حفاري شمال,3612,22768137,259445830570,11500,11110,11450,-50,-0.43,11400,-100,-0.87,10930,11760,1399-11-8
104,تاپكيش,تجارت الكترونيك پارسيان كيش,3556,7923302,191118828198,24005,24365,23299,-706,-2.94,24121,116,0.48,22900,25150,1399-11-8
105,شلرد,كود شيميايي اوره لردگان,3496,27966710,208442561348,7798,7410,7470,-328,-4.21,7453,-345,-4.42,7409,7610,1399-11-8
106,چكاوهح,ح . صنايع‌كاغذسازي‌كاوه‌,3472,33002253,409597708810,11350,12290,12490,1140,10.04,12410,1060,9.34,12010,12490,1399-11-8
107,تاپيكو,س. نفت و گاز و پتروشيمي تأمين,3439,23900624,264817364690,11160,10750,11400,240,2.15,11080,-80,-0.72,10610,11690,1399-11-8
108,ساربيل,سيمان آرتا اردبيل,3408,4118105,180656154710,42590,41100,44710,2120,4.98,43870,1280,3.01,40520,44710,1399-11-8
109,ونوين,بانك‌اقتصادنوين‌,3406,68836978,284494288970,4280,4100,4140,-140,-3.27,4130,-150,-3.5,4070,4320,1399-11-8
110,غويتا,ويتانا,3378,12736526,286499838328,23468,22295,22999,-469,-2.0,22494,-974,-4.15,22295,23460,1399-11-8
111,دماوند,توليد نيروي برق دماوند,3371,5233296,232965019249,46607,44280,44300,-2307,-4.95,44516,-2091,-4.49,44277,46000,1399-11-8
112,دشيمي,شيمي‌ داروئي‌ داروپخش‌,3353,4414718,202853086820,48100,47000,45700,-2400,-4.99,45950,-2150,-4.47,45700,47400,1399-11-8
113,فوكا,فولاد كاويان,3299,23624909,313671001261,12968,12790,13340,372,2.87,13277,309,2.38,12610,13357,1399-11-8
114,هاي وب,داده گسترعصرنوين-هاي وب,3266,9025493,216945897780,25160,23980,23910,-1250,-4.97,24040,-1120,-4.45,23910,24800,1399-11-8
115,ولصنم,ليزينگ‌صنعت‌ومعدن‌,3241,16236867,206576590900,12990,12990,12350,-640,-4.93,12720,-270,-2.08,12350,13280,1399-11-8
116,كوير,توليدي فولاد سپيد فراب كوير,3223,10351049,240368483760,23130,23580,22710,-420,-1.82,23220,90,0.39,22500,23980,1399-11-8
117,مدير,ص.س.مديريت ثروت ص.بازنشستگي-س,3221,20229587,191967885406,9753,9349,9538,-215,-2.2,9489,-264,-2.71,9000,9810,1399-11-8
118,كپارس,كاشي‌ پارس‌,3217,2064285,325697358590,163810,155640,155620,-8190,-5.0,157780,-6030,-3.68,155620,163770,1399-11-8
119,بجهرم,توسعه مولد نيروگاهي جهرم,3212,31144639,94368062591,3076,3011,3070,-6,-0.2,3030,-46,-1.5,2932,3110,1399-11-8
120,ثاخت,بين‌المللي‌توسعه‌ساختمان,3179,72950924,240857680290,3460,3290,3370,-90,-2.6,3300,-160,-4.62,3290,3370,1399-11-8
121,فخوز,فولاد  خوزستان,3162,23531162,314556452320,13490,13300,13500,10,0.07,13370,-120,-0.89,12930,13700,1399-11-8
122,ختوقا,قطعات‌ اتومبيل‌ ايران‌,3158,52258636,138536502250,2760,2670,2670,-90,-3.26,2650,-110,-3.99,2630,2750,1399-11-8
123,كروي,توسعه‌ معادن‌ روي‌ ايران‌,3120,8997842,269804330620,31320,29760,30400,-920,-2.94,29990,-1330,-4.25,29760,31160,1399-11-8
124,گشان,توسعه بين المللي پديده شانديز,3081,5223321,251923355933,49203,48219,48219,-984,-2.0,48230,-973,-1.98,48219,49000,1399-11-8
125,غدام,خوراك‌  دام‌ پارس‌,3035,1074918,423216157770,411330,390770,390770,-20560,-5.0,393720,-17610,-4.28,390770,407000,1399-11-8
126,ولشرق,ليزينگ ايران و شرق,2988,17142959,144602179709,8310,8670,8653,343,4.13,8435,125,1.5,8000,8670,1399-11-8
127,زكوثر,سرمايه گذاري كشاورزي كوثر,2965,8828803,177902861970,21080,20030,20030,-1050,-4.98,20150,-930,-4.41,20030,20860,1399-11-8
128,بكهنوج,توليد برق ماهتاب كهنوج,2912,59997493,116388632155,2034,1990,1949,-85,-4.18,1940,-94,-4.62,1933,2000,1399-11-8
129,البرز,بيمه البرز,2859,45964406,189092688940,4280,4110,4170,-110,-2.57,4110,-170,-3.97,4070,4280,1399-11-8
130,ودي,بيمه  دي,2857,13196018,305285349584,22917,22100,23560,643,2.81,23135,218,0.95,22100,24000,1399-11-8
131,فولاي,صنايع فولاد آلياژي يزد,2844,6611358,269322287364,42480,40356,40830,-1650,-3.88,40736,-1744,-4.11,40356,42172,1399-11-8
132,غگيلا,شيرپاستوريزه پگاه گيلان,2800,46950,1068112500,21667,22750,22750,1083,5.0,21689,22,0.1,22750,22750,1399-11-8
133,كالا,بورس كالاي ايران,2757,6735627,242565564820,37850,35960,35960,-1890,-4.99,36010,-1840,-4.86,35960,36670,1399-11-8
134,ستران,سيمان‌ تهران‌,2754,9386664,261268531680,27310,25960,28670,1360,4.98,27830,520,1.9,25950,28670,1399-11-8
135,مرقام,ايران‌ارقام‌,2736,9389227,169534340110,18810,17870,17910,-900,-4.78,18060,-750,-3.99,17870,19200,1399-11-8
136,شرانل,نفت ايرانول,2701,4716004,195796034733,40304,39400,41560,1256,3.12,41517,1213,3.01,39000,42319,1399-11-8
137,ختراك,ريخته‌گري‌ تراكتورسازي‌ ايران‌,2699,13880024,181557800270,13340,12680,13240,-100,-0.75,13080,-260,-1.95,12680,13870,1399-11-8
138,ثعتما,س. ساختماني اعتماد گستر,2666,4033202,279331775256,72097,74000,69100,-2997,-4.16,69258,-2839,-3.94,68493,74000,1399-11-8
139,وپست,پست بانك ايران,2646,23410811,447761763930,20110,19110,19110,-1000,-4.97,19130,-980,-4.87,19110,19450,1399-11-8
140,اخابر,مخابرات ايران,2630,19685558,216215658100,11040,11040,11210,170,1.54,10980,-60,-0.54,10490,11460,1399-11-8
141,خلنت,لنت‌ ترمزايران‌,2622,2008099,248170233170,128380,121970,121970,-6410,-4.99,123580,-4800,-3.74,121970,129000,1399-11-8
142,غدشت,دشت‌ مرغاب‌,2605,1869114,552956370290,283540,297710,297710,14170,5.0,295840,12300,4.34,269370,297710,1399-11-8
143,فرآور,فرآوري‌موادمعدني‌ايران‌,2598,8173919,297680959830,35000,34350,36750,1750,5.0,36420,1420,4.06,34150,36750,1399-11-8
144,كلر,كلر پارس,2563,2340956,270941785708,110741,112955,116278,5537,5.0,115740,4999,4.51,112955,116278,1399-11-8
145,تسه9910,امتياز تسهيلات مسكن دي99,2552,45559,23845624796,514101,535000,520000,5899,1.15,523401,9300,1.81,502100,539806,1399-11-8
146,فاذر,صنايع‌ آذرآب‌,2541,6963564,162562509660,23760,22590,24000,240,1.01,23340,-420,-1.77,22580,24300,1399-11-8
147,ورنا,سرمايه‌گذاري‌ رنا(هلدينگ‌,2537,46232125,273871801720,6230,5920,5930,-300,-4.82,5920,-310,-4.98,5920,6040,1399-11-8
148,بورس,بورس اوراق بهادار تهران,2516,8436247,375563398050,46760,44430,44980,-1780,-3.81,44520,-2240,-4.79,44430,46680,1399-11-8
149,قنيشا,قند  نيشابور,2511,3759854,250203211590,69170,69200,65720,-3450,-4.99,66550,-2620,-3.79,65720,69500,1399-11-8
150,سخزر,سيمان‌ خزر,2511,6344436,194593100060,30780,29260,31500,720,2.34,30670,-110,-0.36,29250,32300,1399-11-8
151,بشهاب,لامپ‌  پارس‌ شهاب‌,2479,3216465,333330214510,102200,100000,106440,4240,4.15,103630,1430,1.4,97090,107000,1399-11-8
152,شغدير,پتروشيمي غدير,2469,4005159,252854035286,64481,61560,62500,-1981,-3.07,63132,-1349,-2.09,61257,65980,1399-11-8
153,تكمبا,كمباين‌ سازي‌ ايران‌,2466,17817138,187078017810,10110,10320,10610,500,4.95,10500,390,3.86,9950,10610,1399-11-8
154,دزهراويح,ح . ‌داروسازي‌زهراوي‌,2440,9147712,62285397060,6790,6800,6900,110,1.62,6810,20,0.29,6480,7150,1399-11-8
155,آگاس,صندوق س.هستي بخش آگاه-س,2427,2761358,181687986151,65565,64011,66840,1275,1.94,65797,232,0.35,63000,67500,1399-11-8
156,دتوليد,داروسازي توليد دارو,2400,5454930,145743378985,28013,26620,26894,-1119,-3.99,26718,-1295,-4.62,26613,27840,1399-11-8
157,دبالك,مواد اوليه دارويي البرز بالك,2394,6986148,141253046988,21194,20135,20135,-1059,-5.0,20219,-975,-4.6,20135,21000,1399-11-8
158,ولملت,واسپاري ملت,2356,22791353,238714576980,10370,9860,10730,360,3.47,10470,100,0.96,9860,10880,1399-11-8
159,سرود,سيمان‌شاهرود,2355,14979798,280539597890,17870,18760,18760,890,4.98,18730,860,4.81,18100,18760,1399-11-8
160,ولساپا,ليزينگ رايان‌ سايپا,2333,35512906,124685870040,3570,3470,3560,-10,-0.28,3510,-60,-1.68,3400,3620,1399-11-8
161,وساخت,سرمايه‌ گذاري‌ ساختمان‌ايران‌,2331,2893033,150369751130,53940,51500,51600,-2340,-4.34,51980,-1960,-3.63,51250,54500,1399-11-8
162,ونيرو,سرمايه‌گذاري‌نيرو,2331,28188326,81738991330,2990,2920,2940,-50,-1.67,2900,-90,-3.01,2850,3050,1399-11-8
163,فسازان,غلتك سازان سپاهان,2322,6027007,231167753710,37990,36510,37550,-440,-1.16,38360,370,0.97,36260,39500,1399-11-8
164,غپآذر,شير پگاه آذربايجان شرقي,2304,2485608,171979872126,72147,68540,68540,-3607,-5.0,69190,-2957,-4.1,68540,72498,1399-11-8
165,دزهراوي,داروسازي‌زهراوي‌,2299,13584200,115451302620,8890,8530,8530,-360,-4.05,8500,-390,-4.39,8450,8760,1399-11-8
166,وكارح,ح . بانك‌ كارآفرين‌,2299,52839878,102775875290,2060,2030,1950,-110,-5.34,1950,-110,-5.34,1890,2050,1399-11-8
167,سفار,سيمان‌فارس‌,2297,2220961,301237289820,134040,127340,140740,6700,5.0,135630,1590,1.19,127340,140740,1399-11-8
168,سفانو,سيمان فارس نو,2296,6664378,261236440200,37530,39000,39400,1870,4.98,39200,1670,4.45,37600,39400,1399-11-8
169,كچاد,معدني‌وصنعتي‌چادرملو,2289,11310798,231303048940,20340,20400,20650,310,1.52,20450,110,0.54,19800,20890,1399-11-8
170,دارو,كارخانجات‌داروپخش‌,2280,4311714,155739850950,36450,38090,35080,-1370,-3.76,36120,-330,-0.91,34630,38140,1399-11-8
171,ارزش,صندوق س ارزش آفرين بيدار-سهام,2255,16100565,154966462590,9650,9300,9750,100,1.04,9620,-30,-0.31,9070,9900,1399-11-8
172,چكارن,كارتن‌ ايران‌,2240,29264426,104069142760,3710,3530,3530,-180,-4.85,3560,-150,-4.04,3530,3710,1399-11-8
173,پدرخش,درخشان‌ تهران‌,2233,1814051,231948052660,125070,119100,131320,6250,5.0,127860,2790,2.23,118820,131320,1399-11-8
174,لپارس,پارس‌ الكتريك‌,2229,1719499,161436567160,98680,93750,93750,-4930,-5.0,93890,-4790,-4.85,93750,95990,1399-11-8
175,خريخت,صنايع‌ريخته‌گري‌ايران‌,2200,32577431,122782476550,3940,3750,3770,-170,-4.31,3770,-170,-4.31,3750,3900,1399-11-8
176,شفن,پتروشيمي فناوران,2198,860535,254865835420,293600,284050,300000,6400,2.18,296170,2570,0.88,284050,304950,1399-11-8
177,وآذر,سرمايه‌گذاري‌توسعه‌آذربايجان‌,2184,2461118,261378201530,111410,105840,105840,-5570,-5.0,106200,-5210,-4.68,105840,108050,1399-11-8
178,امين يكم,صندوق درآمد ثابت امين يكم فردا,2173,66411115,673421051348,10135,10140,10143,8,0.08,10140,5,0.05,10136,10145,1399-11-8
179,كاوه,فولاد كاوه جنوب كيش,2173,8846469,167112910110,18920,18900,19110,190,1.0,18890,-30,-0.16,18220,19460,1399-11-8
180,پلاسك,پلاسكوكار,2161,13680264,129348689090,9730,9250,9500,-230,-2.36,9460,-270,-2.77,9250,10000,1399-11-8
181,چدن,توليدي چدن سازان,2160,6818475,190233023100,29300,27840,27860,-1440,-4.91,27900,-1400,-4.78,27840,28400,1399-11-8
182,سصوفي,سيمان‌ صوفيان‌,2150,11431021,169361209560,14480,13990,15200,720,4.97,14820,340,2.35,13760,15200,1399-11-8
183,هخود011,اختيارف ت خودرو-3540-00/11/06,2140,214000000,32100000000,70,150,150,80,114.29,150,80,114.29,150,150,1399-11-8
184,كساوه,صنايع‌ كاشي‌ و سراميك‌ سينا,2136,3222799,268080684010,80460,83000,84000,3540,4.4,83180,2720,3.38,80000,84210,1399-11-8
185,واحيا,م .صنايع و معادن احياء سپاهان,2099,2874165,466496350737,166177,161192,166400,223,0.13,162307,-3870,-2.33,161192,169300,1399-11-8
186,ولغدر,ليزينگ‌خودروغدير,2088,7052071,164186309450,24390,23180,23180,-1210,-4.96,23280,-1110,-4.55,23180,24200,1399-11-8
187,قشير,قند شيروان قوچان و بجنورد,2073,5398430,137010187181,26530,25204,25430,-1100,-4.15,25380,-1150,-4.33,25204,26640,1399-11-8
188,وكادو,تكادو,2065,8360774,217185245634,26069,26000,26350,281,1.08,25977,-92,-0.35,25287,26800,1399-11-8
189,فجر,فولاد اميركبيركاشان,2052,3630734,239165684540,64570,65000,66400,1830,2.83,65870,1300,2.01,61550,67790,1399-11-8
190,وآوا,سرمايه گذاري آوا نوين,2026,10602621,87282198170,8598,8169,8169,-429,-4.99,8232,-366,-4.26,8169,8550,1399-11-8
191,سيمرغ,سيمرغ,2024,7638693,112063714270,15300,14810,14850,-450,-2.94,14670,-630,-4.12,14540,15860,1399-11-8
192,ثباغ,شهر سازي و خانه سازي باغميشه,2002,7381303,119512522302,16945,16098,16098,-847,-5.0,16191,-754,-4.45,16098,16700,1399-11-8
193,فروس,فروسيليس‌ ايران‌,1939,16909927,84654595050,5250,5090,5020,-230,-4.38,5010,-240,-4.57,4860,5200,1399-11-8
194,غالبر,لبنيات‌ كالبر,1939,9847883,132852646520,13090,12440,13740,650,4.97,13490,400,3.06,12440,13740,1399-11-8
195,وبهمن,سرمايه‌گذاري‌بهمن‌,1921,16820494,333913997550,20870,19830,20320,-550,-2.64,19850,-1020,-4.89,19830,20330,1399-11-8
196,نوين,بيمه نوين,1891,16950174,115274168346,6903,6651,6940,37,0.54,6801,-102,-1.48,6570,7130,1399-11-8
197,فاسمين,كالسيمين‌,1855,6996942,110132134420,15810,15200,15950,140,0.89,15740,-70,-0.44,15190,16210,1399-11-8
198,ثعمرا,عمران و توسعه شاهد,1846,11891996,126077834025,11109,10554,10770,-339,-3.05,10602,-507,-4.56,10554,11080,1399-11-8
199,ومعلم,بيمه معلم,1819,22505763,116926870410,5460,5187,5187,-273,-5.0,5195,-265,-4.85,5187,5286,1399-11-8
200,وسكاب,س.ص.بازنشستگي كاركنان بانكها,1806,20580861,131067518830,6440,6250,6420,-20,-0.31,6370,-70,-1.09,6120,6650,1399-11-8
201,فن آوا,گروه فن آوا,1804,13719177,255372780631,18291,18839,18839,548,3.0,18614,323,1.77,17800,18839,1399-11-8
202,سفارس,سيمان فارس و خوزستان,1789,10870455,185258203710,16520,16110,17340,820,4.96,17040,520,3.15,15850,17340,1399-11-8
203,خكمك,كمك‌فنرايندامين‌,1782,6486279,198760851670,32240,30630,30630,-1610,-4.99,30640,-1600,-4.96,30630,31130,1399-11-8
204,مداران,داده‌پردازي‌ايران‌,1780,6995635,190101236720,26810,25470,28150,1340,5.0,27170,360,1.34,25470,28150,1399-11-8
205,شبهرن,نفت‌ بهران‌,1777,2972772,184311476510,62080,61000,63450,1370,2.21,62000,-80,-0.13,59400,64100,1399-11-8
206,آ س پ,آ.س.پ,1768,8743690,117079844893,14009,13312,13450,-559,-3.99,13390,-619,-4.42,13309,13881,1399-11-8
207,پرداخت,به پرداخت ملت,1758,3369105,135326974850,38540,39800,40460,1920,4.98,40170,1630,4.23,37810,40460,1399-11-8
208,اعتماد,صندوق س.اعتماد آفرين پارسيان-د,1737,46747620,1616633087970,34540,34550,34585,45,0.13,34582,42,0.12,34550,34605,1399-11-8
209,نطرين,عطرين نخ قم,1714,7342541,85520437998,12185,11576,11576,-609,-5.0,11647,-538,-4.42,11576,12086,1399-11-8
210,سباقر,سيمان باقران,1712,6291037,101166381947,16127,15644,16300,173,1.07,16081,-46,-0.29,15644,16500,1399-11-8
211,وايران,ليزينگ ايرانيان,1682,8922920,116939573110,13750,13090,13070,-680,-4.95,13110,-640,-4.65,13070,13640,1399-11-8
212,حتايد,تايدواترخاورميانه,1665,8553730,214799235320,26120,24820,25190,-930,-3.56,25110,-1010,-3.87,24820,25970,1399-11-8
213,ورازي,بيمه رازي,1660,12253899,105034176412,8506,8574,8700,194,2.28,8571,65,0.76,8112,8920,1399-11-8
214,ملت,بيمه ملت,1650,6321892,92232467710,14670,14570,14590,-80,-0.55,14590,-80,-0.55,14030,15200,1399-11-8
215,بموتو,موتوژن‌,1621,2500532,147170020740,56380,57300,59190,2810,4.98,58860,2480,4.4,57300,59190,1399-11-8
216,ونفت,سرمايه‌گذاري‌ صنعت‌ نفت‌,1619,6153966,109264454140,17800,17000,18010,210,1.18,17760,-40,-0.22,16980,18250,1399-11-8
217,قرن,پديده شيمي قرن,1616,1408301,90101571640,64750,63000,64180,-570,-0.88,63980,-770,-1.19,61710,66500,1399-11-8
218,تپولا,مهندسي مرآت پولاد,1610,2509206,93899475822,37404,36606,36282,-1122,-3.0,37422,18,0.05,36282,38510,1399-11-8
219,رمپنا,گروه مپنا (سهامي عام),1596,7338886,125083722950,17420,17150,17400,-20,-0.11,17060,-360,-2.07,16550,17690,1399-11-8
220,وملل,اعتباري ملل,1581,14743480,213536236757,14982,14500,15000,18,0.12,14483,-499,-3.33,14233,15100,1399-11-8
221,بپاس,بيمه پاسارگاد,1574,3762083,375887093932,99901,99901,99995,94,0.09,99915,14,0.01,99899,99998,1399-11-8
222,خمحور,توليدمحورخودرو,1571,2843254,153377713860,52810,50170,55450,2640,5.0,53940,1130,2.14,50170,55450,1399-11-8
223,كمنگنز,معادن‌منگنزايران‌,1560,1173793,117239337340,102140,102160,98750,-3390,-3.32,99880,-2260,-2.21,97980,104590,1399-11-8
224,رنيك,جنرال مكانيك,1549,4097742,92678956220,21963,21530,23061,1098,5.0,22617,654,2.98,21500,23061,1399-11-8
225,خوساز,محورسازان‌ايران‌خودرو,1545,13978015,111871170340,7770,7710,8150,380,4.89,8000,230,2.96,7390,8150,1399-11-8
226,وسينا,بانك سينا,1542,21288564,69511090350,3390,3230,3280,-110,-3.24,3270,-120,-3.54,3230,3400,1399-11-8
227,خفناور,مهندسي صنعتي روان فن آور,1530,4329426,179180192610,40154,41000,42161,2007,5.0,41387,1233,3.07,38147,42161,1399-11-8
228,شاراك,پتروشيمي شازند,1500,7298026,174393094170,23100,23000,24250,1150,4.98,23900,800,3.46,22700,24250,1399-11-8
229,كگل,معدني و صنعتي گل گهر,1498,7549349,132698927140,17480,17500,17890,410,2.35,17580,100,0.57,17010,17940,1399-11-8
230,وصنعت,سرمايه گذاري توسعه صنعت وتجارت,1498,10118076,61237434920,6100,6140,6150,50,0.82,6050,-50,-0.82,5900,6190,1399-11-8
231,پكوير,كوير تاير,1494,7982603,117343740020,15440,14670,14670,-770,-4.99,14700,-740,-4.79,14670,14970,1399-11-8
232,سامان,بانك سامان,1492,14357013,145846326447,10437,10125,10195,-242,-2.32,10159,-278,-2.66,10124,10500,1399-11-8
233,وحكمت,بيمه حكمت صبا,1490,13975660,66459834259,4813,4669,4848,35,0.73,4755,-58,-1.21,4669,4939,1399-11-8
234,واعتبار,سرمايه گذاري اعتبار ايران,1473,11453637,94048684600,7890,7950,8280,390,4.94,8210,320,4.06,7570,8280,1399-11-8
235,وسپه,سرمايه‌گذاري‌ سپه‌,1463,18058126,130689437640,6950,6670,7290,340,4.89,7240,290,4.17,6610,7290,1399-11-8
236,فسرب,ملي‌ سرب‌وروي‌ ايران‌,1458,922264,82197011790,90000,85850,91250,1250,1.39,89130,-870,-0.97,85570,92000,1399-11-8
237,غگلستا,شير پاستوريزه پگاه گلستان,1457,4955850,132041110774,25663,25922,26946,1283,5.0,26643,980,3.82,25791,26946,1399-11-8
238,سخاش,سيمان‌خاش‌,1449,935423,119980814940,122780,128890,128910,6130,4.99,128260,5480,4.46,123630,128910,1399-11-8
239,ريشمك,توليد و صادرات ريشمك,1436,2629975,141071898708,51945,51000,54542,2597,5.0,53640,1695,3.26,49560,54542,1399-11-8
240,وسين,بيمه سينا,1429,7649351,134346439811,18218,18300,17308,-910,-5.0,17563,-655,-3.6,17308,18300,1399-11-8
241,شكربن,كربن‌ ايران‌,1425,1691558,171722026130,105290,103330,101900,-3390,-3.22,101520,-3770,-3.58,100030,105500,1399-11-8
242,قصفها,قنداصفهان‌,1420,483250,69636089650,150030,142710,143640,-6390,-4.26,144100,-5930,-3.95,142550,150000,1399-11-8
243,كهمدا,شيشه‌ همدان‌,1415,7015875,72935238940,10860,10350,10380,-480,-4.42,10400,-460,-4.24,10320,10860,1399-11-8
244,وبانك,سرمايه گذاري گروه توسعه ملي,1401,7433697,59569254670,7910,8000,8080,170,2.15,7980,70,0.88,7700,8250,1399-11-8
245,فسپا,گروه‌صنعتي‌سپاهان‌,1388,3921036,165849773320,40800,39320,42580,1780,4.36,42300,1500,3.68,39320,42840,1399-11-8
246,كشرق,صنعتي و معدني شمال شرق شاهرود,1382,1283546,123662147270,93168,89500,97826,4658,5.0,96344,3176,3.41,89500,97826,1399-11-8
247,دكوثر,داروسازي‌ كوثر,1381,5248494,114125814910,21380,20320,22440,1060,4.96,21740,360,1.68,20320,22440,1399-11-8
248,كاردان,صندوق س تجارت شاخصي كاردان,1369,720056,106695535720,149790,143800,149450,-340,-0.23,148180,-1610,-1.07,142000,154070,1399-11-8
249,والبر,سرمايه‌ گذاري‌ البرز(هلدينگ‌,1354,6298574,86912405070,14300,13590,14030,-270,-1.89,13800,-500,-3.5,13590,14150,1399-11-8
250,زبينا,كشاورزي و دامپروري بينالود,1353,2522118,93606691293,39027,37076,37076,-1951,-5.0,37114,-1913,-4.9,37076,38000,1399-11-8
251,پارسان,گسترش نفت و گاز پارسيان,1351,8393117,153334619290,18040,18040,18400,360,2.0,18270,230,1.27,17730,18660,1399-11-8
252,شسپا,نفت سپاهان,1334,3961158,97524317700,24580,24580,24780,200,0.81,24620,40,0.16,23400,25500,1399-11-8
253,قچار,فراوردههاي غذايي وقند چهارمحال,1317,1903197,150391435450,75334,78775,79100,3766,5.0,79020,3686,4.89,77777,79100,1399-11-8
254,كرمان,س. توسعه و عمران استان كرمان,1311,1442646,90334164582,65912,62617,62617,-3295,-5.0,62617,-3295,-5.0,62617,62617,1399-11-8
255,سيستم,همكاران سيستم,1286,3073580,102342088730,34830,33390,33090,-1740,-5.0,33300,-1530,-4.39,33090,34800,1399-11-8
256,كيان,صندوق س. با درآمد ثابت كيان,1286,28236666,760486479980,26913,26935,26934,21,0.08,26933,20,0.07,26930,26936,1399-11-8
257,بالبر,كابل‌ البرز,1286,2443951,96411630850,41410,39540,39540,-1870,-4.52,39450,-1960,-4.73,39340,40210,1399-11-8
258,وبوعلي,سرمايه‌گذاري‌بوعلي‌,1285,10480195,56615607680,5350,5250,5530,180,3.36,5400,50,0.93,5190,5550,1399-11-8
259,لسرما,سرما آفرين‌,1281,3089948,87314017140,28080,27430,28400,320,1.14,28260,180,0.64,27430,29000,1399-11-8
260,زفكا,كشت و دامداري فكا,1270,3835095,48608420186,13205,12748,12545,-660,-5.0,12678,-527,-3.99,12545,13160,1399-11-8
261,شكلر,نيروكلر,1266,1128785,66552725850,58740,58490,59300,560,0.95,58960,220,0.37,56600,61150,1399-11-8
262,فلوله,لوله‌وماشين‌سازي‌ايران‌,1265,6114626,126711002260,20040,19500,21040,1000,4.99,20720,680,3.39,19180,21040,1399-11-8
263,زماهان,مجتمع توليد گوشت مرغ ماهان,1264,2617299,119146564405,43490,43000,45664,2174,5.0,45523,2033,4.67,43000,45664,1399-11-8
264,شگل,گلتاش‌,1259,5401609,149361635570,26400,27700,27720,1320,5.0,27650,1250,4.73,26510,27720,1399-11-8
265,هفولا011,اختيارف ت فولاد-14832-00/11/06,1250,125000000,12500000000,1,100,100,99,9900.0,100,99,9900.0,100,100,1399-11-8
266,سغرب,سيمان‌غرب‌,1236,2287722,58512350420,24990,25380,26230,1240,4.96,25580,590,2.36,23780,26230,1399-11-8
267,خكاوه,سايپا ديزل,1234,22043719,111099499325,5300,5035,5035,-265,-5.0,5040,-260,-4.91,5035,5174,1399-11-8
268,ولانا,شركت ليزينگ آريا دانا,1233,2859049,84096210869,28758,29500,29620,862,3.0,29414,656,2.28,29000,29620,1399-11-8
269,خپويش,سازه‌ پويش‌,1230,969568,45843140360,46410,46550,47000,590,1.27,47260,850,1.83,45000,48680,1399-11-8
270,شصدف,صنعتي دوده فام,1221,35264,1008021440,27224,28585,28585,1361,5.0,27250,26,0.1,28585,28585,1399-11-8
271,فنوال,نورد آلومينيوم‌,1220,5495122,128769878570,22570,21480,23690,1120,4.96,23430,860,3.81,21480,23690,1399-11-8
272,غپاك,لبنيات‌ پاك‌,1219,6537769,89758006050,13830,13150,13920,90,0.65,13730,-100,-0.72,13150,14110,1399-11-8
273,شخارك,پتروشيمي‌ خارك‌,1218,1953019,82395491580,41670,42290,42160,490,1.18,42090,420,1.01,40510,43000,1399-11-8
274,غمينوح,ح . شركت صنايع غذايي مينو شرق,1194,4638701,42752466042,9593,9115,9190,-403,-4.2,9216,-377,-3.93,9114,9800,1399-11-8
275,آريان,سرمايه گذاري پارس آريان,1191,19134632,255498496022,13439,13439,13442,3,0.02,13353,-86,-0.64,13170,13770,1399-11-8
276,ولبهمن,شركت بهمن ليزينگ,1191,9764202,70138694717,7478,7118,7120,-358,-4.79,7183,-295,-3.94,7105,7660,1399-11-8
277,زاگرس,پتروشيمي زاگرس,1183,567508,106355429433,186204,186000,189010,2806,1.51,187408,1204,0.65,180000,193000,1399-11-8
278,وثنو,سرمايه گذاري ساختماني نوين,1176,4867783,82814424743,17501,16626,17390,-111,-0.63,17013,-488,-2.79,16626,18050,1399-11-8
279,كي بي سي,شركت كي بي سي,1174,11021109,359263418360,31048,32600,32600,1552,5.0,32598,1550,4.99,32000,32600,1399-11-8
280,وكار,بانك‌ كارآفرين‌,1166,24941576,70787411090,2970,2850,2840,-130,-4.38,2840,-130,-4.38,2830,2940,1399-11-8
281,ارفع,شركت آهن و فولاد ارفع,1158,8007688,96655393672,12357,11740,12350,-7,-0.06,12070,-287,-2.32,11740,12800,1399-11-8
282,كفپارس,فرآورده‌هاي‌ نسوز پارس‌,1149,11731880,50586508450,4520,4300,4300,-220,-4.87,4310,-210,-4.65,4300,4430,1399-11-8
283,سيدكو,سرمايه گذاري توسعه صنايع سيمان,1146,9175882,53911413730,5840,5590,5950,110,1.88,5880,40,0.68,5550,6050,1399-11-8
284,سشرق,سيمان‌ شرق‌,1146,14165400,91614752640,6250,6100,6560,310,4.96,6470,220,3.52,5940,6560,1399-11-8
285,فايرا,آلومينيوم‌ايران‌,1140,4445364,103862294640,22730,22500,23860,1130,4.97,23360,630,2.77,21820,23860,1399-11-8
286,دفارا,داروسازي‌ فارابي‌,1139,1202512,62975821330,54130,51440,51500,-2630,-4.86,52370,-1760,-3.25,51430,55970,1399-11-8
287,تپمپي,پمپ‌ سازي‌ ايران‌,1138,3380008,77759824220,24190,22990,22990,-1200,-4.96,23010,-1180,-4.88,22990,23390,1399-11-8
288,اميد,تامين سرمايه اميد,1137,10711995,85500840120,8360,7980,8000,-360,-4.31,7980,-380,-4.55,7950,8200,1399-11-8
289,كسعديح,ح . كاشي‌ سعدي‌,1136,5947710,93655327420,14360,15700,15800,1440,10.03,15750,1390,9.68,15400,15800,1399-11-8
290,هفملي011,اختيارف ت فملي-14400-00/11/06,1130,113000000,59890000000,220,530,530,310,140.91,530,310,140.91,530,530,1399-11-8
291,بهپاك,صنعتي بهپاك,1117,7122146,282421375221,41185,39126,41185,0,0.0,39654,-1531,-3.72,39126,41338,1399-11-8
292,كحافظ,كاشي‌ وسراميك‌ حافظ‌,1112,6220007,82456511970,12730,12900,13360,630,4.95,13260,530,4.16,12600,13360,1399-11-8
293,فاما,صنعتي‌ آما,1107,3514452,75885480790,20680,21000,21710,1030,4.98,21590,910,4.4,20100,21710,1399-11-8
294,كطبس,ذغال‌سنگ‌ نگين‌ ط‌بس‌,1104,1931346,137735047970,69130,66400,72580,3450,4.99,71320,2190,3.17,66400,72580,1399-11-8
295,ثمسكن,سرمايه‌گذاري‌ مسكن‌,1094,12200558,58814735460,5040,4950,4820,-220,-4.37,4820,-220,-4.37,4790,5000,1399-11-8
296,دسانكو,داروسازي سبحان انكولوژي,1092,4550196,69338688204,15983,15184,15184,-799,-5.0,15239,-744,-4.65,15184,15890,1399-11-8
297,رتكو,كنترل‌خوردگي‌تكين‌كو,1091,5924474,122099100170,19880,19900,20870,990,4.98,20610,730,3.67,19150,20870,1399-11-8
298,كگاز,شيشه‌ و گاز,1090,3481981,60563717190,16850,16500,17690,840,4.99,17390,540,3.2,16050,17690,1399-11-8
299,شوينده,مديريت صنعت شوينده ت.ص.بهشهر,1087,5111203,174878068910,32730,33000,34360,1630,4.98,34210,1480,4.52,31720,34360,1399-11-8
300,كپرور,فرآوري زغال سنگ پروده طبس,1075,1971616,77553744780,41298,39300,39234,-2064,-5.0,39335,-1963,-4.75,39234,40980,1399-11-8
301,رتاپ,تجارت الكترونيك  پارسيان,1074,5280463,31351176970,6080,5830,6000,-80,-1.32,5980,-100,-1.64,5780,6160,1399-11-8
302,غبهنوش,بهنوش‌ ايران‌,1073,1345083,111263059190,86930,82590,82590,-4340,-4.99,82720,-4210,-4.84,82590,84090,1399-11-8
303,چفيبر,فيبر ايران‌,1073,9000856,117664882940,13710,13130,13030,-680,-4.96,13070,-640,-4.67,13030,13360,1399-11-8
304,غشصفا,شيرپاستوريزه‌پگاه‌اصفهان‌,1072,2554312,73550332160,30150,28700,28700,-1450,-4.81,28790,-1360,-4.51,28650,29400,1399-11-8
305,داروح,ح . كارخانجات‌داروپخش,1064,3367617,104751766130,30630,31840,30030,-600,-1.96,31110,480,1.57,28000,33000,1399-11-8
306,وتوكا,سرمايه‌گذاري‌توكافولاد(هلدينگ,1061,9348379,105046428680,11770,11200,11240,-530,-4.5,11240,-530,-4.5,11190,11690,1399-11-8
307,فباهنر,مس‌ شهيدباهنر,1060,961960,51618435850,53020,51100,54340,1320,2.49,53640,620,1.17,50520,55670,1399-11-8
308,فيروزه,صندوق شاخص30 شركت فيروزه- سهام,1059,554275,78604714270,143940,136000,142500,-1440,-1.0,141820,-2120,-1.47,135100,146000,1399-11-8
309,مبين,مبين انرژي خليج فارس,1054,9649969,129033650630,13470,13010,13590,120,0.89,13370,-100,-0.74,12800,14140,1399-11-8
310,خاور,ايران خودرو ديزل,1039,16596247,119222200111,7403,7181,7181,-222,-3.0,7184,-219,-2.96,7181,7290,1399-11-8
311,شپديس,پتروشيمي پرديس,1038,1787487,165626859140,92650,90000,93880,1230,1.33,92660,10,0.01,89500,95000,1399-11-8
312,رانفور,خدمات‌انفورماتيك‌,1035,5915118,162124729380,26120,26500,27420,1300,4.98,27410,1290,4.94,26500,27420,1399-11-8
313,وآتوس,س.آرين توسكا قيمت اسمي 350ريال,1025,2100374,98998148231,47741,49100,46390,-1351,-2.83,47134,-607,-1.27,46309,49100,1399-11-8
314,پاسا,ايران‌ياساتايرورابر,1024,2641116,67434426130,25220,24500,25500,280,1.11,25530,310,1.23,24200,26280,1399-11-8
315,وخاور,بانك خاورميانه,1024,9961524,99950997700,10140,9980,10140,0,0.0,10030,-110,-1.08,9890,10180,1399-11-8
316,لابسا,آبسال‌,1022,1118725,65061004700,55450,58210,58220,2770,5.0,58160,2710,4.89,56450,58220,1399-11-8
317,زملارد,كشاورزي و دامپروري ملارد شير,1022,1750173,60534740891,36402,34582,34582,-1820,-5.0,34588,-1814,-4.98,34582,35000,1399-11-8
318,غمارگ,مارگارين‌,1021,3456306,102485496160,31140,29650,29590,-1550,-4.98,29650,-1490,-4.78,29590,30500,1399-11-8
319,واميد,گروه مديريت سرمايه گذاري اميد,1011,7063896,280270363290,39400,39380,39990,590,1.5,39680,280,0.71,37740,40590,1399-11-8
320,تيپيكو,سرمايه گذاري دارويي تامين,1010,2749311,131218683530,47950,45670,47500,-450,-0.94,47730,-220,-0.46,45670,49000,1399-11-8
321,غبشهر,صنعتي‌ بهشهر,1007,5126686,104570540370,21390,20370,20330,-1060,-4.96,20400,-990,-4.63,20330,22200,1399-11-8
322,تاصيكو,سرمايه گذاري صدرتامين,1001,7637010,74464823840,9730,9300,9780,50,0.51,9740,10,0.1,9250,10190,1399-11-8
323,بزاگرس,نيروگاه زاگرس كوثر,998,9243004,67216413968,7634,7253,7253,-381,-4.99,7272,-362,-4.74,7253,7498,1399-11-8
324,بسويچ,پارس‌سويچ‌,992,1066486,59267205930,58240,55330,55330,-2910,-5.0,55570,-2670,-4.58,55330,57450,1399-11-8
325,پاكشو,گروه صنعتي پاكشو,992,881995,68353538430,78440,79000,78000,-440,-0.56,77800,-640,-0.82,76200,79000,1399-11-8
326,ثاباد,توريستي ورفاهي آبادگران ايران,990,1842694,100890425840,57020,57020,54170,-2850,-5.0,54750,-2270,-3.98,54170,57020,1399-11-8
327,وشهر,بانك شهر,989,16216861,101686533863,6487,6487,6228,-259,-3.99,6270,-217,-3.35,6228,6490,1399-11-8
328,سپاها,سيمان‌سپاهان‌,989,7960546,66899118610,8090,8100,8490,400,4.94,8400,310,3.83,7800,8490,1399-11-8
329,سكرد,سيمان كردستان,988,8086964,68404283930,8190,8300,8590,400,4.88,8460,270,3.3,7790,8590,1399-11-8
330,خاذين,سايپاآذين‌,979,21519585,93285834720,4550,4350,4330,-220,-4.84,4330,-220,-4.84,4330,4440,1399-11-8
331,سشمال,سيمان‌ شمال‌,974,4119864,39329607910,9420,8950,9700,280,2.97,9520,100,1.06,8950,9800,1399-11-8
332,ومهان,گروه توسعه مالي مهر آيندگان,971,2887264,36712233851,12770,12180,12890,120,0.94,12730,-40,-0.31,12180,13150,1399-11-8
333,دكپسول,توليد ژلاتين كپسول ايران,963,2243670,114450958968,48743,50000,51180,2437,5.0,51011,2268,4.65,49500,51180,1399-11-8
334,آرمان,بيمه آرمان,953,5252208,50926843680,9638,9351,9630,-8,-0.08,9696,58,0.6,9351,9927,1399-11-8
335,پكرمان,گروه‌ صنعتي‌ بارز,953,4293282,117404083900,26180,25390,27480,1300,4.97,27350,1170,4.47,25390,27480,1399-11-8
336,خاهن,آهنگري‌ تراكتورسازي‌ ايران‌,946,1681440,64646640990,38870,38290,38700,-170,-0.44,38450,-420,-1.08,37900,39610,1399-11-8
337,هرمز,فولاد هرمزگان جنوب,946,4704544,61654539584,13149,12515,13012,-137,-1.04,13127,-22,-0.17,12515,13526,1399-11-8
338,سرچشمه,سرمايه گذاري مس سرچشمه,943,6552089,45990396539,7185,7180,7040,-145,-2.02,7020,-165,-2.3,6826,7180,1399-11-8
339,ساروج,بين المللي ساروج بوشهر,939,9234708,223269176381,23999,23280,23557,-442,-1.84,24177,178,0.74,23280,24718,1399-11-8
340,بخاور,بيمه زندگي خاورميانه,939,7297014,51344824239,6945,6650,7243,298,4.29,7036,91,1.31,6600,7292,1399-11-8
341,همراه,شركت ارتباطات سيار ايران,936,3408777,91724177820,27020,27500,27000,-20,-0.07,26920,-100,-0.37,25900,27710,1399-11-8
342,وليز,ليزينگ‌ايران‌,934,8801500,57626200570,6360,6350,6670,310,4.87,6550,190,2.99,6120,6670,1399-11-8
343,سخوز,سيمان خوزستان,934,3590993,83558031420,22350,21440,23460,1110,4.97,23270,920,4.12,21440,23460,1399-11-8
344,وبشهر,توسعه‌ صنايع‌ بهشهر(هلدينگ,926,4504683,54035501440,12510,11920,12170,-340,-2.72,12000,-510,-4.08,11890,12510,1399-11-8
345,وپترو,سرمايه‌گذاري صنايع پتروشيمي‌,923,4087441,63829836230,16280,15470,15520,-760,-4.67,15620,-660,-4.05,15470,16400,1399-11-8
346,شاوان,پالايش نفت لاوان,922,826359,72917433499,88495,84400,88650,155,0.18,88239,-256,-0.29,84071,92000,1399-11-8
347,خمهر,مهركام‌پارس‌,921,11043054,31685380460,2930,2890,2860,-70,-2.39,2890,-40,-1.37,2790,2980,1399-11-8
348,وآرين,شركت توسعه اقتصادي آرين,918,6717929,32346100330,4826,4900,4847,21,0.44,4815,-11,-0.23,4682,4900,1399-11-8
349,ميدكو,هلدينگ صنايع  معدني خاورميانه,917,7633491,241272221964,31412,31412,31799,387,1.23,31607,195,0.62,31035,31820,1399-11-8
350,بساما,بيمه سامان,907,2090851,47055931395,21902,21500,22997,1095,5.0,22506,604,2.76,21000,22997,1399-11-8
351,تنوين,تامين سرمايه نوين,899,6861758,40358178720,5850,5800,5980,130,2.22,5870,20,0.34,5610,6010,1399-11-8
352,حسينا,توسعه خدمات دريايي وبندري سينا,897,786537,55682740503,70561,67600,71100,539,0.76,70795,234,0.33,67600,72680,1399-11-8
353,وتوسم,سرمايه‌گذاري‌توسعه‌ملي‌,892,4581153,52424504680,11600,11560,11640,40,0.34,11450,-150,-1.29,11020,11840,1399-11-8
354,لخزر,پارس‌ خزر,887,452521,77311929660,176920,177380,168080,-8840,-5.0,170850,-6070,-3.43,168080,178690,1399-11-8
355,شجم,صنايع پتروشيمي تخت جمشيد,875,6502881,76211972569,12006,12124,11897,-109,-0.91,11720,-286,-2.38,11646,12124,1399-11-8
356,لبوتان,گروه‌صنعتي‌بوتان‌,873,1162514,78607284200,70980,67730,68400,-2580,-3.63,67620,-3360,-4.73,67440,71000,1399-11-8
357,وصنا,گروه‌صنايع‌بهشهرايران‌,872,4621849,29979753100,6750,6590,6480,-270,-4.0,6580,-170,-2.52,6420,6690,1399-11-8
358,وتوشه,سرمايه‌ گذاري‌ پارس‌ توشه‌,872,2919503,64361604060,23020,21870,21960,-1060,-4.6,22050,-970,-4.21,21870,22940,1399-11-8
359,تكنو,تكنوتار,868,3682442,83304106120,21670,22690,22750,1080,4.98,22620,950,4.38,21920,22750,1399-11-8
360,طلا,صندوق س.پشتوانه طلاي لوتوس,856,647234,48294233736,72280,75100,74245,1965,2.72,74616,2336,3.23,73550,75499,1399-11-8
361,شنفت,نفت‌ پارس‌,855,1405347,75893319280,54900,54900,53800,-1100,-2.0,54000,-900,-1.64,52160,56000,1399-11-8
362,ساينا,صنايع بهداشتي ساينا,843,831182,144505842126,172297,163690,180911,8614,5.0,173856,1559,0.9,163684,180911,1399-11-8
363,فپنتا,سپنتا,822,128043,51615408280,411950,402610,417000,5050,1.23,403110,-8840,-2.15,391360,417000,1399-11-8
364,زفكاح,ح . كشت و دامداري فكا,816,6806516,58227495960,8991,8549,8542,-449,-4.99,8555,-436,-4.85,8542,8816,1399-11-8
365,اتكام,شركت بيمه اتكايي امين,811,7496243,40978791550,5606,5330,5606,0,0.0,5480,-126,-2.25,5326,5650,1399-11-8
366,حبندر,دريايي و کشتيراني خط دريابندر,809,3340484,116682601191,33272,34935,34935,1663,5.0,34930,1658,4.98,33850,34935,1399-11-8
367,كگهر,سنگ آهن گهرزمين,807,1476347,67707619213,44970,44970,46703,1733,3.85,45453,483,1.07,44550,46900,1399-11-8
368,درهآور,دارويي ره آورد تامين,803,1521484,60604376268,38311,38010,40226,1915,5.0,39832,1521,3.97,38010,40226,1399-11-8
369,سكرما,سيمان‌ كرمان‌,800,5243311,83169435880,15350,14710,16110,760,4.95,15860,510,3.32,14710,16110,1399-11-8
370,نمرينو,ايران‌ مرينوس‌,798,1111802,58834275530,53470,50800,54850,1380,2.58,52920,-550,-1.03,50800,55800,1399-11-8
371,وگستر,گسترش سرمايه گذاري ايرانيان,798,2534802,53936993046,21949,22000,21110,-839,-3.82,21279,-670,-3.05,20852,22000,1399-11-8
372,فولاژ,فولاد آلياژي ايران,794,2458930,39161699240,16350,15550,15860,-490,-3.0,16090,-260,-1.59,15540,16800,1399-11-8
373,پخش,پخش البرز,780,2398288,70260413761,30680,29440,29390,-1290,-4.2,29296,-1384,-4.51,29146,30090,1399-11-8
374,شفارا,پتروشيمي فارابي,779,9594973,45465105970,4882,4775,4736,-146,-2.99,4738,-144,-2.95,4736,4880,1399-11-8
375,ما,بيمه  ما,770,7245730,59398594550,8120,8120,8200,80,0.99,8200,80,0.99,7900,8390,1399-11-8
376,بفجر,فجر انرژي خليج فارس,765,5091760,126486899230,25120,23910,25500,380,1.51,24840,-280,-1.11,23870,26370,1399-11-8
377,غگلپا,شير پاستوريزه پگاه گلپايگان,764,706204,42924583897,62848,60110,61750,-1098,-1.75,60799,-2049,-3.26,59706,65900,1399-11-8
378,تسه9908,امتياز تسهيلات مسكن آبان99,762,18057,9422996275,509985,509985,520000,10015,1.96,521847,11862,2.33,496552,535484,1399-11-8
379,فخاس,فولاد خراسان,747,1831155,47262848510,26540,25740,26690,150,0.57,26180,-360,-1.36,25220,26910,1399-11-8
380,هجرت,پخش هجرت,742,1004624,26746628603,27156,25850,26400,-756,-2.78,26838,-318,-1.17,25799,27970,1399-11-8
381,خشرق,الكتريك‌ خودرو شرق‌,738,4046908,78493193770,20360,19400,19350,-1010,-4.96,19400,-960,-4.72,19350,19800,1399-11-8
382,پارس,پتروشيمي پارس,734,1301204,169859021260,131350,127100,129500,-1850,-1.41,130540,-810,-0.62,125990,134850,1399-11-8
383,گوهران,سرمايه گذاري توسعه گوهران اميد,724,4104577,32167082070,7808,7511,8080,272,3.48,7826,18,0.23,7500,8080,1399-11-8
384,غپونه,نوش پونه مشهد,722,1785319,37908080797,21764,21112,21112,-652,-3.0,21233,-531,-2.44,21112,22110,1399-11-8
385,زقيام,كشت و دام قيام اصفهان,711,2215692,59353259579,28012,26612,26612,-1400,-5.0,26788,-1224,-4.37,26612,27990,1399-11-8
386,شسينا,صنايع‌شيميايي‌سينا,710,409380,64465068600,165750,157470,157470,-8280,-5.0,157470,-8280,-5.0,157470,157470,1399-11-8
387,ثجوان,تامين مسكن جوانان,699,3949681,49143633237,12636,12258,12280,-356,-2.82,12442,-194,-1.54,12257,13010,1399-11-8
388,دلقما,دارويي‌ لقمان‌,697,2069791,47994826350,24390,23180,23180,-1210,-4.96,23190,-1200,-4.92,23180,23650,1399-11-8
389,لوتوس,تامين سرمايه لوتوس پارسيان,693,2637204,27894840060,10420,10410,10620,200,1.92,10510,90,0.86,10100,10940,1399-11-8
390,شپارس,بين‌ المللي‌ محصولات‌  پارس‌,690,2638991,49007108330,19430,18500,18480,-950,-4.89,18570,-860,-4.43,18460,19430,1399-11-8
391,قمرو,قند مرودشت‌,689,1147626,30393982800,26980,25640,26900,-80,-0.3,26650,-330,-1.22,25640,27900,1399-11-8
392,تسه9909,امتياز تسهيلات مسكن آذر99,678,10454,5500366901,515133,516000,525000,9867,1.92,526149,11016,2.14,501000,540000,1399-11-8
393,خديزل,بهمن  ديزل,675,1381054,61765112774,42842,44975,44984,2142,5.0,44723,1881,4.39,42333,44984,1399-11-8
394,خچرخش,چرخشگر,670,3723567,60051806910,16940,16100,16100,-840,-4.96,16130,-810,-4.78,16100,16500,1399-11-8
395,سنير,سيمان‌ سفيد ني‌ريز,670,176081,39470316960,213490,224160,224160,10670,5.0,220770,7280,3.41,224160,224160,1399-11-8
396,سدور,سيمان‌ دورود,669,3280872,64075430160,18600,19530,19530,930,5.0,19530,930,5.0,19530,19530,1399-11-8
397,واتي,سرمايه‌ گذاري‌ آتيه‌ دماوند,666,3733703,39050206150,10390,9920,10510,120,1.15,10450,60,0.58,9920,10890,1399-11-8
398,كفرآور,فرآورده هاي سيمان شرق,661,3680836,77406659466,20708,20087,21329,621,3.0,21030,322,1.55,20087,21329,1399-11-8
399,شپاكسا,پاكسان‌,654,2065845,66641666820,32160,32160,32200,40,0.12,32260,100,0.31,31230,32990,1399-11-8
400,فلات,گروه صنايع معادن فلات ايرانيان,648,3294234,49002043079,15270,14521,14775,-495,-3.24,14875,-395,-2.59,14507,15555,1399-11-8
401,سيلام,سيمان‌ ايلام‌,641,6391421,52584868990,7890,7980,8280,390,4.94,8230,340,4.31,7700,8280,1399-11-8
402,حپترو,حمل و نقل پتروشيمي( سهامي عام,640,1748002,62715177630,35800,34010,37000,1200,3.35,35880,80,0.22,34010,37420,1399-11-8
403,سهرمز,سيمان‌هرمزگان‌,638,2956039,72165132230,23290,23340,24450,1160,4.98,24410,1120,4.81,23340,24450,1399-11-8
404,تايرا,تراكتورسازي‌ايران‌,625,1246467,34406553330,28890,27510,27900,-990,-3.43,27920,-970,-3.36,27450,28680,1399-11-8
405,دامين,داروسازي‌ امين‌,621,2711581,41591241960,15780,15000,15240,-540,-3.42,15370,-410,-2.6,15000,16000,1399-11-8
406,نيرو,نيرو سرمايه,620,1126686,71569993707,63061,61600,64952,1891,3.0,63523,462,0.73,61170,64952,1399-11-8
407,جم,پتروشيمي جم,617,1181950,49105329540,41440,41470,43500,2060,4.97,41490,50,0.12,39850,43500,1399-11-8
408,شبصير,توليدات پتروشيمي قائد بصير,613,561235,55109357148,97816,95177,99000,1184,1.21,98193,377,0.39,95177,99500,1399-11-8
409,اعتلا,شركت سرمايه گذاري اعتلاء البرز,611,2602885,21134990979,8520,8220,8094,-426,-5.0,8320,-200,-2.35,8094,8350,1399-11-8
410,دلرح,ح . داروسازي‌ اكسير,610,1546476,46571263680,30820,31200,29920,-900,-2.92,30110,-710,-2.3,27740,32010,1399-11-8
411,وثخوز,سرمايه گذاري و توسعه خوزستان,609,899945,62536564297,66485,68890,69809,3324,5.0,69489,3004,4.52,68500,69809,1399-11-8
412,سمازن,سيمان‌مازندران‌,608,6870900,64789476310,9100,8800,9550,450,4.95,9430,330,3.63,8710,9550,1399-11-8
413,سخواف,سيمان مجد خواف,606,3878723,81862652984,21753,21101,21101,-652,-3.0,21106,-647,-2.97,21101,21500,1399-11-8
414,اتكاي,بيمه اتكايي ايرانيان,597,2279294,35326093982,15903,16050,15120,-783,-4.92,15616,-287,-1.8,15108,16050,1399-11-8
415,وملي,گروه‌ صنعتي‌ ملي‌ (هلدينگ‌,594,147022,27426954100,196360,186550,186550,-9810,-5.0,190310,-6050,-3.08,186550,186550,1399-11-8
416,حپارسا,توسعه حمل و نقل ريلي پارسيان,594,1395432,46727687965,35173,33500,33415,-1758,-5.0,33486,-1687,-4.8,33415,34790,1399-11-8
417,ضخود2007,اختيارخ خودرو-3000-1400/02/08,583,21339,6441949000,316,300,305,-11,-3.48,302,-14,-4.43,256,323,1399-11-8
418,فجام,جام‌دارو,575,3133826,37693666200,12620,12240,11990,-630,-4.99,12210,-410,-3.25,11990,12240,1399-11-8
419,ثاژن,سخت آژند,570,4042784,36492824216,8870,8696,9047,177,2.0,9027,157,1.77,8696,9047,1399-11-8
420,سهگمت,سيمان‌هگمتان‌,568,3300532,78305979530,22660,22030,23790,1130,4.99,23730,1070,4.72,22030,23790,1399-11-8
421,قاسم,قاسم ايران,567,3953972,53988282402,14372,13654,13654,-718,-5.0,13654,-718,-5.0,13654,13900,1399-11-8
422,قزوين,كارخانجات‌ قند قزوين‌,565,883396,30681590740,36430,34620,34640,-1790,-4.91,35280,-1150,-3.16,34610,36000,1399-11-8
423,كپشير,پشم‌شيشه‌ايران‌,561,1909281,53620666320,26810,28150,28150,1340,5.0,28080,1270,4.74,26810,28150,1399-11-8
424,پرديس,سرمايه گذاري پرديس,560,4647877,29033604270,6360,6150,6300,-60,-0.94,6290,-70,-1.1,6050,6410,1399-11-8
425,فبيرا,بسته‌ بندي‌ ايران‌,553,6756728,21717234216,3312,3213,3213,-99,-2.99,3214,-98,-2.96,3213,3312,1399-11-8
426,زكشت,كشاورزي مكانيزه اصفهان كشت,547,1198280,38389580959,33461,32500,31788,-1673,-5.0,32230,-1231,-3.68,31788,33365,1399-11-8
427,پسهند,صنايع‌ لاستيكي‌  سهند,545,968464,33489562970,35650,33870,35100,-550,-1.54,34870,-780,-2.19,33870,36180,1399-11-8
428,وزمين,بانك ايران زمين,544,4238447,61576820717,14663,14900,14700,37,0.25,14528,-135,-0.92,14370,14950,1399-11-8
429,كرماشا,صنايع پتروشيمي كرمانشاه,544,939772,33714035540,35120,35150,35730,610,1.74,35620,500,1.42,35100,36400,1399-11-8
430,كاريس,صندوق س.سپهر كاريزما-س,537,3586151,38330305713,10843,10852,10790,-53,-0.49,10688,-155,-1.43,10500,11140,1399-11-8
431,دتماد,توليدمواداوليه‌داروپخش‌,536,639686,32927750750,50640,48760,51400,760,1.5,51210,570,1.13,48760,52770,1399-11-8
432,پارسيان,بيمه پارسيان,533,2341787,27180995900,11860,11510,11720,-140,-1.18,11730,-130,-1.1,11270,11990,1399-11-8
433,غشهد,شهد ايران ‌,530,7924988,54035851370,6520,6600,6840,320,4.91,6820,300,4.6,6600,6840,1399-11-8
434,غنوش,نوش‌ مازندران‌,527,1096622,61706919940,59230,56270,56270,-2960,-5.0,56270,-2960,-5.0,56270,56270,1399-11-8
435,سكه0012پ01,سكه تمام بهارتحويلي 1روزه رفاه,522,254300,267154542100,1023624,1058000,1046000,22376,2.19,1050549,26925,2.63,1040000,1060000,1399-11-8
436,دكيمي,كيميدارو,513,563587,13564810760,25250,23990,24010,-1240,-4.91,24900,-350,-1.39,23990,24530,1399-11-8
437,شيراز,پتروشيمي‌شيراز,507,1084693,59888275260,54840,54700,55300,460,0.84,55050,210,0.38,53770,56340,1399-11-8
438,سپاس,صندوق س. پاداش سهامداري توسعه1,504,22409393,226740790741,10099,10118,10116,17,0.17,10118,19,0.19,10088,10124,1399-11-8
439,سدبير,س. تدبيرگران فارس وخوزستان,503,722245,59564989640,78545,82472,82472,3927,5.0,82298,3753,4.78,82472,82472,1399-11-8
440,ياقوت,صندوق س ياقوت آگاه-ثابت,502,11617655,137135401604,11806,11804,11809,3,0.03,11804,-2,-0.02,11789,11809,1399-11-8
441,سپ,پرداخت الكترونيك سامان كيش,500,1680155,28715923120,17790,16920,16910,-880,-4.95,17330,-460,-2.59,16910,17690,1399-11-8
442,قشهد,شهد,495,836371,28634796200,35650,33900,33870,-1780,-4.99,34820,-830,-2.33,33870,36200,1399-11-8
443,ضصاد1101,اختيارخ وبصادر-3000-1399/11/12,493,24325,43057000,10,5,1,-9,-90.0,2,-8,-80.0,1,9,1399-11-8
444,كتوكاح,ح.توليدي وخدمات صنايع نسوزتوكا,492,1661121,36260479552,21234,22010,21849,615,2.9,21829,595,2.8,21270,22295,1399-11-8
445,دجابر,داروسازي‌ جابرابن‌حيان‌,490,1483161,30955747610,20520,21440,20770,250,1.22,20740,220,1.07,19610,21500,1399-11-8
446,وآفري,بيمه كارآفرين,484,3484948,64264418576,18974,18405,18405,-569,-3.0,18441,-533,-2.81,18405,19297,1399-11-8
447,ددام,داروسازي زاگرس فارمد پارس,484,2107823,48606398380,21970,23060,23060,1090,4.96,22900,930,4.23,23060,23060,1399-11-8
448,تماوند,تامين سرمايه دماوند,482,2540683,46194938093,18282,17520,18280,-2,-0.01,18182,-100,-0.55,17520,18500,1399-11-8
449,كسعدي,كاشي‌ سعدي‌,481,2017229,37157358180,17550,18420,18420,870,4.96,18230,680,3.87,18420,18420,1399-11-8
450,زر,صندوق س.پشتوانه سكه طلاي زر,477,769703,34365802052,43967,44530,44400,433,0.98,44648,681,1.55,44100,45499,1399-11-8
451,دلر,داروسازي‌ اكسير,475,767990,28185961790,38090,36250,36800,-1290,-3.39,37260,-830,-2.18,36190,39000,1399-11-8
452,دابور,داروسازي‌ ابوريحان‌,475,704256,25716401510,36630,36390,36640,10,0.03,36570,-60,-0.16,35020,37700,1399-11-8
453,دعبيد,لابراتوارداروسازي‌  دكترعبيدي‌,473,545240,13803884000,26430,25460,25560,-870,-3.29,26110,-320,-1.21,25110,26220,1399-11-8
454,كنور,توسعه معدني و صنعتي صبانور,470,1060772,46226209910,43810,41750,43270,-540,-1.23,43600,-210,-0.48,41750,45000,1399-11-8
455,شپاس,نفت پاسارگاد,469,1009511,23633169603,22835,22000,23675,840,3.68,23087,252,1.1,22000,23750,1399-11-8
456,غشوكو,شوكو پارس,462,461127,21955850209,48814,47360,47350,-1464,-3.0,47613,-1201,-2.46,47350,49490,1399-11-8
457,آساس,صندوق س.آسمان آرماني سهام-س,460,260890,42197470499,163455,158101,163524,69,0.04,161744,-1711,-1.05,155005,166260,1399-11-8
458,بمپنا,توليد برق عسلويه  مپنا,458,309360,23515447061,78551,74624,77000,-1551,-1.97,77221,-1330,-1.69,74624,80000,1399-11-8
459,وملت,سرمايه گذاري ملت,455,8607173,34126039269,3933,3855,4011,78,1.98,3965,32,0.81,3855,4011,1399-11-8
460,پارند,صندوق س. پارند پايدار سپهر,449,12997463,147082289081,11311,11324,11316,5,0.04,11316,5,0.04,11315,11324,1399-11-8
461,دارا,صندوق س. دارا الگوريتم-د,447,20316598,203129981764,9997,10005,10000,3,0.03,9998,1,0.01,9974,10010,1399-11-8
462,مارون,پتروشيمي مارون,446,365362,56287613996,152860,145225,155180,2320,1.52,153522,662,0.43,145225,159500,1399-11-8
463,سبهان,سيمان‌ بهبهان‌,444,527383,67900561250,122620,128750,128750,6130,5.0,128750,6130,5.0,128750,128750,1399-11-8
464,اطلس,صندوق س.توسعه اندوخته آينده-س,435,165329,32995657627,200792,195003,202000,1208,0.6,199576,-1216,-0.61,194000,203001,1399-11-8
465,خراسان,پتروشيمي خراسان,431,670692,43522138060,64090,64750,64730,640,1.0,64800,710,1.11,61690,66790,1399-11-8
466,ضخود2006,اختيارخ خودرو-2500-1400/02/08,428,17222,8144016000,497,515,460,-37,-7.44,473,-24,-4.83,447,530,1399-11-8
467,كوثر,بيمه كوثر,427,2844624,47584870272,17608,16728,16728,-880,-5.0,16728,-880,-5.0,16728,16728,1399-11-8
468,ثتوسا,س.توسعه و عمران استان اردبيل,426,780322,33079410224,41158,42392,42392,1234,3.0,42392,1234,3.0,42392,42392,1399-11-8
469,سبجنو,سيمان‌ بجنورد,418,1289248,54133677250,40100,41470,42100,2000,4.99,41990,1890,4.71,40630,42100,1399-11-8
470,آپ,آسان پرداخت پرشين,416,1523789,26248744870,18080,17190,17180,-900,-4.98,17570,-510,-2.82,17180,17990,1399-11-8
471,شفا,سرمايه گذاري شفادارو,409,466710,20158499180,43530,41410,43500,-30,-0.07,43380,-150,-0.34,41410,44950,1399-11-8
472,شراز,پالايش نفت شيراز,408,215089,21567368836,99350,94390,100270,920,0.93,99737,387,0.39,94390,104000,1399-11-8
473,جم پيلن,پلي پروپيلن جم - جم پيلن,403,392464,27544525930,71950,71900,70670,-1280,-1.78,71080,-870,-1.21,68360,72400,1399-11-8
474,وصندوق,سرمايه‌گذاري‌صندوق‌بازنشستگي‌,397,3376449,43048165590,12690,12700,12810,120,0.95,12710,20,0.16,12110,13120,1399-11-8
475,شاملا,معدني‌ املاح‌  ايران‌,396,402039,22995797850,60070,57070,57070,-3000,-4.99,58730,-1340,-2.23,57070,58780,1399-11-8
476,خكرمان,گروه اقتصادي كرمان خودرو,395,5362034,25898624220,4979,4830,4830,-149,-2.99,4830,-149,-2.99,4830,4830,1399-11-8
477,حتوكا,حمل‌ونقل‌توكا,393,1638434,57738414160,37090,35240,35240,-1850,-4.99,35240,-1850,-4.99,35240,35240,1399-11-8
478,آتيمس,صندوق س.آرمان آتيه درخشان مس-س,389,135990,24406313690,179994,178910,181470,1476,0.82,179471,-523,-0.29,170120,184500,1399-11-8
479,اوان,مبين وان كيش,389,700179,35097937802,51388,49040,50699,-689,-1.34,50456,-932,-1.81,49040,52000,1399-11-8
480,دسبحان,سبحان دارو,388,1125790,21404332510,19660,18760,19310,-350,-1.78,19350,-310,-1.58,18680,19660,1399-11-8
481,وسنا,سرمايه گذاري نيروگاهي ايران,386,1672987,30547790721,19181,18849,18222,-959,-5.0,18259,-922,-4.81,18222,18849,1399-11-8
482,ماديرا,صنايع ماشين هاي اداري ايران,385,2142739,21628807466,10625,10094,10094,-531,-5.0,10372,-253,-2.38,10094,10094,1399-11-8
483,عيار,صندوق س. پشتوانه طلاي مفيد,383,589123,15301692002,25087,26110,25807,720,2.87,25974,887,3.54,25650,26496,1399-11-8
484,ثالوند,سرمايه گذاري مسكن الوند,375,1619693,39705154202,23347,24514,24514,1167,5.0,24107,760,3.26,24514,24514,1399-11-8
485,قپيرا,فرآورده‌هاي‌غدايي‌وقندپيرانشهر,375,272029,30264788140,117010,111160,111160,-5850,-5.0,113410,-3600,-3.08,111160,116930,1399-11-8
486,خفولا,خدمات فني فولاد يزد,374,1494284,122594047928,79653,82042,82042,2389,3.0,82042,2389,3.0,82042,82042,1399-11-8
487,كمينا,شيشه سازي مينا,369,915112,26209310686,30112,28608,28607,-1505,-5.0,28641,-1471,-4.89,28607,29810,1399-11-8
488,درازك,دارويي‌ رازك‌,363,551227,20728885720,37600,37600,37520,-80,-0.21,37600,0,0.0,35740,38790,1399-11-8
489,مفاخر,توسعه فناوري اطلاعات خوارزمي,361,868346,40147883783,44038,46239,46239,2201,5.0,45708,1670,3.79,45000,46239,1399-11-8
490,دالبر,البرزدارو,351,902650,17042895220,19520,18780,18810,-710,-3.64,19280,-240,-1.23,18560,19400,1399-11-8
491,حخزر,كشتيراني درياي خزر,349,1203530,29187218303,25098,23844,24330,-768,-3.06,24577,-521,-2.08,23844,25020,1399-11-8
492,تصميم,صندوق س با درآمد ثابت تصميم,348,8254631,128081350164,15495,15520,15521,26,0.17,15516,21,0.14,15500,15524,1399-11-8
493,دفرا,فرآورده‌هاي‌ تزريقي‌ ايران‌,339,547051,15143420470,28110,28500,27630,-480,-1.71,27970,-140,-0.5,26800,28500,1399-11-8
494,شپترو,پتروشيمي آبادان,331,4657259,22587706150,5105,4850,4850,-255,-5.0,4850,-255,-5.0,4850,4850,1399-11-8
495,كخاك,صنايع‌خاك‌چيني‌ايران‌,329,570860,27176586670,48990,47200,48220,-770,-1.57,48210,-780,-1.59,46550,49470,1399-11-8
496,قهكمت,قندهكمتان‌,329,365758,15702066480,44790,42560,43330,-1460,-3.26,44190,-600,-1.34,42560,43800,1399-11-8
497,غمينو,شركت صنايع غذايي مينو شرق,329,1032707,15500932070,15799,15010,15010,-789,-4.99,15513,-286,-1.81,15010,15010,1399-11-8
498,ولتجار,واسپاري تجارت وسرمايه ايرانيان,320,4314871,35896493783,8549,8500,8293,-256,-2.99,8319,-230,-2.69,8293,8610,1399-11-8
499,دسبحا,گروه دارويي سبحان,320,582650,9674107020,17240,16390,16720,-520,-3.02,17100,-140,-0.81,16380,17100,1399-11-8
500,كمرجان,بازرگاني و توليدي مرجان كار,314,286381,33271458199,110647,116179,116179,5532,5.0,113840,3193,2.89,116179,116179,1399-11-8
501,كتوكا,توليدي و خدمات صنايع نسوز توكا,308,904189,26846798397,28324,29740,29740,1416,5.0,29073,749,2.64,28003,29740,1399-11-8
502,شكبير,پتروشيمي اميركبير,305,1669225,140126621327,81522,83950,83967,2445,3.0,83947,2425,2.97,79210,83967,1399-11-8
503,غويتاح,ح . ويتانا,305,1330630,21955395000,5515,16500,16500,10985,199.18,16500,10985,199.18,16500,16500,1399-11-8
504,ختور,رادياتور ايران‌,303,693584,19052752480,28910,27470,27470,-1440,-4.98,28260,-650,-2.25,27470,27470,1399-11-8
505,ثنوسا,نوسازي‌وساختمان‌تهران‌,296,2249330,29443729700,13770,13090,13090,-680,-4.94,13330,-440,-3.2,13090,13090,1399-11-8
506,دسينا,داروسازي‌ سينا,291,577928,15691902690,27590,26220,27700,110,0.4,27440,-150,-0.54,26220,28880,1399-11-8
507,دقاضي,داروسازي شهيد قاضي,280,318916,15616063254,48135,46700,49579,1444,3.0,48811,676,1.4,46700,49579,1399-11-8
508,كرازي,كارخانجات‌توليدي‌شيشه‌رازي‌,279,1086811,29615599750,28680,27250,27250,-1430,-4.99,27690,-990,-3.45,27250,27250,1399-11-8
509,قشكر,شكرشاهرود,277,4830294,19369478940,3820,4010,4010,190,4.97,3890,70,1.83,4010,4010,1399-11-8
510,اپرداز,آتيه داده پرداز,276,1990068,41751626640,22084,20980,20980,-1104,-5.0,21017,-1067,-4.83,20980,20980,1399-11-8
511,آكورد,صندوق س. آرمان آتي كوثر-د,274,5491201,167328394980,30462,30477,30470,8,0.03,30472,10,0.03,30469,30477,1399-11-8
512,ضسپا1102,اختيارخ خساپا-2000-1399/11/26,268,9941,2048171000,212,200,219,7,3.3,206,-6,-2.83,142,268,1399-11-8
513,ثنور,سرمايه گذاري كوه نور,267,4583199,59141599896,13303,12904,12904,-399,-3.0,12904,-399,-3.0,12904,12904,1399-11-8
514,داسوه,داروسازي‌ اسوه‌,266,419033,18479355300,42000,44100,44100,2100,5.0,42680,680,1.62,44100,44100,1399-11-8
515,تسه9907,امتياز تسهيلات مسكن مهر99,262,8042,4298777422,518788,500000,530000,11212,2.16,534541,15753,3.04,500000,544444,1399-11-8
516,هجرتح,ح . پخش هجرت,259,744706,15589731251,21947,21700,21457,-490,-2.23,20934,-1013,-4.62,20850,22000,1399-11-8
517,وپخش,داروپخش‌ (هلدينگ‌,254,134515,15027388640,113050,110000,113880,830,0.73,112630,-420,-0.37,107400,114000,1399-11-8
518,زشگزا,شير و گوشت زاگرس شهركرد,251,1841041,17475161172,9991,9492,9492,-499,-4.99,9788,-203,-2.03,9492,9492,1399-11-8
519,وتوصا,گروه س توسعه صنعتي ايران,249,3329624,53706835120,16970,16130,16130,-840,-4.95,16130,-840,-4.95,16130,16130,1399-11-8
520,شصفها,پتروشيمي‌ اصفهان‌,244,185206,22498571958,123934,121456,121456,-2478,-2.0,121479,-2455,-1.98,121456,122694,1399-11-8
521,ساراب,سيمان‌ داراب‌,241,1138293,16755672960,14020,14720,14720,700,4.99,14220,200,1.43,14720,14720,1399-11-8
522,آرمانح,ح.بيمه آرمان,239,3474583,27828905786,7927,7693,8100,173,2.18,8009,82,1.03,7693,8164,1399-11-8
523,وگردش,بانك گردشگري,237,1244575,25673093100,21713,20628,20628,-1085,-5.0,21392,-321,-1.48,20628,20628,1399-11-8
524,حسير,ريل سير كوثر,231,1267776,22726152576,17073,17926,17926,853,5.0,17431,358,2.1,17926,17926,1399-11-8
525,غشاذر,پگاه‌آذربايجان‌غربي‌,219,732688,17577197570,25250,23990,23990,-1260,-4.99,24780,-470,-1.86,23990,24000,1399-11-8
526,ثفارس,عمران‌وتوسعه‌فارس‌,218,997910,11246445700,11860,11270,11270,-590,-4.97,11700,-160,-1.35,11270,11270,1399-11-8
527,خفنر,فنرسازي‌خاور,217,1074198,25727042100,22810,23950,23950,1140,5.0,23370,560,2.46,23950,23950,1399-11-8
528,وثوق,سرمايه گذاري وثوق امين,215,330449,8483947626,24927,25674,25674,747,3.0,25207,280,1.12,25674,25674,1399-11-8
529,زنگان,صنعت روي زنگان,212,246179,27660672440,107010,112360,112360,5350,5.0,109986,2976,2.78,112360,112360,1399-11-8
530,افق ملت,صندوق س در سهام افق ملت,204,67736,8260861350,124560,122000,122200,-2360,-1.89,121960,-2600,-2.09,120500,124470,1399-11-8
531,فسا,پتروشيمي فسا,203,3023158,5867949678,2043,1941,1941,-102,-4.99,2010,-33,-1.62,1941,1941,1399-11-8
532,دپارس,پارس‌ دارو,202,78333,6549659540,86120,82060,86200,80,0.09,85770,-350,-0.41,82060,86200,1399-11-8
533,خرينگ,رينگ‌سازي‌مشهد,200,203187,10655126280,55190,52440,52440,-2750,-4.98,54480,-710,-1.29,52440,52440,1399-11-8
534,ولراز,ليزينگ رازي,198,315767,17819679111,54790,56433,56433,1643,3.0,56170,1380,2.52,56433,56433,1399-11-8
535,فيروزا,صندوق بادرآمد ثابت فيروزه آسيا,197,5581650,122915967997,22019,22118,22023,4,0.02,22021,2,0.01,22001,22118,1399-11-8
536,سكه9912پ04,سكه تمام بهارتحويل1روزه صادرات,193,133900,140522246100,1019506,1060000,1048000,28494,2.79,1049457,29951,2.94,1040000,1061000,1399-11-8
537,تسه9902,امتياز تسهيلات مسكن ارديبهشت99,191,2093,1086779492,508261,491000,533674,25413,5.0,519245,10984,2.16,491000,533674,1399-11-8
538,تسه9810,امتياز تسهيلات مسكن دي98,190,3436,1789079636,523484,497310,506000,-17484,-3.34,520687,-2797,-0.53,497310,549657,1399-11-8
539,ضپاس2002,اختيارخ وپارس-3000-1400/02/29,189,5293,3045137000,585,550,575,-10,-1.71,575,-10,-1.71,520,650,1399-11-8
540,شتوكا,توكا رنگ فولاد سپاهان,185,160088,9831644432,64646,61414,61414,-3232,-5.0,63963,-683,-1.06,61414,61414,1399-11-8
541,ضخود2005,اختيارخ خودرو-2000-1400/02/08,183,5169,4104716000,777,760,787,10,1.29,794,17,2.19,670,820,1399-11-8
542,گدنا,تهيه توزيع غذاي دنا آفرين فدك,182,1061719,35413637245,35110,33355,33355,-1755,-5.0,33783,-1327,-3.78,33355,33355,1399-11-8
543,آينده,بازرگاني آينده سازان بهشت پارس,181,305745,7720978485,24518,25253,25253,735,3.0,24762,244,1.0,25253,25253,1399-11-8
544,تسه9906,امتياز تسهيلات مسكن شهريور99,178,3583,1880452666,516094,505600,520000,3906,0.76,524826,8732,1.69,505600,541898,1399-11-8
545,وجامي,سرمايه گذاري جامي,176,1192491,18729263646,14959,15706,15706,747,4.99,15585,626,4.18,15706,15706,1399-11-8
546,گپارس,امور رفاهي كارگزاران پارس,172,49863,9662089575,184548,193775,193775,9227,5.0,188779,4231,2.29,190000,193775,1399-11-8
547,بالاس,مهندسي ساختمان تاسيسات راه آهن,171,483899,28499715504,61995,58896,58896,-3099,-5.0,60042,-1953,-3.15,58896,58896,1399-11-8
548,شفارس,صنايع‌ شيميايي‌ فارس‌,170,484674,20836135260,45250,42990,42990,-2260,-4.99,44210,-1040,-2.3,42990,42990,1399-11-8
549,كدما,معدني‌ دماوند,168,23874,6128217060,270190,256690,256690,-13500,-5.0,268350,-1840,-0.68,256690,256690,1399-11-8
550,تسه9905,امتياز تسهيلات مسكن مرداد99,167,4741,2507702834,528568,512222,510100,-18468,-3.49,528940,372,0.07,503001,554996,1399-11-8
551,غمهرا,توليدي‌مهرام‌,163,258765,23733925800,87360,91720,91720,4360,4.99,89110,1750,2.0,91720,91720,1399-11-8
552,وتعاون,بيمه  تعاون,162,1075639,7416530905,7108,6895,6895,-213,-3.0,7019,-89,-1.25,6895,6895,1399-11-8
553,ميهن,بيمه ميهن,162,1789403,8977434851,5281,5017,5017,-264,-5.0,5230,-51,-0.97,5017,5017,1399-11-8
554,تسه9904,امتياز تسهيلات مسكن تير99,161,3437,1801595267,520619,510000,518005,-2614,-0.5,524177,3558,0.68,495815,540000,1399-11-8
555,تسه9712,امتياز تسهيلات مسكن اسفند97,161,1993,1030811185,511081,487180,506199,-4882,-0.96,517216,6135,1.2,487180,536630,1399-11-8
556,دروز,داروسازي‌ روزدارو,159,1046996,25044144320,22790,23920,23920,1130,4.96,23280,490,2.15,23920,23920,1399-11-8
557,پلوله,گازلوله‌,154,314022,5829920158,18690,18876,18504,-186,-1.0,18565,-125,-0.67,18504,18876,1399-11-8
558,وبيمه,سرمايه‌ گذاري‌ صنعت‌ بيمه‌,154,3945858,12389994120,3300,3140,3140,-160,-4.85,3260,-40,-1.21,3140,3140,1399-11-8
559,تسه9903,امتياز تسهيلات مسكن خرداد99,153,2408,1259207605,519425,503005,510000,-9425,-1.81,522927,3502,0.67,493454,530011,1399-11-8
560,شدوص,دوده‌ صنعتي‌ پارس‌,151,631173,17268893280,28800,27360,27360,-1440,-5.0,28240,-560,-1.94,27360,27360,1399-11-8
561,گكيش,توريستي ورفاهي آبادگران كيش,149,261137,21352911353,79388,81769,81769,2381,3.0,81769,2381,3.0,81769,81769,1399-11-8
562,واحصا,احياء صنايع خراسان,149,359054,22432257704,59501,62476,62476,2975,5.0,62454,2953,4.96,62476,62476,1399-11-8
563,نتوس,پشم‌ بافي‌ توس,147,344505,7075099185,19939,20537,20537,598,3.0,20123,184,0.92,20537,20537,1399-11-8
564,غاذر,كشت‌وصنعت‌پياذر,145,387995,19783865050,53670,50990,50990,-2680,-4.99,52460,-1210,-2.25,50990,50990,1399-11-8
565,ومشان,س. فني و مهندسي مشانير,145,146001,12106548921,80506,82921,82921,2415,3.0,81911,1405,1.75,82921,82921,1399-11-8
566,كاسپين,داروسازي كاسپين تامين,142,743815,19073004820,26983,25634,25634,-1349,-5.0,26425,-558,-2.07,25634,26030,1399-11-8
567,ثشرق,سرمايه گذاري مسكن شمال شرق,142,1399949,8189701650,6150,5850,5850,-300,-4.88,6100,-50,-0.81,5850,5850,1399-11-8
568,بميلا,توسعه بازرگاني آهن وفولادميلاد,141,1158804,25323343812,23003,21853,21853,-1150,-5.0,21853,-1150,-5.0,21853,21853,1399-11-8
569,وتوس,توسعه‌شهري‌توس‌گستر,141,1351426,25014895260,19480,18510,18510,-970,-4.98,18900,-580,-2.98,18510,18510,1399-11-8
570,غگرجي,بيسكويت‌  گرجي‌,137,1247301,28288786680,23870,22680,22680,-1190,-4.99,23120,-750,-3.14,22680,22680,1399-11-8
571,تسه9711,امتياز تسهيلات مسكن بهمن 97,137,1958,985233022,511499,492010,505100,-6399,-1.25,503183,-8316,-1.63,492010,524000,1399-11-8
572,زعف0008پ10,زعفران0008نگين طلاي سرخ(پ),136,305320,38794671980,126176,127500,128800,2624,2.08,127062,886,0.7,125570,128990,1399-11-8
573,ثرود,سرمايه‌گذاري مسكن زاينده رود,135,1490222,19356493558,13672,12989,12989,-683,-5.0,13391,-281,-2.06,12989,12989,1399-11-8
574,خموتور,موتورسازان‌تراكتورسازي‌ايران‌,131,1409190,30283493100,22620,21490,21490,-1130,-5.0,21780,-840,-3.71,21490,21490,1399-11-8
575,جهرم,پتروشيمي جهرم,131,1536924,3212171160,2200,2090,2090,-110,-5.0,2181,-19,-0.86,2090,2090,1399-11-8
576,فنفت,صنايع تجهيزات نفت,130,544729,13916187263,24803,25547,25547,744,3.0,25304,501,2.02,25538,25547,1399-11-8
577,غشان,شيرپاستوريزه‌پگاه‌خراسان‌,130,1747559,11708645300,7050,6700,6700,-350,-4.96,6960,-90,-1.28,6700,6700,1399-11-8
578,زپارس,ملي كشت و صنعت و دامپروري پارس,126,131306,16381736560,118820,124760,124760,5940,5.0,120760,1940,1.63,124760,124760,1399-11-8
579,آساميد,صندوق س.مشترك آسمان اميد -د,126,3839704,44052048011,11457,11468,11465,8,0.07,11473,16,0.14,11459,11476,1399-11-8
580,تسه9801,امتياز تسهيلات مسكن فروردين98,126,1215,638808361,523855,503010,529000,5145,0.98,525768,1913,0.37,503010,550047,1399-11-8
581,گوهر,صندوق سكه طلاي كيان,124,34055,1781027677,50570,52499,51901,1331,2.63,52299,1729,3.42,51901,53200,1399-11-8
582,غبهار,كشت وصنعت بهاران گلبهار خراسان,123,365756,14940401088,42111,40848,40848,-1263,-3.0,41093,-1018,-2.42,40848,40848,1399-11-8
583,تسه9802,امتياز تسهيلات مسكن ارديبهشت98,119,1308,684265878,530584,509062,530001,-583,-0.11,523139,-7445,-1.4,509062,533950,1399-11-8
584,چكاوه,صنايع‌كاغذسازي‌كاوه‌,117,365754,5116898460,13330,13990,13990,660,4.95,13390,60,0.45,13990,13990,1399-11-8
585,فافزا,فولاد افزا سپاهان,117,303322,17252045394,55221,56877,56877,1656,3.0,56504,1283,2.32,56877,56877,1399-11-8
586,تابا,تابان نيرو سپاهان,113,436434,23035859388,50269,52782,52782,2513,5.0,52724,2455,4.88,52782,52782,1399-11-8
587,افران,صندوق س افرا نماد پايدار-ثابت,113,3728916,46833776736,12549,12555,12560,11,0.09,12560,11,0.09,12552,12570,1399-11-8
588,شتولي,تولي‌پرس‌,111,242678,8169269514,32369,33663,33663,1294,4.0,33348,979,3.02,33663,33663,1399-11-8
589,اخزا903,اسنادخزانه-م3بودجه99-011110,106,454508,314147323065,690556,688109,695999,5443,0.79,691181,625,0.09,688109,697000,1399-11-8
590,غفارس,شير پاستوريزه پگاه فارس,104,796035,8379064410,11080,10526,10526,-554,-5.0,10974,-106,-0.96,10526,10526,1399-11-8
591,اخزا909,اسنادخزانه-م9بودجه99-020316,102,461862,294127759930,638785,635001,637000,-1785,-0.28,636830,-1955,-0.31,633136,638000,1399-11-8
592,دقاضيح,ح . داروسازي شهيد قاضي,102,169373,6418194451,38834,37700,37669,-1165,-3.0,37894,-940,-2.42,37669,39500,1399-11-8
593,اخزا902,اسنادخزانه-م2بودجه99-011019,102,412442,287979696011,699130,695100,697361,-1769,-0.25,698231,-899,-0.13,690000,701000,1399-11-8
594,تسه9803,امتياز تسهيلات مسكن خرداد98,101,859,445331947,516020,491500,522755,6735,1.31,518431,2411,0.47,491500,530000,1399-11-8
595,افرا,افرانت,99,309146,11821124748,40250,38238,38238,-2012,-5.0,39693,-557,-1.38,38238,38238,1399-11-8
596,دمعيار,صندوق س. توازن معيار-د,98,2761669,27727721160,10032,10040,10040,8,0.08,10040,8,0.08,10039,10042,1399-11-8
597,صايند,صندوق س. گنجينه آينده روشن-د,98,1922940,19352357170,10052,10035,10080,28,0.28,10064,12,0.12,10035,10080,1399-11-8
598,ضشنا2001,اختيارخ شپنا-10000-1400/02/27,97,1754,5157727000,2882,2500,3160,278,9.65,2941,59,2.05,2500,3160,1399-11-8
599,حاريا,كشتيراني آريا,95,199906,6880764520,35484,34420,34420,-1064,-3.0,35099,-385,-1.08,34420,34420,1399-11-8
600,ضخود2008,اختيارخ خودرو-3500-1400/02/08,94,3390,671638000,203,219,190,-13,-6.4,198,-5,-2.46,190,219,1399-11-8
601,ساروجح,ح . بين المللي ساروج بوشهر,94,3580191,71606008000,20000,20000,20000,0,0.0,20001,1,0.01,20000,21200,1399-11-8
602,ثقزوي,شركت عمران و سازندگي قزوين,93,126459,4522426758,36868,35762,35762,-1106,-3.0,36598,-270,-0.73,35762,35762,1399-11-8
603,ارمغان,ص سرمايه گذاري ارمغان ايرانيان,92,2809994,28474608163,10140,10133,10143,3,0.03,10133,-7,-0.07,10130,10145,1399-11-8
604,تسه9812,امتياز تسهيلات مسكن اسفند98,92,757,391508838,503823,511000,510010,6187,1.23,517185,13362,2.65,490122,529014,1399-11-8
605,تسه9901,امتياز تسهيلات مسكن فروردين99,92,882,462013486,514124,500000,520500,6376,1.24,523825,9701,1.89,500000,539830,1399-11-8
606,زعف0008پ11,زعفران0008نگين سحرخيز(پ),91,158547,19956816645,125814,125814,126000,186,0.15,125873,59,0.05,123210,127000,1399-11-8
607,اخزا820,اسنادخزانه-م20بودجه98-020806,90,138329,83256158927,598598,604000,602000,3402,0.57,601871,3273,0.55,599500,604994,1399-11-8
608,زگلدشت,كشت و دام گلدشت نمونه اصفهان,88,252989,13658623121,56830,53989,53989,-2841,-5.0,55966,-864,-1.52,53989,53989,1399-11-8
609,كفرا,فراورده‌ هاي‌ نسوزايران‌,87,149138,7526994860,53120,50470,50470,-2650,-4.99,52670,-450,-0.85,50470,50470,1399-11-8
610,چافست,افست‌,87,278562,4532203740,17120,16270,16270,-850,-4.96,17030,-90,-0.53,16270,16270,1399-11-8
611,تسه9811,امتياز تسهيلات مسكن بهمن98,86,805,417275067,515477,490088,500200,-15277,-2.96,518354,2877,0.56,489894,535000,1399-11-8
612,لخانه,لوازم‌ خانگي‌ پارس‌,85,195398,5419363530,26928,27735,27735,807,3.0,27129,201,0.75,27735,27735,1399-11-8
613,كسرام,پارس‌ سرام‌,84,276402,2990669640,11380,10820,10820,-560,-4.92,11340,-40,-0.35,10820,10820,1399-11-8
614,سكارون,سيمان كارون,81,29837,6147466295,212407,206035,206035,-6372,-3.0,210285,-2122,-1.0,206035,206035,1399-11-8
615,دتوزيع,توزيع دارو پخش,81,316310,16827692000,51795,53200,53200,1405,2.71,52264,469,0.91,53200,53200,1399-11-8
616,شكف,كف,80,119511,10102742874,82877,84534,84534,1657,2.0,84534,1657,2.0,84534,84534,1399-11-8
617,خكار,ايركا پارت صنعت,79,292487,6349892770,22850,21710,21710,-1140,-4.99,22680,-170,-0.74,21710,21710,1399-11-8
618,ثغرب,شركت سرمايه گذاري مسكن شمالغرب,79,382793,2932959966,8065,7662,7662,-403,-5.0,8038,-27,-0.33,7662,7662,1399-11-8
619,ضخود2009,اختيارخ خودرو-4000-1400/02/08,78,3255,484959000,167,150,149,-18,-10.78,149,-18,-10.78,145,150,1399-11-8
620,داوه,داروسازي آوه سينا,77,391625,8405055750,22591,21462,21462,-1129,-5.0,22377,-214,-0.95,21462,21462,1399-11-8
621,شساخت,مهندسي و ساختمان صنايع نفت,75,741142,29152820570,40551,39335,39335,-1216,-3.0,39657,-894,-2.2,39335,39335,1399-11-8
622,ضصاد1100,اختيارخ وبصادر-2500-1399/11/12,74,2568,421643000,202,120,159,-43,-21.29,164,-38,-18.81,105,190,1399-11-8
623,سكه0011پ02,سكه تمام بهارتحويلي 1روزه ملت,74,14300,14999688200,1022073,1058500,1044799,22726,2.22,1048929,26856,2.63,1035011,1060000,1399-11-8
624,ركيش,كارت اعتباري ايران كيش,71,185516,4133296480,23450,22280,22280,-1170,-4.99,23350,-100,-0.43,22280,22280,1399-11-8
625,وسرمد,بيمه  سرمد,71,2073033,14376483855,7149,6935,6935,-214,-2.99,6985,-164,-2.29,6935,6935,1399-11-8
626,سفارود,كارخانه فارسيت درود,69,178868,3065260916,16801,17137,17137,336,2.0,16896,95,0.57,17137,17137,1399-11-8
627,پلاست,كارخانجات توليدي پلاستيران,69,143523,9720238698,65754,67726,67726,1972,3.0,66614,860,1.31,67726,67726,1399-11-8
628,تشتاد,صنايع توليدي اشتاد ايران‌,69,317389,5204227433,17260,16397,16397,-863,-5.0,17010,-250,-1.45,16397,16397,1399-11-8
629,سپر,صندوق س سپر سرمايه بيدار- ثابت,64,371374,4164375077,11167,11206,11230,63,0.56,11213,46,0.41,11206,11230,1399-11-8
630,ضسپا1103,اختيارخ خساپا-2500-1399/11/26,64,3657,188618000,44,48,55,11,25.0,52,8,18.18,45,60,1399-11-8
631,بايكا,كارخانجات كابلسازي ‌ايران‌,63,144479,6953918749,49619,48131,48131,-1488,-3.0,49025,-594,-1.2,48131,48131,1399-11-8
632,ضشنا2000,اختيارخ شپنا-9000-1400/02/27,63,1268,4617777000,2923,3500,3900,977,33.42,3642,719,24.6,3398,3900,1399-11-8
633,زعف0008پ05,زعفران0008نگين زرين(پ),63,81286,10137073080,124397,125000,124200,-197,-0.16,124709,312,0.25,124200,125200,1399-11-8
634,تكنار,مجتمع معادن مس تكنار,62,162948,27992348076,163607,171787,171787,8180,5.0,171787,8180,5.0,171787,171787,1399-11-8
635,كارين,صندوق س نگين سامان-ثابت,61,1762996,17751261827,10042,10050,10070,28,0.28,10069,27,0.27,10050,10080,1399-11-8
636,تسه9808,امتياز تسهيلات مسكن آبان98,59,992,512710239,504511,520000,505000,489,0.1,516845,12334,2.44,479286,529736,1399-11-8
637,ضسپا1101,اختيارخ خساپا-1800-1399/11/26,58,1882,621211000,327,285,350,23,7.03,330,3,0.92,270,400,1399-11-8
638,تسه9809,امتياز تسهيلات مسكن آذر98,56,557,288465913,509476,510000,500600,-8876,-1.74,517892,8416,1.65,488003,534949,1399-11-8
639,سفاسي,شركت فارسيت اهواز,56,132476,2004759308,15601,15133,15133,-468,-3.0,15549,-52,-0.33,15133,15133,1399-11-8
640,الماس,صندوق س.امين تدبيرگران فردا-س,56,20082,2180234873,109591,107005,109300,-291,-0.27,108567,-1024,-0.93,107000,112244,1399-11-8
641,شرنگي,شيميايي رنگين,55,67561,10852863918,155960,160638,160638,4678,3.0,158250,2290,1.47,160638,160638,1399-11-8
642,سكه0112پ03,سكه تمام بهارتحويلي1روزه سامان,55,13000,13659760500,1015384,1060000,1046000,30616,3.02,1050751,35367,3.48,1037000,1060000,1399-11-8
643,تاپكيشح,ح.تجارت الكترونيك پارسيان كيش,52,253866,4945999216,20374,21392,19356,-1018,-5.0,19483,-891,-4.37,19356,21392,1399-11-8
644,اخزا815,اسنادخزانه-م15بودجه98-010406,52,289640,225739408654,777704,780000,777004,-700,-0.09,779379,1675,0.22,775000,781000,1399-11-8
645,وايرا,سرمايه گذاري صنايع ايران,52,594633,7356799476,13023,12372,12372,-651,-5.0,12762,-261,-2.0,12372,12372,1399-11-8
646,تسه9806,امتياز تسهيلات مسكن شهريور98,50,674,342647428,507814,482424,518500,10686,2.1,508379,565,0.11,482424,533204,1399-11-8
647,كيان2,صندوق س. با درآمد ثابت كيان,50,5000000,5000000,26913,1,1,-26912,-100.0,1,-26912,-100.0,1,1,1399-11-8
648,ضسپا1105,اختيارخ خساپا-3500-1399/11/26,50,2601,2602000,2,1,2,0,0.0,1,-1,-50.0,1,2,1399-11-8
649,آكورد2,صندوق س. آرمان آتي كوثر-د,50,5000000,5000000,30462,1,1,-30461,-100.0,1,-30461,-100.0,1,1,1399-11-8
650,اخزا901,اسنادخزانه-م1بودجه99-010621,49,28938,21509074174,741197,740731,742016,819,0.11,743281,2084,0.28,740731,759995,1399-11-8
651,ضشنا2002,اختيارخ شپنا-12000-1400/02/27,47,1206,2432990000,2019,1600,2150,131,6.49,2017,-2,-0.1,1600,2990,1399-11-8
652,ثپرديس,سرمايه گذاري مسكن پرديس,46,307019,3604096041,12356,11739,11739,-617,-4.99,12308,-48,-0.39,11739,11739,1399-11-8
653,سايرا,ايرانيت‌,44,135082,5809471574,42164,43007,43007,843,2.0,42644,480,1.14,43007,43007,1399-11-8
654,صنوين,صندوق سرمايه‌گذاري صنوين-مختلط,44,15576,1551126230,100040,99000,99360,-680,-0.68,99580,-460,-0.46,99000,100100,1399-11-8
655,اخزا905,اسنادخزانه-م5بودجه99-020218,42,53397,34338140862,647224,635746,647998,774,0.12,643072,-4152,-0.64,634010,649980,1399-11-8
656,خاتم,صندوق س خاتم ايساتيس پويا-ثابت,42,243303,2545031770,10446,10460,10463,17,0.16,10460,14,0.13,10452,10463,1399-11-8
657,بذر,صندوق س بذر اميد آفرين-سهام,41,33576,3280991790,98860,97330,98100,-760,-0.77,97720,-1140,-1.15,96100,98300,1399-11-8
658,دتوزيعح,ح . توزيع دارو پخش,41,50283,1769961600,34700,35200,35200,500,1.44,35200,500,1.44,35200,35200,1399-11-8
659,تسه9807,امتياز تسهيلات مسكن مهر98,40,540,281386825,508158,509000,530000,21842,4.3,521087,12929,2.54,509000,533565,1399-11-8
660,ضخود2013,اختيارخ خودرو-7000-1400/02/08,40,1404,35122000,28,23,25,-3,-10.71,25,-3,-10.71,23,28,1399-11-8
661,ضفلا1151,اختيارخ فولاد-8000-1399/11/28,39,502,1614120000,2988,2999,3650,662,22.16,3215,227,7.6,2999,3650,1399-11-8
662,ثنظام,س. ساختماني نظام مهندسي ايران,36,75538,3739735304,51039,49508,49508,-1531,-3.0,50743,-296,-0.58,49508,49508,1399-11-8
663,ثروتم,صندوق س. ثروت آفرين پارسيان-س,36,11740,940187800,81646,75150,80500,-1146,-1.4,80084,-1562,-1.91,75150,85870,1399-11-8
664,دشيري,شيرين دارو,35,60828,14479132152,231101,238034,238034,6933,3.0,235691,4590,1.99,238034,238034,1399-11-8
665,آسام,صندوق س.آرمان سپهر آشنا-م,35,32990,3411312230,102627,103999,104100,1473,1.44,103404,777,0.76,101328,104900,1399-11-8
666,سدشت,صنايع سيمان دشتستان,35,34708,1562554160,42880,45020,45020,2140,4.99,42940,60,0.14,45020,45020,1399-11-8
667,ضملت1128,اختيارخ وبملت-6000-1399/11/28,34,1405,18938000,15,10,14,-1,-6.67,13,-2,-13.33,10,15,1399-11-8
668,اخزا817,اسنادخزانه-م17بودجه98-010512,34,63706,48744132653,764997,762252,763804,-1193,-0.16,765142,145,0.02,762252,767998,1399-11-8
669,اوصتا,صندوق انديشه ورزان صباتامين -د,33,599062,10640522159,17752,17762,17762,10,0.06,17762,10,0.06,17756,17762,1399-11-8
670,ضسپا1104,اختيارخ خساپا-3000-1399/11/26,33,1107,4938000,7,5,4,-3,-42.86,4,-3,-42.86,2,7,1399-11-8
671,ضپاس2001,اختيارخ وپارس-2500-1400/02/29,33,386,328422000,850,780,890,40,4.71,851,1,0.12,750,899,1399-11-8
672,ضسپا1100,اختيارخ خساپا-1600-1399/11/26,33,824,427819000,501,470,547,46,9.18,519,18,3.59,470,552,1399-11-8
673,تسه9805,امتياز تسهيلات مسكن مرداد98,31,253,129333666,514174,495000,529900,15726,3.06,511200,-2974,-0.58,495000,529900,1399-11-8
674,دارا2,صندوق س. دارا الگوريتم-د,30,3000000,3000000,9997,1,1,-9996,-99.99,1,-9996,-99.99,1,1,1399-11-8
675,اخزا907,اسنادخزانه-م7بودجه99-020704,30,78599,47146903983,599935,597210,600000,65,0.01,599841,-94,-0.02,597201,601000,1399-11-8
676,كقزوي,شيشه‌ قزوين‌,30,115799,1214731510,10814,10490,10490,-324,-3.0,10792,-22,-0.2,10490,10490,1399-11-8
677,فنرژي,گسترش صنايع انرژي آذرآب,29,292274,5075922558,17027,17367,17367,340,2.0,17185,158,0.93,17367,17367,1399-11-8
678,وارس,سرمايه گذاري ارس صبا,29,25528,483806656,19538,18952,18952,-586,-3.0,19523,-15,-0.08,18952,18952,1399-11-8
679,بنيرو,نيروترانس‌,29,68234,1250046880,19280,18320,18320,-960,-4.98,19250,-30,-0.16,18320,18320,1399-11-8
680,زنجان,صنايع كشاورزي وكود زنجان,28,133001,1316975902,10208,9902,9902,-306,-3.0,10186,-22,-0.22,9902,9902,1399-11-8
681,هبركت912,اختيارف ت بركت-22100-99/12/17,27,42059,106535447,1598,2533,2533,935,58.51,2533,935,58.51,2533,2533,1399-11-8
682,اخزا821,اسنادخزانه-م21بودجه98-020906,26,62728,37139016324,591362,599890,592000,638,0.11,592064,702,0.12,591000,599894,1399-11-8
683,اراد71,مرابحه عام دولت71-ش.خ0311,26,5000000,5000000000000,1000000,1000000,1000000,0,0.0,1000000,0,0.0,1000000,1000000,1399-11-8
684,ضفلا1155,اختيارخ فولاد-14000-1399/11/28,25,810,88950000,94,120,120,26,27.66,110,16,17.02,80,120,1399-11-8
685,زعف0008پ18,زعفران0008نگين بهرامن(پ),24,15453,1926365815,124794,125700,124999,205,0.16,124660,-134,-0.11,123782,126000,1399-11-8
686,اخزا808,اسنادخزانه-م8بودجه98-000817,24,16422,14321423993,872165,872180,872560,395,0.05,872088,-77,-0.01,872000,873000,1399-11-8
687,ثنام,س ساختماني ب نام آوران مهندسي,24,19931,347357468,17966,17428,17428,-538,-2.99,17956,-10,-0.06,17428,17428,1399-11-8
688,ضفلا1156,اختيارخ فولاد-16000-1399/11/28,23,597,22882000,32,79,39,7,21.88,38,6,18.75,30,79,1399-11-8
689,تسه9804,امتياز تسهيلات مسكن تير98,23,160,82528465,504356,529573,509002,4646,0.92,515803,11447,2.27,500001,529573,1399-11-8
690,اخزا818,اسنادخزانه-م18بودجه98-010614,22,26009,19656726947,756414,753340,756250,-164,-0.02,755766,-648,-0.09,753335,758000,1399-11-8
691,ضملت1126,اختيارخ وبملت-4500-1399/11/28,22,638,104922000,205,200,160,-45,-21.95,164,-41,-20.0,150,220,1399-11-8
692,اخزا814,اسنادخزانه-م14بودجه98-010318,21,29818,23427807479,784132,782022,786000,1868,0.24,785693,1561,0.2,782022,786000,1399-11-8
693,زعف0008پ08,زعفران0008نگين روستا(پ),21,15039,1877237987,124200,125000,124800,600,0.48,124825,625,0.5,124200,125500,1399-11-8
694,قلرست,قند لرستان‌,21,16546,536586780,34130,32430,32430,-1700,-4.98,34110,-20,-0.06,32430,32430,1399-11-8
695,كيا,كيا الكترود شرق,20,966778,6868957690,6767,7105,7105,338,4.99,7105,338,4.99,7105,7105,1399-11-8
696,اخزا908,اسنادخزانه-م8بودجه99-020606,19,56809,34736550842,611438,611438,611438,0,0.0,611462,24,0.0,611438,611999,1399-11-8
697,ضفلا1153,اختيارخ فولاد-10000-1399/11/28,19,133,254297000,1612,1700,1752,140,8.68,1912,300,18.61,1700,2380,1399-11-8
698,اخزا813,اسنادخزانه-م13بودجه98-010219,19,23039,18308666773,804023,792500,794986,-9037,-1.12,794681,-9342,-1.16,792500,798000,1399-11-8
699,اخزا811,اسنادخزانه-م11بودجه98-001013,18,18997,16114338070,846062,845500,849900,3838,0.45,848257,2195,0.26,845202,849900,1399-11-8
700,تملي708,تسهيلات مسكن ب. ملي-آبان97,18,249,151094765,638110,606205,606205,-31905,-5.0,606806,-31304,-4.91,606205,610000,1399-11-8
701,كساپا,سايپاشيشه‌,18,28983,1132075980,41110,39060,39060,-2050,-4.99,41060,-50,-0.12,39060,39060,1399-11-8
702,اخزا816,اسنادخزانه-م16بودجه98-010503,18,162457,124698292421,766863,763513,766000,-863,-0.11,767577,714,0.09,763510,769000,1399-11-8
703,ضغدر1119,اختيارخ وغدير-10000-1399/11/26,17,137,220393000,1382,1500,1700,318,23.01,1609,227,16.43,1500,1950,1399-11-8
704,ضملي3003,اختيارخ فملي-12000-1400/03/02,17,853,1097180000,1530,1200,1450,-80,-5.23,1286,-244,-15.95,1200,1650,1399-11-8
705,ضصاد3003,اختيارخ وبصادر-3000-1400/03/12,17,517,211990000,497,400,438,-59,-11.87,410,-87,-17.51,312,450,1399-11-8
706,سخند,صندوق س.سپهرخبرگان نفت-د,17,162490,1643940120,10110,10120,10115,5,0.05,10117,7,0.07,10114,10120,1399-11-8
707,اخزا806,اسنادخزانه-م6بودجه98-000519,17,115858,105186807063,908198,907001,908000,-198,-0.02,907894,-304,-0.03,907000,910000,1399-11-8
708,ضترا1118,اختيارخ شتران-12000-1399/11/14,17,796,3526000,1,1,3,2,200.0,4,3,300.0,1,10,1399-11-8
709,ضفار3000,اختيارخ فارس-8000-1400/03/05,17,176,480700000,3030,2850,2900,-130,-4.29,2731,-299,-9.87,2600,2950,1399-11-8
710,وساشرقي,شركت س استان آذربايجان شرقي,16,220736,209699200,990,950,950,-40,-4.04,990,0,0.0,950,950,1399-11-8
711,نگين,ص.س. زمين و ساختمان نگين شهرري,16,7375,355802600,47540,48590,47560,20,0.04,48240,700,1.47,47550,48590,1399-11-8
712,خبازرس,بازرسي مهندسي و صنعتي ايران,16,245443,6059005898,23967,24686,24686,719,3.0,24175,208,0.87,24686,24686,1399-11-8
713,دحاوي,الحاوي,16,50862,614870718,12462,12089,12089,-373,-2.99,12450,-12,-0.1,12089,12089,1399-11-8
714,وسكرد,شركت س استان كردستان,15,170686,128014500,780,750,750,-30,-3.85,780,0,0.0,750,750,1399-11-8
715,اخزا809,اسنادخزانه-م9بودجه98-000923,15,19160,16418920866,857576,852055,858000,424,0.05,856937,-639,-0.07,852055,858000,1399-11-8
716,ضخود2011,اختيارخ خودرو-5000-1400/02/08,14,909,89445000,86,119,90,4,4.65,98,12,13.95,90,119,1399-11-8
717,داريك,صندوق س.اعتماد داريك-د,14,8519,88579080,10443,10450,10400,-43,-0.41,10398,-45,-0.43,10380,10450,1399-11-8
718,گنجين,صندوق س. گنجينه يكم آويد-د,13,31613,382795365,12103,12106,12111,8,0.07,12109,6,0.05,12103,12118,1399-11-8
719,عيار2,صندوق س. پشتوانه طلاي مفيد,13,130000,130000,25087,1,1,-25086,-100.0,1,-25086,-100.0,1,1,1399-11-8
720,اخزا812,اسنادخزانه-م12بودجه98-001111,13,39943,33455131849,835859,833001,838000,2141,0.26,837572,1713,0.2,833001,838000,1399-11-8
721,ضفلا1154,اختيارخ فولاد-12000-1399/11/28,12,54,42497000,514,700,730,216,42.02,787,273,53.11,700,850,1399-11-8
722,زعف0008پ16,زعفران0008نگين بيرجند(پ),12,10838,1350213900,124108,124108,124456,348,0.28,124581,473,0.38,124108,125000,1399-11-8
723,ضخود2010,اختيارخ خودرو-4500-1400/02/08,12,193,24431000,155,198,140,-15,-9.68,127,-28,-18.06,112,198,1399-11-8
724,رطب0002پ01,رطب مضافتي0002افشارتعاون بم(پ),12,413,90450197,211085,221628,221609,10524,4.99,219008,7923,3.75,200532,221628,1399-11-8
725,ضملي3002,اختيارخ فملي-10000-1400/03/02,11,103,289920000,2118,2710,2700,582,27.48,2815,697,32.91,2600,2850,1399-11-8
726,ضپاس2003,اختيارخ وپارس-3500-1400/02/29,11,306,121910000,382,390,390,8,2.09,398,16,4.19,370,420,1399-11-8
727,اخزا810,اسنادخزانه-م10بودجه98-001006,11,6180,5252441797,851443,847002,850501,-942,-0.11,849910,-1533,-0.18,845602,850501,1399-11-8
728,تملي701,تسهيلات مسكن ب. ملي-فروردين97,11,120,78619836,640109,660000,608104,-32005,-5.0,655165,15056,2.35,608104,672114,1399-11-8
729,تملي705,تسهيلات مسكن ب. ملي-مرداد97,9,88,48453436,529361,555829,555829,26468,5.0,550607,21246,4.01,502893,555829,1399-11-8
730,ضترا3000,اختيارخ شتران-6000-1400/03/09,9,96,371050000,3091,3800,3100,9,0.29,3865,774,25.04,3100,4190,1399-11-8
731,اخزا722,اسنادخزانه-م22بودجه97-000428,9,56693,51984186613,918000,918001,914000,-4000,-0.44,916942,-1058,-0.12,914000,918004,1399-11-8
732,ضترا1117,اختيارخ شتران-10000-1399/11/14,9,178,56290000,100,200,400,300,300.0,316,216,216.0,200,400,1399-11-8
733,سلامت6,مرابحه سلامت6واجدشرايط خاص1400,8,200000,200000000000,1000000,1000000,1000000,0,0.0,1000000,0,0.0,1000000,1000000,1399-11-8
734,اخزا904,اسنادخزانه-م4بودجه99-011215,7,60974,41524268000,681002,680000,682000,998,0.15,681016,14,0.0,680000,682000,1399-11-8
735,اخزا805,اسنادخزانه-م5بودجه98-000422,6,940,862955140,916036,916001,919010,2974,0.32,918037,2001,0.22,916001,920000,1399-11-8
736,شسم,توليد سموم‌ علف‌ كش,6,2086,186692828,87744,89498,89498,1754,2.0,87776,32,0.04,89498,89498,1399-11-8
737,ضپار1118,اختيارخ خپارس-8000-1399/11/19,6,101,1114000,134,3,12,-122,-91.04,11,-123,-91.79,10,12,1399-11-8
738,ضترا3003,اختيارخ شتران-9000-1400/03/09,6,238,558550000,2500,2100,2350,-150,-6.0,2347,-153,-6.12,2100,2350,1399-11-8
739,ضصاد3002,اختيارخ وبصادر-2500-1400/03/12,6,124,84338000,807,685,685,-122,-15.12,680,-127,-15.74,655,685,1399-11-8
740,كرونا2,تامين مالي جمعي صرفا اهداي سود,6,1370,13700000,10000,10000,10000,0,0.0,10000,0,0.0,10000,10000,1399-11-8
741,دسبحاح,ح .گروه دارويي سبحان,6,7504,112560000,15020,15000,15000,-20,-0.13,15000,-20,-0.13,15000,15000,1399-11-8
742,هترول911,اختيارف ت پترول-14730-99/11/15,6,12607,55521228,4126,4404,4404,278,6.74,4404,278,6.74,4404,4404,1399-11-8
743,هفارس912,اختيارف ت فارس-14576-99/12/13,5,78498,376162416,4414,4792,4792,378,8.56,4792,378,8.56,4792,4792,1399-11-8
744,ضملت1124,اختيارخ وبملت-3500-1399/11/28,5,116,92470000,700,720,800,100,14.29,797,97,13.86,720,800,1399-11-8
745,فولاد2,فولاد مباركه اصفهان,5,211000000,2526660000000,11680,11560,12260,580,4.97,11975,295,2.53,11560,12260,1399-11-8
746,زير0003پ01,زيره سبز0003كيميابذر(پ),5,50,22431480,462170,450000,451000,-11170,-2.42,448630,-13540,-2.93,442468,451001,1399-11-8
747,اعتماد2,صندوق س.اعتماد آفرين پارسيان-د,5,50000000,50000000,34540,1,1,-34539,-100.0,1,-34539,-100.0,1,1,1399-11-8
748,اشاد10,مشاركت دولتي10-شرايط خاص001226,5,30400,29488000000,940000,970000,970000,30000,3.19,970000,30000,3.19,970000,970000,1399-11-8
749,پست0008پ08,پسته فندقي32-30مه ولات0008(پ),5,78,104095446,1327857,1334557,1334557,6700,0.5,1334557,6700,0.5,1334557,1334557,1399-11-8
750,زعف0008پ09,زعفران0008نگين نوين(پ),5,5740,716097600,125748,124748,124700,-1048,-0.83,124756,-992,-0.79,124700,128250,1399-11-8
751,وسخراج,شركت س استان خراسان جنوبي,4,158508,334451880,2220,2110,2110,-110,-4.95,2220,0,0.0,2110,2110,1399-11-8
752,اخزا807,اسنادخزانه-م7بودجه98-000719,4,2275,2001570248,888990,879001,880004,-8986,-1.01,879811,-9179,-1.03,879001,881002,1399-11-8
753,وسمازن,س.سهام عدالت استان مازندران,4,23032,21650080,980,940,940,-40,-4.08,980,0,0.0,940,940,1399-11-8
754,وسيستا,شركت س استان سيستان وبلوچستان,4,32330,24570800,790,760,760,-30,-3.8,790,0,0.0,760,760,1399-11-8
755,ياقوت2,صندوق س ياقوت آگاه-ثابت,4,6452000,6452000,11806,1,1,-11805,-99.99,1,-11805,-99.99,1,1,1399-11-8
756,ضترا3002,اختيارخ شتران-8000-1400/03/09,4,140,433950000,2703,3050,3100,397,14.69,3100,397,14.69,3050,3100,1399-11-8
757,ضفار3001,اختيارخ فارس-9000-1400/03/05,4,15,31600000,2200,2200,2100,-100,-4.55,2107,-93,-4.23,2100,2200,1399-11-8
758,اراد50,مرابحه عام دولت5-ش.خ0302,4,85000,85000035000,1000000,1000000,1000001,1,0.0,1000000,0,0.0,1000000,1000001,1399-11-8
759,اخزا720,اسنادخزانه-م20بودجه97-000324,4,148,138084315,932066,933000,933009,943,0.1,933002,936,0.1,933000,933009,1399-11-8
760,ضملت1123,اختيارخ وبملت-3000-1399/11/28,4,35,43240000,1248,1230,1240,-8,-0.64,1235,-13,-1.04,1230,1240,1399-11-8
761,اخزا713,اسنادخزانه-م13بودجه97-000518,4,2101,1908514762,908886,954330,908002,-884,-0.1,908384,-502,-0.06,907502,954330,1399-11-8
762,غيوان,كيوان,4,2225,34465250,15337,15490,15490,153,1.0,15338,1,0.01,15490,15490,1399-11-8
763,اخزا718,اسنادخزانه-م18بودجه97-000525,4,40006,36199643000,904776,904902,908000,3224,0.36,904855,79,0.01,904776,908000,1399-11-8
764,تملي805,تسهيلات مسكن ب. ملي-مرداد98,3,23,17571747,727609,763989,763989,36380,5.0,763989,36380,5.0,763989,763989,1399-11-8
765,اخزا721,اسنادخزانه-م21بودجه97-000728,3,1369,1197918954,876883,875000,876051,-832,-0.09,875032,-1851,-0.21,875000,876051,1399-11-8
766,وسخراش,شركت س استان خراسان شمالي,3,15324,20074440,1370,1310,1310,-60,-4.38,1370,0,0.0,1310,1310,1399-11-8
767,وسلرستا,شركت س استان لرستان,3,11850,10191000,900,860,860,-40,-4.44,900,0,0.0,860,860,1399-11-8
768,ضملي3001,اختيارخ فملي-9000-1400/03/02,3,20,79750000,3000,3750,4000,1000,33.33,3987,987,32.9,3750,4000,1399-11-8
769,وسقم,شركت س استان قم,3,11634,15589560,1410,1340,1340,-70,-4.96,1410,0,0.0,1340,1340,1399-11-8
770,وسيلام,شركت س استان ايلام,3,30438,35916840,1240,1180,1180,-60,-4.84,1240,0,0.0,1180,1180,1399-11-8
771,شستا991,اجاره تامين اجتماعي-امين991226,3,47,46646200,1000447,993000,992320,-8127,-0.81,992472,-7975,-0.8,991000,993000,1399-11-8
772,دمعيار2,صندوق س. توازن معيار-د,3,27600000,27600000,10032,1,1,-10031,-99.99,1,-10031,-99.99,1,1,1399-11-8
773,اراد53,مرابحه عام دولت5-ش.خ 0207,3,4100,3929000000,959454,950000,960000,546,0.06,958293,-1161,-0.12,950000,960000,1399-11-8
774,تملي710,تسهيلات مسكن ب. ملي-دي97,3,8,6679304,878855,834913,834913,-43942,-5.0,834913,-43942,-5.0,834913,834913,1399-11-8
775,فملي2,ملي‌ صنايع‌ مس‌ ايران‌,3,113000000,1296110000000,10930,11470,11470,540,4.94,11470,540,4.94,11470,11470,1399-11-8
776,كابگن,توليدي و صنعتي آبگينه‌,3,9000,46062000,5068,5118,5118,50,0.99,5068,0,0.0,5118,5118,1399-11-8
777,ضپاس2000,اختيارخ وپارس-2000-1400/02/29,2,11,13850000,1196,1250,1350,154,12.88,1259,63,5.27,1250,1350,1399-11-8
778,اخزا7164,اسنادخزانه-م16بودجه97-000407,2,1636000,1556803694000,927048,929783,973400,46352,5.0,951591,24543,2.65,929783,973400,1399-11-8
779,اراد374,مرابحه عام دولت3-ش.خ 0005,2,1500000,1493239000000,1049977,998239,990000,-59977,-5.71,995493,-54484,-5.19,990000,998239,1399-11-8
780,پا ر 16,بار پايه روز 16,2,3000,1140000,498,380,380,-118,-23.69,380,-118,-23.69,380,380,1399-11-8
781,اجاد25,اجاره دولتي آپرورش-سپهر991118,2,967,967000000,1000000,1000000,1000000,0,0.0,1000000,0,0.0,1000000,1000000,1399-11-8
782,پا ر 15,بار پايه روز 15,2,3000,1140000,715,380,380,-335,-46.85,380,-335,-46.85,380,380,1399-11-8
783,پا ر 18,بار پايه روز 18,2,3000,1140000,498,380,380,-118,-23.69,380,-118,-23.69,380,380,1399-11-8
784,وسمركز,شركت س استان مركزي,2,8120,10799600,1400,1330,1330,-70,-5.0,1400,0,0.0,1330,1330,1399-11-8
785,اخزا8114,اسنادخزانه-م11بودجه98-001013,2,1736000,1472088940000,846062,849893,846062,0,0.0,847977,1915,0.23,846062,849893,1399-11-8
786,سلامت1,مرابحه دولتي تعاون-ملت991118,2,774,774000000,1010000,1000000,1000000,-10000,-0.99,1000000,-10000,-0.99,1000000,1000000,1399-11-8
787,اخزا7224,اسنادخزانه-م22بودجه97-000428,2,1838000,1690519799000,918000,921521,918000,0,0.0,919760,1760,0.19,918000,921521,1399-11-8
788,گواهي ظرفيت,گواهي ظرفيت نقدي,2,10740000,114262860000,10639,10639,10639,0,0.0,10639,0,0.0,10639,10639,1399-11-8
789,اخزا7204,اسنادخزانه-م20بودجه97-000324,2,1420000,1326031500000,932066,935584,932066,0,0.0,933825,1759,0.19,932066,935584,1399-11-8
790,اخزا8074,اسنادخزانه-م7بودجه98-000719,2,668000,591361362000,888990,881553,888990,0,0.0,885271,-3719,-0.42,881553,888990,1399-11-8
791,ضمخا7070,اختيارخ اخابر-20000-1400/07/28,2,2,3600000,2927,1800,1800,-1127,-38.5,1800,-1127,-38.5,1800,1800,1399-11-8
792,اخزا723,اسنادخزانه-م23بودجه97-000824,2,1433,1244931000,866307,868000,869000,2693,0.31,868759,2452,0.28,868000,869000,1399-11-8
793,ضپار1115,اختيارخ خپارس-5000-1399/11/19,2,30,33500000,1150,1100,1150,0,0.0,1117,-33,-2.87,1100,1150,1399-11-8
794,اخزا7214,اسنادخزانه-م21بودجه97-000728,2,3164000,2778884248000,876883,879681,876883,0,0.0,878282,1399,0.16,876883,879681,1399-11-8
795,ضصاد3001,اختيارخ وبصادر-2000-1400/03/12,2,4,3600000,784,900,900,116,14.8,900,116,14.8,900,900,1399-11-8
796,فماك,ماداكتو استيل كرد,2,100000,2239900000,23500,22399,22399,-1101,-4.69,22399,-1101,-4.69,22399,22399,1399-11-8
797,اخزا7184,اسنادخزانه-م18بودجه97-000525,2,2498000,2262753348000,904776,906876,904776,0,0.0,905826,1050,0.12,904776,906876,1399-11-8
798,اخزا804,اسنادخزانه-م4بودجه98-000421,2,1000,919759800,919676,919999,919700,24,0.0,919760,84,0.01,919700,919999,1399-11-8
799,زعف0008پ19,زعفران0008نگين تروند قاينات(پ),2,3197,398114500,125262,124500,125000,-262,-0.21,124528,-734,-0.59,124500,125000,1399-11-8
800,اراد404,مرابحه عام دولت4-ش.خ 0207,2,7000000,6565345500000,999000,936883,938930,-60070,-6.01,937906,-61094,-6.12,936883,938930,1399-11-8
801,پست0008پ04,پسته فندقي32-30سبزدانه0008(پ),2,43,57233000,1349000,1331000,1331000,-18000,-1.33,1331000,-18000,-1.33,1331000,1331000,1399-11-8
802,سلامت4,مرابحه دولتي تعاون-لوتوس991118,2,3969,3969001969,1000001,1000001,1000000,-1,0.0,1000000,-1,0.0,1000000,1000001,1399-11-8
803,اخزا8134,اسنادخزانه-م13بودجه98-010219,2,434000,346979528000,804023,794961,804023,0,0.0,799492,-4531,-0.56,794961,804023,1399-11-8
804,اطلس2,صندوق س.توسعه اندوخته آينده-س,2,20000,20000,200792,1,1,-200791,-100.0,1,-200791,-100.0,1,1,1399-11-8
805,وسيزد,شركت س استان يزد,2,9100,11102000,1280,1220,1220,-60,-4.69,1280,0,0.0,1220,1220,1399-11-8
806,كيش1402,اجاره س. و توسعه كيش14020820,2,3594,3594000000,990074,1000000,1000000,9926,1.0,1000000,9926,1.0,1000000,1000000,1399-11-8
807,ضمخا7066,اختيارخ اخابر-12000-1400/07/28,2,2,9180000,4388,4990,4190,-198,-4.51,4590,202,4.6,4190,4990,1399-11-8
808,اراد314,مرابحه عام دولت3-ش.خ 0208,2,15000000,13394370000000,1000000,893148,892848,-107152,-10.72,892958,-107042,-10.7,892848,893148,1399-11-8
809,اخزا8094,اسنادخزانه-م9بودجه98-000923,2,670000,574228190000,857576,856538,857576,0,0.0,857057,-519,-0.06,856538,857576,1399-11-8
810,اراد344,مرابحه عام دولت3-ش.خ 0305,2,15793000,13573946894000,1000000,859709,859358,-140642,-14.06,859491,-140509,-14.05,859358,859709,1399-11-8
811,زعف0008پ20,زعفران0008نگين وحدت جام(پ),2,5000,628285000,10000,125657,125657,115657,1156.57,125657,115657,1156.57,125657,125657,1399-11-8
812,پا ر 17,بار پايه روز 17,2,3000,1140000,498,380,380,-118,-23.69,380,-118,-23.69,380,380,1399-11-8
813,غگز,گز سكه,2,100000,2100000000,22000,21000,21000,-1000,-4.55,21000,-1000,-4.55,21000,21000,1399-11-8
814,وسگيلا,شركت س استان گيلان,2,13368,10560720,830,790,790,-40,-4.82,830,0,0.0,790,790,1399-11-8
815,آگاس2,صندوق س.هستي بخش آگاه-س,2,200000,200000,65565,1,1,-65564,-100.0,1,-65564,-100.0,1,1,1399-11-8
816,تملي709,تسهيلات مسكن ب. ملي-آذر97,2,6,5376006,943158,896001,896001,-47157,-5.0,896001,-47157,-5.0,896001,896001,1399-11-8
817,ضترا1126,اختيارخ شتران-7000-1399/11/14,2,6,13070000,2000,2100,2570,570,28.5,2178,178,8.9,2100,2570,1399-11-8
818,سپر2,صندوق س سپر سرمايه بيدار- ثابت,2,2000000,2000000,11167,1,1,-11166,-99.99,1,-11166,-99.99,1,1,1399-11-8
819,زكوثر2,سرمايه گذاري كشاورزي كوثر,1,27000000,545400000000,21080,20200,20200,-880,-4.17,20200,-880,-4.17,20200,20200,1399-11-8
820,اراد444,مرابحه عام دولت4-ش.خ 0007,1,2050000,2030602900000,1050000,990538,990538,-59462,-5.66,990538,-59462,-5.66,990538,990538,1399-11-8
821,اراد354,مرابحه عام دولت3-ش.خ 0103,1,10000000,9584190000000,950000,958419,958419,8419,0.89,958419,8419,0.89,958419,958419,1399-11-8
822,ضملي3004,اختيارخ فملي-14000-1400/03/02,1,1,900000,686,900,900,214,31.2,900,214,31.2,900,900,1399-11-8
823,شبندر2,پالايش نفت بندرعباس,1,5000000,115000000000,22380,23000,23000,620,2.77,23000,620,2.77,23000,23000,1399-11-8
824,ضملت1129,اختيارخ وبملت-7000-1399/11/28,1,1,30000,1,30,30,29,2900.0,30,29,2900.0,30,30,1399-11-8
825,ضخود2012,اختيارخ خودرو-6000-1400/02/08,1,50,2550000,52,51,51,-1,-1.92,51,-1,-1.92,51,51,1399-11-8
826,اجاد22,اجاره دولتي آپرورش-لوتوس991118,1,2817,2817000000,1000000,1000000,1000000,0,0.0,1000000,0,0.0,1000000,1000000,1399-11-8
827,صمسكن912,ص دين مسكن جنوب-ماهانه16درصد,1,700,35609700,50871,50871,50871,0,0.0,50871,0,0.0,50871,50871,1399-11-8
828,غشهداب2,كشت و صنعت شهداب ناب خراسان,1,22609360,85689474400,3911,3790,3790,-121,-3.09,3790,-121,-3.09,3790,3790,1399-11-8
829,تملي703,تسهيلات مسكن ب. ملي-خرداد97,1,8,5693064,749087,711633,711633,-37454,-5.0,711633,-37454,-5.0,711633,711633,1399-11-8
830,ضترا1127,اختيارخ شتران-8000-1399/11/14,1,3,5670000,1773,1890,1890,117,6.6,1890,117,6.6,1890,1890,1399-11-8
831,ضگل1144,اختيارخ كگل-20000-1399/11/21,1,10,1000000,120,100,100,-20,-16.67,100,-20,-16.67,100,100,1399-11-8
832,پست0008پ09,پسته بادامي30-28مه ولات0008(پ),1,9,12240000,1305722,1360000,1360000,54278,4.16,1360000,54278,4.16,1360000,1360000,1399-11-8
833,ضبدر1149,اختيارخ شبندر-28000-1399/11/19,1,13,520000,88,40,40,-48,-54.55,40,-48,-54.55,40,40,1399-11-8
834,ساذري,آذريت‌,1,286,1714284,5820,5994,5994,174,2.99,5820,0,0.0,5994,5994,1399-11-8
835,رايان106,مشاركت رايان سايپا-3ماهه16%,1,10,9558340,955834,955834,955834,0,0.0,955834,0,0.0,955834,955834,1399-11-8
836,اراد424,مرابحه عام دولت4-ش.خ 0106,1,9126000,8157740526000,1056250,893901,893901,-162349,-15.37,893901,-162349,-15.37,893901,893901,1399-11-8
837,آوا2,صندوق س.سهام آواي معيار-س,1,100000,100000,7789,1,1,-7788,-99.99,1,-7788,-99.99,1,1,1399-11-8
838,افران2,صندوق س افرا نماد پايدار-ثابت,1,3000000,3000000,12549,1,1,-12548,-99.99,1,-12548,-99.99,1,1,1399-11-8
839,ضگل1141,اختيارخ كگل-14000-1399/11/21,1,1,4200000,3500,4200,4200,700,20.0,4200,700,20.0,4200,4200,1399-11-8
840,اراد65,مرابحه عام دولتي65-ش.خ0210,1,5300,4909284000,926220,926280,926280,60,0.01,926280,60,0.01,926280,926280,1399-11-8
841,كمند2,صندوق س. با درآمد ثابت كمند,1,100000000,100000000,10123,1,1,-10122,-99.99,1,-10122,-99.99,1,1,1399-11-8
842,ضپنا2002,اختيارخ رمپنا-14000-1400/02/12,1,20,104600000,4200,5230,5230,1030,24.52,5230,1030,24.52,5230,5230,1399-11-8
843,ضغدر1120,اختيارخ وغدير-12000-1399/11/26,1,5,1125000,336,225,225,-111,-33.04,225,-111,-33.04,225,225,1399-11-8
844,شلرد02,كود شيميايي اوره لردگان,1,23,22839000,993000,993000,993000,0,0.0,993000,0,0.0,993000,993000,1399-11-8
845,ضپيك2010,اختيارخ تاپيكو-12000-00/02/19,1,5,10000000,2000,2000,2000,0,0.0,2000,0,0.0,2000,2000,1399-11-8
846,اراد41,مرابحه عام دولت4-ش.خ 0006,1,2000,2058860000,1024430,1029430,1029430,5000,0.49,1029430,5000,0.49,1029430,1029430,1399-11-8
847,ضفلا1158,اختيارخ فولاد-20000-1399/11/28,1,30,240000,10,8,8,-2,-20.0,8,-2,-20.0,8,8,1399-11-8
848,پارس2,پتروشيمي پارس,1,3600000,472860000000,131350,131350,131350,0,0.0,131350,0,0.0,131350,131350,1399-11-8
849,تملي804,تسهيلات مسكن ب. ملي-تير98,1,8,6125168,805943,765646,765646,-40297,-5.0,765646,-40297,-5.0,765646,765646,1399-11-8
850,ضفلا1152,اختيارخ فولاد-9000-1399/11/28,1,10,28000000,2000,2800,2800,800,40.0,2800,800,40.0,2800,2800,1399-11-8
851,ضصاد1103,اختيارخ وبصادر-4000-1399/11/12,1,1,1000,1,1,1,0,0.0,1,0,0.0,1,1,1399-11-8
852,ضخوز2014,اختيارخ فخوز-14000-1400/02/15,1,2,1200000,2470,600,600,-1870,-75.71,600,-1870,-75.71,600,600,1399-11-8
853,اراد134,مرابحه عام دولت1-ش.خ ساير0206,1,5000000,4787715000000,885000,957543,957543,72543,8.2,957543,72543,8.2,957543,957543,1399-11-8
854,اراد334,مرابحه عام دولت3-ش.خ 0303,1,5000000,4328345000000,910000,865669,865669,-44331,-4.87,865669,-44331,-4.87,865669,865669,1399-11-8
855,مشير112,مشاركت شهرداري شيراز-3ماهه18%,1,1,990000,1000000,990000,990000,-10000,-1.0,990000,-10000,-1.0,990000,990000,1399-11-8
856,ضبدر1158,اختيارخ شبندر-24000-1399/11/19,1,1,500000,650,500,500,-150,-23.08,500,-150,-23.08,500,500,1399-11-8
857,هاباد912,اختيارف ت آبادا-30100-99/12/12,1,300,3686400,12238,12288,12288,50,0.41,12288,50,0.41,12288,12288,1399-11-8
858,خودرو2,ايران‌ خودرو,1,214000000,599200000000,2670,2800,2800,130,4.87,2800,130,4.87,2800,2800,1399-11-8
859,ضفلا1157,اختيارخ فولاد-18000-1399/11/28,1,23,115000,5,5,5,0,0.0,5,0,0.0,5,5,1399-11-8
860,اخزا9022,اسنادخزانه-م2بودجه99-011019,1,853719,596322721500,699130,698500,698500,-630,-0.09,698500,-630,-0.09,698500,698500,1399-11-8
861,ضپيك2009,اختيارخ تاپيكو-10000-00/02/19,1,1,2650000,3118,2650,2650,-468,-15.01,2650,-468,-15.01,2650,2650,1399-11-8
862,اراد524,مرابحه عام دولت5-ش.خ 0108,1,6333000,6028344702000,1000000,951894,951894,-48106,-4.81,951894,-48106,-4.81,951894,951894,1399-11-8
863,وسبوشهر,شركت س استان بوشهر,1,8000,9600000,1260,1200,1200,-60,-4.76,1260,0,0.0,1200,1200,1399-11-8
864,پا ر 21,بار پايه روز 21,1,3000,1140000,498,380,380,-118,-23.69,380,-118,-23.69,380,380,1399-11-8
865,ضغدر1121,اختيارخ وغدير-14000-1399/11/26,1,1,70000,150,70,70,-80,-53.33,70,-80,-53.33,70,70,1399-11-8
866,پا ر 22,بار پايه روز 22,1,3000,1140000,709,380,380,-329,-46.4,380,-329,-46.4,380,380,1399-11-8
867,كايتا,ايتالران‌,1,5587,53400546,9280,9558,9558,278,3.0,9281,1,0.01,9558,9558,1399-11-8
868,ضبدر1160,اختيارخ شبندر-18000-1399/11/19,1,1,5385000,3950,5385,5385,1435,36.33,5385,1435,36.33,5385,5385,1399-11-8
869,اجاد27,اجاره دولت آپرورش-كاردان991118,1,2500,2500000000,1002000,1000000,1000000,-2000,-0.2,1000000,-2000,-0.2,1000000,1000000,1399-11-8
870,ضبدر1159,اختيارخ شبندر-16000-1399/11/19,1,5,29000000,6275,5800,5800,-475,-7.57,5800,-475,-7.57,5800,5800,1399-11-8
871,زعف0008پ12,زعفران0008پوشالمعمول سحرخيز(پ),1,100,8000100,81811,80001,80001,-1810,-2.21,80001,-1810,-2.21,80001,80001,1399-11-8
872,اخزا906,اسنادخزانه-م6بودجه99-020321,1,1000,690000000,685195,690000,690000,4805,0.7,690000,4805,0.7,690000,690000,1399-11-8
873,تملي711,تسهيلات مسكن ب. ملي-بهمن97,1,8,7433608,978106,929201,929201,-48905,-5.0,929201,-48905,-5.0,929201,929201,1399-11-8
874,اخزا716,اسنادخزانه-م16بودجه97-000407,1,1,930000,927048,930000,930000,2952,0.32,930000,2952,0.32,930000,930000,1399-11-8
875,شپنا2,پالايش نفت اصفهان,1,9000000,99000000000,11190,11000,11000,-190,-1.7,11000,-190,-1.7,11000,11000,1399-11-8
876,كاوه2,فولاد كاوه جنوب كيش,1,39000000,741000000000,18920,19000,19000,80,0.42,19000,80,0.42,19000,19000,1399-11-8
877,ضبدر1157,اختيارخ شبندر-20000-1399/11/19,1,5,15000000,314,3000,3000,2686,855.41,3000,2686,855.41,3000,3000,1399-11-8
878,فبستم,صنايع ‌بسته‌بندي‌ مشهد,1,1138,928608,793,816,816,23,2.9,793,0,0.0,816,816,1399-11-8
879,كشم0001پ01,كشمش سبز0001خليل آباد(پ),1,8,5311488,632320,663936,663936,31616,5.0,663936,31616,5.0,663936,663936,1399-11-8
880,تملي706,تسهيلات مسكن ب. ملي-شهريور97,1,8,6135680,807326,766960,766960,-40366,-5.0,766960,-40366,-5.0,766960,766960,1399-11-8
881,اخزا819,اسنادخزانه-م19بودجه98-020322,1,3000,2130255000,703055,710085,710085,7030,1.0,710085,7030,1.0,710085,710085,1399-11-8
882,ضبدر1150,اختيارخ شبندر-32000-1399/11/19,1,3,30000,114,10,10,-104,-91.23,10,-104,-91.23,10,10,1399-11-8
883,صايپا112,صكوك مرابحه سايپا112-3ماهه 16%,1,6000,5900226000,983371,983371,983371,0,0.0,983371,0,0.0,983371,983371,1399-11-8
884,اجاد23,اجاره دولتي آپرورش-ملت991118,1,510,510000000,1000004,1000000,1000000,-4,0.0,1000000,-4,0.0,1000000,1000000,1399-11-8
885,زعف0008پ15,زعفران0008پوشالمعمول طلاسرخ(پ),1,70,5740000,82999,82000,82000,-999,-1.2,82000,-999,-1.2,82000,82000,1399-11-8
886,تملي803,تسهيلات مسكن ب. ملي-خرداد98,1,8,6123896,805775,765487,765487,-40288,-5.0,765487,-40288,-5.0,765487,765487,1399-11-8
887,خعمرا,توسعه و عمران شهرستان نائين,1,700,15761900,21862,22517,22517,655,3.0,21862,0,0.0,22517,22517,1399-11-8
888,زير0003پ02,زيره سبز0003 دانش(پ),1,13,6240000,475000,480000,480000,5000,1.05,480000,5000,1.05,480000,480000,1399-11-8
889,شرق1400,مشاركت ليزينگ ايران وشرق140010,1,5,4999500,999900,999900,999900,0,0.0,999900,0,0.0,999900,999900,1399-11-8
890,اشاد1,مشاركت دولتي1-شرايط خاص001026,1,700,700000000,984004,1000000,1000000,15996,1.63,1000000,15996,1.63,1000000,1000000,1399-11-8
891,اراد474,مرابحه عام دولت4-ش.خ 0008,1,2000000,1980182000000,980000,990091,990091,10091,1.03,990091,10091,1.03,990091,990091,1399-11-8
892,ودي2,بيمه  دي,1,23750000,544278750000,22917,22917,22917,0,0.0,22917,0,0.0,22917,22917,1399-11-8
