,نماد,نام,تعداد,حجم,ارزش,دیروز,اولین,آخرین معامله - مقدار,آخرین معامله - تغییر,آخرین معامله - درصد,قیمت پایانی - مقدار,قیمت پایانی - تغییر,قیمت پایانی - درصد,کمترین,بیشترین,تاریخ
0,وكبهمن,مديريت سرمايه گذاري كوثربهمن,4662412,249998861,3620983502724,1000,14484,14484,13484,1348.4,14484,13484,1348.4,14484,14484,1399-9-19
1,بوعلي,پتروشيمي بوعلي سينا,4519898,341995463,14168872032090,1000,41430,41430,40430,4043.0,41430,40430,4043.0,41430,41430,1399-9-19
2,پالايش,صندوق پالايشي يکم-سهام,133114,39613764,3971587099610,101150,100710,100190,-960,-0.95,100260,-890,-0.88,100000,101990,1399-9-19
3,وسپهر,سرمايه گذاري مالي سپهرصادرات,126011,278601653,3355172584109,11660,11780,12243,583,5.0,12043,383,3.28,11510,12243,1399-9-19
4,بپيوند,برق و انرژي پيوندگستر پارس,110664,77554566,2679399814759,33921,35400,33997,76,0.22,34549,628,1.85,33100,35800,1399-9-19
5,شستا,سرمايه گذاري تامين اجتماعي,97886,185583661,5356999104470,29360,29150,29220,-140,-0.48,28870,-490,-1.67,28360,29570,1399-9-19
6,زملارد,كشاورزي و دامپروري ملارد شير,68475,5379606,237009501440,42294,42200,44408,2114,5.0,44057,1763,4.17,41100,44408,1399-9-19
7,فملي,ملي‌ صنايع‌ مس‌ ايران‌,66659,208530538,3349310452240,16100,16500,16120,20,0.12,16060,-40,-0.25,15510,16700,1399-9-19
8,آبادا,توليد نيروي برق آبادان,65098,16942960,353640194530,20040,19760,21040,1000,4.99,20870,830,4.14,19760,21040,1399-9-19
9,غزر,صنعتي زر ماكارون,62751,5855595,364545197330,62050,62650,62290,240,0.39,62260,210,0.34,60020,64000,1399-9-19
10,وتجارت,بانك تجارت,58657,1097575672,4327738619620,4040,4000,3920,-120,-2.97,3940,-100,-2.48,3880,4050,1399-9-19
11,خودرو,ايران‌ خودرو,58122,996182647,4140957230680,4170,4210,4180,10,0.24,4160,-10,-0.24,4060,4300,1399-9-19
12,دارا يكم,صندوق واسطه گري مالي يكم-سهام,54017,18274726,3491392914490,194520,194550,190250,-4270,-2.2,191050,-3470,-1.78,188770,195100,1399-9-19
13,شپنا,پالايش نفت اصفهان,53988,199790170,3490936813550,17980,17430,17470,-510,-2.84,17470,-510,-2.84,17100,18200,1399-9-19
14,پيزد,مجتمع صنايع لاستيك يزد,52149,3631594,327347710475,86937,87000,91283,4346,5.0,90139,3202,3.68,86951,91283,1399-9-19
15,امين,تامين سرمايه امين,50394,25092069,308967081990,11800,11950,12390,590,5.0,12310,510,4.32,11800,12390,1399-9-19
16,خساپا,سايپا,48739,1165809110,3737416300660,3280,3280,3200,-80,-2.44,3210,-70,-2.13,3130,3370,1399-9-19
17,گدنا,تهيه توزيع غذاي دنا آفرين فدك,47590,3854391,128170063923,31670,33253,33253,1583,5.0,33253,1583,5.0,33253,33253,1399-9-19
18,سيتا,سرمايه گذاري سيمان تامين,45916,53940094,972058315240,17390,17350,18250,860,4.95,18020,630,3.62,17350,18250,1399-9-19
19,وبصادر,بانك صادرات ايران,45700,1065796164,4044089040820,3890,3940,3740,-150,-3.86,3790,-100,-2.57,3700,3980,1399-9-19
20,فولاد,فولاد مباركه اصفهان,44818,240497564,3472594852450,14320,14200,14770,450,3.14,14440,120,0.84,14020,14850,1399-9-19
21,شاروم,پتروشيمي اروميه,43982,4475294,126171963742,26851,28193,28193,1342,5.0,28193,1342,5.0,28193,28193,1399-9-19
22,بگيلان,توسعه مسير برق گيلان,43373,5300752,152083875632,27325,28691,28691,1366,5.0,28691,1366,5.0,28691,28691,1399-9-19
23,دي,بانك دي,41314,76743849,3889044142160,49798,49000,52287,2489,5.0,50676,878,1.76,48290,52287,1399-9-19
24,بركت,گروه دارويي بركت,39645,122221297,2727422570800,21530,22600,22600,1070,4.97,22320,790,3.67,21530,22600,1399-9-19
25,ثاميد,توسعه و عمران اميد,38956,176890588,442226470000,2390,2500,2500,110,4.6,2500,110,4.6,2500,2500,1399-9-19
26,شتران,پالايش نفت تهران,37848,141848975,1925373015920,14060,13710,13650,-410,-2.92,13570,-490,-3.49,13360,14250,1399-9-19
27,آريا,پليمر آريا ساسول,36289,3888725,707573373484,186282,183020,183420,-2862,-1.54,181955,-4327,-2.32,178400,185821,1399-9-19
28,وپويا,سرمايه گذاري پويا,34381,56698855,549095114101,9231,9692,9692,461,4.99,9684,453,4.91,9510,9692,1399-9-19
29,خگستر,گسترش‌سرمايه‌گذاري‌ايران‌خودرو,33852,383622228,1905117007490,5030,5150,4960,-70,-1.39,4970,-60,-1.19,4810,5160,1399-9-19
30,چخزر,صنايع چوب خزر كاسپين,33618,224701,6155459194,26090,27394,27394,1304,5.0,26237,147,0.56,27394,27394,1399-9-19
31,رافزا,رايان هم افزا,31283,182558,6901422632,36004,37804,37804,1800,5.0,36236,232,0.64,37804,37804,1399-9-19
32,ثبهساز,بهساز كاشانه تهران,26915,76114193,235953998300,2960,3100,3100,140,4.73,3100,140,4.73,3100,3100,1399-9-19
33,شبندر,پالايش نفت بندرعباس,26661,61423854,1932627388630,31730,31950,31700,-30,-0.09,31460,-270,-0.85,30500,32440,1399-9-19
34,پترول,گروه پتروشيمي س. ايرانيان,24276,107276400,1432327869360,13030,13110,13680,650,4.99,13350,320,2.46,12940,13680,1399-9-19
35,تليسه,دامداري تليسه نمونه,23653,157126848,1279894706591,8020,7850,8230,210,2.62,8146,126,1.57,7660,8373,1399-9-19
36,وبملت,بانك ملت,22031,308950823,1641365018120,5400,5350,5300,-100,-1.85,5310,-90,-1.67,5230,5420,1399-9-19
37,ذوب,سهامي ذوب آهن  اصفهان,20963,195569044,1099817388420,5518,5477,5720,202,3.66,5624,106,1.92,5450,5760,1399-9-19
38,حكشتي,كشتيراني جمهوري اسلامي ايران,18537,53526982,1714756327100,30730,30150,32260,1530,4.98,32040,1310,4.26,30150,32260,1399-9-19
39,حسينا,توسعه خدمات دريايي وبندري سينا,17324,19446698,1839955932971,91334,94000,93800,2466,2.7,94615,3281,3.59,91334,99980,1399-9-19
40,شگويا,پتروشيمي تندگويان,16947,76760815,998372262566,12479,12370,13102,623,4.99,13006,527,4.22,12370,13102,1399-9-19
41,خزاميا,زامياد,16181,81627396,1248352509230,15220,15150,15710,490,3.22,15290,70,0.46,14710,15900,1399-9-19
42,وغدير,سرمايه‌گذاري‌غدير(هلدينگ‌,15184,62876103,851477966360,13820,13420,13710,-110,-0.8,13540,-280,-2.03,13220,13900,1399-9-19
43,وپارس,بانك‌پارسيان‌,14609,285249303,1212794526890,4350,4270,4250,-100,-2.3,4250,-100,-2.3,4170,4420,1399-9-19
44,البرز,بيمه البرز,14406,306155218,1781654636460,5570,5800,5840,270,4.85,5820,250,4.49,5630,5840,1399-9-19
45,پتاير,ايران‌ تاير,14367,7778966,1393112033900,166530,169500,183180,16650,10.0,179090,12560,7.54,166690,183180,1399-9-19
46,خپارس,پارس‌ خودرو,13841,126240121,1119943431450,8590,8880,9010,420,4.89,8870,280,3.26,8500,9010,1399-9-19
47,وخارزم,سرمايه گذاري خوارزمي,13156,75136333,832899444020,10860,10690,11400,540,4.97,11090,230,2.12,10650,11400,1399-9-19
48,صبا,سرمايه گذاري صبا تامين,12590,35850205,341518802426,9262,9180,9680,418,4.51,9526,264,2.85,9100,9720,1399-9-19
49,حفاري,حفاري شمال,12441,98449141,1403685540030,13690,13350,14370,680,4.97,14260,570,4.16,13350,14370,1399-9-19
50,شبريز,پالايش نفت تبريز,12387,26753964,974192626510,36960,37750,35940,-1020,-2.76,36410,-550,-1.49,35500,37750,1399-9-19
51,فخوز,فولاد  خوزستان,12071,27956688,1132858089800,40780,40070,41280,500,1.23,40520,-260,-0.64,39800,41470,1399-9-19
52,كرمان,س. توسعه و عمران استان كرمان,11984,17112886,1545409573168,89136,89501,91800,2664,2.99,90307,1171,1.31,87010,93500,1399-9-19
53,قصفها,قنداصفهان‌,11948,3830648,982834754940,240400,254990,260520,20120,8.37,256570,16170,6.73,249390,263500,1399-9-19
54,غنوش,نوش‌ مازندران‌,11211,15243618,968944604540,65290,62030,66900,1610,2.47,63560,-1730,-2.65,62030,66900,1399-9-19
55,غگيلا,شيرپاستوريزه پگاه گيلان,11205,168301,3048604314,17252,18114,18114,862,5.0,17302,50,0.29,18114,18114,1399-9-19
56,فارس,صنايع پتروشيمي خليج فارس,11009,41325781,570359507950,14030,14030,13770,-260,-1.85,13800,-230,-1.64,13450,14300,1399-9-19
57,ساوه,سيمان ساوه,10699,2627075,171369117737,65000,65000,66000,1000,1.54,65232,232,0.36,63600,66100,1399-9-19
58,تاپيكو,س. نفت و گاز و پتروشيمي تأمين,10697,44728051,736997060650,16350,16190,16830,480,2.94,16480,130,0.8,15890,16990,1399-9-19
59,بجهرم,توسعه مولد نيروگاهي جهرم,10399,102190603,438481444557,4119,4200,4324,205,4.98,4291,172,4.18,4160,4324,1399-9-19
60,تبرك,گروه كارخانجات صنعتي تبرك,9224,20524468,558942445523,26869,27000,28211,1342,4.99,27233,364,1.35,25988,28212,1399-9-19
61,وساپا,سرمايه‌گذاري‌ سايپا,9202,54908438,571291475280,10510,10500,10500,-10,-0.1,10400,-110,-1.05,10170,10800,1399-9-19
62,داراب,پتروشيمي داراب,9197,120617937,358405144859,2992,2903,2965,-27,-0.9,2971,-21,-0.7,2903,3049,1399-9-19
63,فروي,ذوب روي اصفهان,9161,7784979,521362257197,64631,66800,67862,3231,5.0,66970,2339,3.62,64446,67862,1399-9-19
64,ونوين,بانك‌اقتصادنوين‌,9158,144319659,813671427230,5800,5800,5700,-100,-1.72,5640,-160,-2.76,5510,5810,1399-9-19
65,شيران,س. صنايع‌شيميايي‌ايران,9132,15970217,654988249780,41510,42000,40540,-970,-2.34,41010,-500,-1.2,40200,43000,1399-9-19
66,زشگزا,شير و گوشت زاگرس شهركرد,8904,3972308,634415441667,166658,170000,158450,-8208,-4.93,159710,-6948,-4.17,158326,170000,1399-9-19
67,سامان,بانك سامان,8572,106062071,1349456826739,12579,12956,12500,-79,-0.63,12723,144,1.14,12202,12956,1399-9-19
68,چكاپا,گروه صنايع كاغذ پارس,8493,57355379,386600266090,6880,6870,6790,-90,-1.31,6740,-140,-2.03,6620,6990,1399-9-19
69,هاي وب,داده گسترعصرنوين-هاي وب,8429,43661045,1345477644620,29690,29600,31170,1480,4.98,30820,1130,3.81,29510,31170,1399-9-19
70,زكوثر,سرمايه گذاري كشاورزي كوثر,8329,15166067,405341739770,26500,27220,26790,290,1.09,26730,230,0.87,26080,27400,1399-9-19
71,تپمپي,پمپ‌ سازي‌ ايران‌,8319,12316794,460167679430,36810,38100,37100,290,0.79,37360,550,1.49,35200,38650,1399-9-19
72,خمحركه,نيرو محركه‌,8211,45253388,356104805200,7710,7790,7980,270,3.5,7870,160,2.08,7610,7990,1399-9-19
73,جهرم,پتروشيمي جهرم,8003,119679527,371345995213,3074,2982,3166,92,2.99,3103,29,0.94,2982,3166,1399-9-19
74,وشهر,بانك شهر,7997,82696575,628460999300,7869,7555,7650,-219,-2.78,7600,-269,-3.42,7555,7810,1399-9-19
75,ونيرو,سرمايه‌گذاري‌نيرو,7789,85494140,421912567420,4910,4890,5050,140,2.85,4930,20,0.41,4750,5090,1399-9-19
76,لكما,كارخانجات‌مخابراتي‌ايران‌,7712,51373904,480048833690,9094,9250,9366,272,2.99,9344,250,2.75,8850,9366,1399-9-19
77,غشهداب,كشت و صنعت شهداب ناب خراسان,7703,99776755,538240053357,5172,5400,5430,258,4.99,5394,222,4.29,5220,5430,1399-9-19
78,ورنا,سرمايه‌گذاري‌ رنا(هلدينگ‌,7625,61426801,618960071510,10440,10300,9990,-450,-4.31,10080,-360,-3.45,9920,10700,1399-9-19
79,سبزوا,سيمان لار سبزوار,7600,47821052,288228926573,5868,5900,6096,228,3.89,6027,159,2.71,5800,6120,1399-9-19
80,بكهنوج,توليد برق ماهتاب كهنوج,7509,104501982,333230278068,3203,3290,3223,20,0.62,3189,-14,-0.44,3100,3290,1399-9-19
81,خصدرا,صنعتي‌ دريايي‌ ايران‌,7437,83784574,462981025618,5384,5321,5545,161,2.99,5526,142,2.64,5321,5545,1399-9-19
82,فرابورس,فرابورس ايران,7271,14181262,877546899893,59095,58500,62049,2954,5.0,61881,2786,4.71,58500,62049,1399-9-19
83,ختوقا,قطعات‌ اتومبيل‌ ايران‌,7218,81608854,341699970960,4180,4190,4270,90,2.15,4190,10,0.24,4050,4300,1399-9-19
84,آسيا,بيمه آسيا,7116,20386268,734792728920,34490,35100,36210,1720,4.99,36040,1550,4.49,34500,36210,1399-9-19
85,شلرد,كود شيميايي اوره لردگان,6870,68839360,800497360958,11304,11620,11643,339,3.0,11628,324,2.87,11210,11643,1399-9-19
86,خكمك,كمك‌فنرايندامين‌,6864,9288790,467827734000,49350,49350,50400,1050,2.13,50360,1010,2.05,48500,51460,1399-9-19
87,ولساپا,ليزينگ رايان‌ سايپا,6798,83161248,384644391420,4540,4520,4740,200,4.41,4630,90,1.98,4450,4750,1399-9-19
88,فبيرا,بسته‌ بندي‌ ايران‌,6761,92431837,462019750344,4999,4850,5148,149,2.98,4998,-1,-0.02,4850,5148,1399-9-19
89,ثاخت,بين‌المللي‌توسعه‌ساختمان,6652,65871689,304235565550,4520,4690,4610,90,1.99,4620,100,2.21,4510,4700,1399-9-19
90,شكلر,نيروكلر,6571,10638025,670995376540,65930,67930,62640,-3290,-4.99,63080,-2850,-4.32,62640,67930,1399-9-19
91,غگل,گلوكوزان‌,6537,75803246,420815864840,5310,5560,5570,260,4.9,5550,240,4.52,5340,5570,1399-9-19
92,دماوند,توليد نيروي برق دماوند,6466,4681780,360201316883,75683,77470,76750,1067,1.41,76937,1254,1.66,75010,78890,1399-9-19
93,خكرمان,گروه اقتصادي كرمان خودرو,6461,59960598,361740147352,6179,6200,6006,-173,-2.8,6033,-146,-2.36,5994,6200,1399-9-19
94,وساخت,سرمايه‌ گذاري‌ ساختمان‌ايران‌,6403,6366582,420756873390,67150,65220,67850,700,1.04,66090,-1060,-1.58,64010,68490,1399-9-19
95,ونيكي,سرمايه‌گذاري‌ ملي‌ايران‌,6396,38142144,719330257080,17970,18860,18860,890,4.95,18860,890,4.95,18800,18860,1399-9-19
96,ودي,بيمه  دي,6225,31241534,956718110104,29297,29800,30761,1464,5.0,30623,1326,4.53,29800,30761,1399-9-19
97,سفارس,سيمان فارس و خوزستان,6215,31017800,629305528290,19440,20110,20410,970,4.99,20290,850,4.37,19600,20410,1399-9-19
98,وملل,اعتباري ملل,6184,80352877,1347769089730,16030,16300,16831,801,5.0,16773,743,4.64,16050,16831,1399-9-19
99,مدير,ص.س.مديريت ثروت ص.بازنشستگي-س,6101,42344417,513897391950,11375,11450,12512,1137,10.0,12136,761,6.69,11450,12512,1399-9-19
100,اخابر,مخابرات ايران,6098,50835927,812985100010,15470,15450,16240,770,4.98,15990,520,3.36,14910,16240,1399-9-19
101,ومعادن,توسعه‌معادن‌وفلزات‌,6038,29884909,453688263380,15180,15320,15210,30,0.2,15180,0,0.0,14800,15650,1399-9-19
102,بكام,كارخانجات توليدي شهيد قندي,5995,58146273,289732008690,4810,4900,5050,240,4.99,4980,170,3.53,4850,5050,1399-9-19
103,كسرا,سراميك‌هاي‌صنعتي‌اردكان‌,5876,16864154,582274586480,34000,35400,35660,1660,4.88,34530,530,1.56,33150,35700,1399-9-19
104,كسعدي,كاشي‌ سعدي‌,5794,11589548,446897834560,36970,38550,38810,1840,4.98,38560,1590,4.3,37700,38810,1399-9-19
105,كگل,معدني و صنعتي گل گهر,5759,17540457,339242528000,19960,19110,19400,-560,-2.81,19340,-620,-3.11,18970,20330,1399-9-19
106,فاراك,ماشين‌ سازي‌ اراك‌,5714,52596820,419310658250,7650,7650,8030,380,4.97,7970,320,4.18,7650,8030,1399-9-19
107,غديس,پاكديس,5699,18244066,239682656324,13229,13240,12982,-247,-1.87,13138,-91,-0.69,12700,13800,1399-9-19
108,لپارس,پارس‌ الكتريك‌,5501,2652172,448829692080,161450,169380,169520,8070,5.0,169230,7780,4.82,164410,169520,1399-9-19
109,ماديرا,صنايع ماشين هاي اداري ايران,5452,15261558,461377877666,29201,29000,30661,1460,5.0,30231,1030,3.53,28800,30661,1399-9-19
110,ارزش,صندوق س ارزش آفرين بيدار-سهام,5258,52744791,615283201310,11210,11230,11860,650,5.8,11670,460,4.1,11230,11980,1399-9-19
111,كحافظ,كاشي‌ وسراميك‌ حافظ‌,5237,17149539,356618214620,20010,19600,21010,1000,5.0,20790,780,3.9,19600,21010,1399-9-19
112,خبهمن,گروه‌بهمن‌,5177,32950424,944251007350,27390,27400,28750,1360,4.97,28660,1270,4.64,27390,28750,1399-9-19
113,دزهراوي,داروسازي‌زهراوي‌,5106,16613331,237609988810,14070,14600,14400,330,2.35,14300,230,1.63,13880,14700,1399-9-19
114,دتوليد,داروسازي توليد دارو,5055,8635334,323645568859,37708,39500,36830,-878,-2.33,37479,-229,-0.61,36100,39500,1399-9-19
115,شغدير,پتروشيمي غدير,4941,7997397,593942500592,72235,75700,75846,3611,5.0,74267,2032,2.81,72235,75846,1399-9-19
116,وپاسار,بانك  پاسارگاد,4938,41792526,494486273880,11720,11820,11860,140,1.19,11830,110,0.94,11810,11860,1399-9-19
117,كبافق,معادن‌ بافق‌,4929,6024263,288409485850,46670,45380,48900,2230,4.78,47870,1200,2.57,44600,49000,1399-9-19
118,كاوه,فولاد كاوه جنوب كيش,4904,21089677,471452834650,21710,21700,22790,1080,4.97,22350,640,2.95,21450,22790,1399-9-19
119,خرينگ,رينگ‌سازي‌مشهد,4868,5650844,377825500890,64820,63270,68060,3240,5.0,66860,2040,3.15,63270,68060,1399-9-19
120,تملت,تامين سرمايه بانك ملت,4849,25046485,236104234590,9000,9190,9450,450,5.0,9430,430,4.78,9010,9450,1399-9-19
121,بزاگرس,نيروگاه زاگرس كوثر,4838,21413072,299717649861,14280,13830,13900,-380,-2.66,13997,-283,-1.98,13650,14695,1399-9-19
122,قشير,قند شيروان قوچان و بجنورد,4781,7031647,236699885521,34910,35000,33270,-1640,-4.7,33662,-1248,-3.57,33190,35050,1399-9-19
123,قچار,فراوردههاي غذايي وقند چهارمحال,4684,7120209,471302398205,67412,70782,64042,-3370,-5.0,66192,-1220,-1.81,64042,70782,1399-9-19
124,فسا,پتروشيمي فسا,4633,61367282,169564828290,2812,2728,2730,-82,-2.92,2763,-49,-1.74,2728,2845,1399-9-19
125,ونفت,سرمايه‌گذاري‌ صنعت‌ نفت‌,4631,14762770,264734604570,18150,18900,17700,-450,-2.48,17930,-220,-1.21,17250,18940,1399-9-19
126,كالا,بورس كالاي ايران,4610,9519321,497673925640,49950,52200,52440,2490,4.98,52280,2330,4.66,50100,52440,1399-9-19
127,كترام,توليدي‌ كاشي‌ تكسرام‌,4575,11885176,456704845480,38270,37000,39320,1050,2.74,38430,160,0.42,36360,40160,1399-9-19
128,پاكشو,گروه صنعتي پاكشو,4572,3577580,307732428790,83800,82500,87990,4190,5.0,86020,2220,2.65,82000,87990,1399-9-19
129,ملت,بيمه ملت,4551,15900195,309354517270,19430,20000,19540,110,0.57,19460,30,0.15,19160,20200,1399-9-19
130,وتوصا,گروه س توسعه صنعتي ايران,4494,32075069,512659264370,15510,15100,16280,770,4.96,15980,470,3.03,15000,16280,1399-9-19
131,وبانك,سرمايه گذاري گروه توسعه ملي,4483,16872864,193155420410,11580,11250,11720,140,1.21,11450,-130,-1.12,11100,11800,1399-9-19
132,خاذين,سايپاآذين‌,4456,31430348,200180875280,6390,6330,6520,130,2.03,6370,-20,-0.31,6160,6550,1399-9-19
133,فسرب,ملي‌ سرب‌وروي‌ ايران‌,4397,1855885,281854362630,154930,156000,152280,-2650,-1.71,151870,-3060,-1.98,149000,157240,1399-9-19
134,فزرين,زرين معدن آسيا,4354,12113476,368167559420,30585,29422,30000,-585,-1.91,30393,-192,-0.63,29422,31500,1399-9-19
135,بپاس,بيمه پاسارگاد,4307,5900816,542181994743,88526,91000,92510,3984,4.5,91883,3357,3.79,90005,92510,1399-9-19
136,زبينا,كشاورزي و دامپروري بينالود,4295,4579057,252796405585,54210,53300,55530,1320,2.43,55207,997,1.84,53300,56170,1399-9-19
137,حسير,ريل سير كوثر,4293,14744730,286699006858,18995,18437,19943,948,4.99,19444,449,2.36,18437,19944,1399-9-19
138,تنوينح,ح . تامين سرمايه نوين,4238,16855567,89006400603,5108,5199,5360,252,4.93,5281,173,3.39,5065,5449,1399-9-19
139,كچاد,معدني‌وصنعتي‌چادرملو,4229,14552902,304222650030,21380,21590,20930,-450,-2.1,20900,-480,-2.25,20580,21590,1399-9-19
140,وپست,پست بانك ايران,4225,28335058,565636689100,20890,21000,19850,-1040,-4.98,19960,-930,-4.45,19850,21200,1399-9-19
141,شصدف,صنعتي دوده فام,4165,162987,4208324340,24591,25820,25820,1229,5.0,24687,96,0.39,25820,25820,1399-9-19
142,قثابت,قند ثابت‌ خراسان‌,4147,4337782,367535132830,83920,83000,85990,2070,2.47,84730,810,0.97,80020,86000,1399-9-19
143,ثمسكن,سرمايه‌گذاري‌ مسكن‌,4026,29473235,204289952300,6680,6860,7010,330,4.94,6930,250,3.74,6700,7010,1399-9-19
144,وبوعلي,سرمايه‌گذاري‌بوعلي‌,3999,22467454,175928121360,7610,7880,7990,380,4.99,7830,220,2.89,7550,7990,1399-9-19
145,كهمدا,شيشه‌ همدان‌,3776,13425158,193949192060,14150,14800,14110,-40,-0.28,14450,300,2.12,13860,14850,1399-9-19
146,ثتران,سرمايه گذاري مسكن تهران,3717,35037811,202482780313,5674,5700,5900,226,3.98,5779,105,1.85,5401,5946,1399-9-19
147,هرمز,فولاد هرمزگان جنوب,3698,20858023,292228883008,13506,13490,14181,675,5.0,14010,504,3.73,13490,14181,1399-9-19
148,كرازي,كارخانجات‌توليدي‌شيشه‌رازي‌,3648,8401688,214026547660,24300,25000,25510,1210,4.98,25470,1170,4.81,24800,25510,1399-9-19
149,قرن,پديده شيمي قرن,3602,2073237,127197914510,60800,62000,61450,650,1.07,61350,550,0.9,60810,62300,1399-9-19
150,كگاز,شيشه‌ و گاز,3599,6948245,169583460870,24980,24300,24750,-230,-0.92,24410,-570,-2.28,23900,24980,1399-9-19
151,كيميا,معدني كيمياي زنجان گستران,3592,5960754,199809250670,35015,33274,33282,-1733,-4.95,33521,-1494,-4.27,33265,35440,1399-9-19
152,غگرجي,بيسكويت‌  گرجي‌,3588,5628828,227881412940,38730,40000,40660,1930,4.98,40480,1750,4.52,39000,40660,1399-9-19
153,رنيك,جنرال مكانيك,3583,9357933,261915714005,27439,28590,28810,1371,5.0,27989,550,2.0,26753,28810,1399-9-19
154,خريخت,صنايع‌ريخته‌گري‌ايران‌,3563,53072396,249516579280,4510,4610,4730,220,4.88,4700,190,4.21,4520,4730,1399-9-19
155,ومهان,گروه توسعه مالي مهر آيندگان,3561,7894935,139117220673,17746,17270,17790,44,0.25,17621,-125,-0.7,17220,18200,1399-9-19
156,وهور,مديريت انرژي اميد  تابان هور,3560,8602191,374601305827,42942,41350,44060,1118,2.6,43547,605,1.41,41350,44370,1399-9-19
157,كپارس,كاشي‌ پارس‌,3549,2399326,414046758430,165340,165340,173600,8260,5.0,172570,7230,4.37,160000,173600,1399-9-19
158,ميهن,بيمه ميهن,3497,56174527,405436011663,6887,7231,7231,344,4.99,7217,330,4.79,6940,7231,1399-9-19
159,وصنعت,سرمايه گذاري توسعه صنعت وتجارت,3459,31857781,277928467210,9020,8960,8630,-390,-4.32,8720,-300,-3.33,8520,9140,1399-9-19
160,نوين,بيمه نوين,3427,28120194,270701492823,9182,9510,9641,459,5.0,9627,445,4.85,9360,9641,1399-9-19
161,ارفع,شركت آهن و فولاد ارفع,3411,16384080,248662815638,14818,14520,15558,740,4.99,15177,359,2.42,14520,15558,1399-9-19
162,وايران,ليزينگ ايرانيان,3409,20329145,298345382360,14090,14460,14790,700,4.97,14680,590,4.19,14200,14790,1399-9-19
163,غبهنوش,بهنوش‌ ايران‌,3366,2943830,374551874250,116740,127000,128410,11670,10.0,127230,10490,8.99,120010,128410,1399-9-19
164,چافست,افست‌,3243,7520205,183892533120,25150,26270,24300,-850,-3.38,24450,-700,-2.78,23900,26270,1399-9-19
165,رانفور,خدمات‌انفورماتيك‌,3218,6033126,209626223690,33640,33670,35320,1680,4.99,34750,1110,3.3,33670,35320,1399-9-19
166,وتوس,توسعه‌شهري‌توس‌گستر,3144,9072990,252955443370,26740,27360,28070,1330,4.97,27880,1140,4.26,26740,28070,1399-9-19
167,كمند,صندوق س. با درآمد ثابت كمند,3109,132609753,1329958990638,10017,10025,10030,13,0.13,10029,12,0.12,10023,10033,1399-9-19
168,كپشيرح,ح . پشم‌شيشه‌ايران‌,3047,11310348,149019012799,12181,12260,13320,1139,9.35,13175,994,8.16,12260,13400,1399-9-19
169,ثغرب,شركت سرمايه گذاري مسكن شمالغرب,3041,20375670,254501123493,11916,12300,12511,595,4.99,12490,574,4.82,12130,12511,1399-9-19
170,كلر,كلر پارس,2978,2580866,200648779435,74231,76890,77942,3711,5.0,77745,3514,4.73,74850,77942,1399-9-19
171,آگاس,صندوق س.هستي بخش آگاه-س,2964,2282361,173574666939,75582,76001,76430,848,1.12,76050,468,0.62,75601,76800,1399-9-19
172,ثنام,س ساختماني ب نام آوران مهندسي,2932,14369143,319556217578,21843,21188,22498,655,3.0,22239,396,1.81,21188,22498,1399-9-19
173,ساربيل,سيمان آرتا اردبيل,2928,3378967,173215804680,49750,48700,52230,2480,4.98,51260,1510,3.04,48700,52230,1399-9-19
174,خوساز,محورسازان‌ايران‌خودرو,2928,21168339,169134687130,7820,7650,8210,390,4.99,7990,170,2.17,7600,8210,1399-9-19
175,كروي,توسعه‌ معادن‌ روي‌ ايران‌,2914,8603036,321633103190,36260,38070,37200,940,2.59,37390,1130,3.12,35000,38070,1399-9-19
176,سشرق,سيمان‌ شرق‌,2912,26441814,183392582190,6710,6620,7040,330,4.92,6940,230,3.43,6620,7040,1399-9-19
177,زقيام,كشت و دام قيام اصفهان,2911,6019479,248110024265,39453,38900,41425,1972,5.0,41218,1765,4.47,38900,41425,1399-9-19
178,رمپنا,گروه مپنا (سهامي عام),2903,10918806,234973843970,21780,21080,21630,-150,-0.69,21520,-260,-1.19,20970,22450,1399-9-19
179,ولصنم,ليزينگ‌صنعت‌ومعدن‌,2896,15787421,191001340480,11550,11990,12120,570,4.94,12100,550,4.76,11600,12120,1399-9-19
180,اپرداز,آتيه داده پرداز,2894,5389364,173397665989,32735,31700,32200,-535,-1.63,32174,-561,-1.71,31250,33150,1399-9-19
181,واتي,سرمايه‌ گذاري‌ آتيه‌ دماوند,2893,17629250,285391983760,15690,16400,15940,250,1.59,16190,500,3.19,15700,16470,1399-9-19
182,اميد,تامين سرمايه اميد,2885,13816022,200457398800,14050,14590,14660,610,4.34,14510,460,3.27,13610,14750,1399-9-19
183,مرقام,ايران‌ارقام‌,2880,6920212,180622147700,25650,25500,26930,1280,4.99,26100,450,1.75,25100,26930,1399-9-19
184,شمواد,توليد مواداوليه الياف مصنوعي,2857,2771952,180030485026,62260,65373,65373,3113,5.0,64947,2687,4.32,62800,65373,1399-9-19
185,ولشرق,ليزينگ ايران و شرق,2850,19996377,157168184714,7565,7943,7943,378,5.0,7860,295,3.9,7657,7943,1399-9-19
186,ثنوسا,نوسازي‌وساختمان‌تهران‌,2797,32222913,422189333230,12490,13080,13110,620,4.96,13100,610,4.88,13000,13110,1399-9-19
187,وپترو,سرمايه‌گذاري صنايع پتروشيمي‌,2791,12531456,251218486490,19300,19200,20250,950,4.92,20050,750,3.89,19010,20260,1399-9-19
188,حفارس,حمل و نقل بين المللي خليج فارس,2768,33705794,165074613940,4700,4700,4930,230,4.89,4900,200,4.26,4700,4930,1399-9-19
189,شسپا,نفت سپاهان,2767,6980754,192546207650,27860,27300,28100,240,0.86,27580,-280,-1.01,26910,28500,1399-9-19
190,فولاي,صنايع فولاد آلياژي يزد,2761,3992360,150002595913,37052,37700,37570,518,1.4,37572,520,1.4,36500,38240,1399-9-19
191,پارسان,گسترش نفت و گاز پارسيان,2754,7450886,179648900530,24180,24000,24650,470,1.94,24110,-70,-0.29,23590,24800,1399-9-19
192,تنوين,تامين سرمايه نوين,2751,48202778,362333554620,7250,7130,7610,360,4.97,7520,270,3.72,7120,7610,1399-9-19
193,پرديس,سرمايه گذاري پرديس,2750,21060069,175407305360,7980,8370,8310,330,4.14,8330,350,4.39,8190,8370,1399-9-19
194,سرو,صندوق س سروسودمند مدبران-سهام,2740,3577179,261635691890,73040,72650,73470,430,0.59,73140,100,0.14,72650,73950,1399-9-19
195,ولبهمن,شركت بهمن ليزينگ,2729,19298330,223361210625,11193,11500,11362,169,1.51,11574,381,3.4,11181,11752,1399-9-19
196,شفارس,صنايع‌ شيميايي‌ فارس‌,2728,4916744,299183783500,58760,60000,61690,2930,4.99,60850,2090,3.56,58780,61690,1399-9-19
197,فاذر,صنايع‌ آذرآب‌,2721,5180971,193666864730,35670,36980,37450,1780,4.99,37380,1710,4.79,36000,37450,1399-9-19
198,فسپا,گروه‌صنعتي‌سپاهان‌,2674,6677882,363298434560,52860,55500,54350,1490,2.82,54400,1540,2.91,52860,55500,1399-9-19
199,ثشاهد,سرمايه‌ گذاري‌ شاهد,2630,7326900,224422947000,29180,30630,30630,1450,4.97,30630,1450,4.97,30630,30630,1399-9-19
200,خمهر,مهركام‌پارس‌,2620,16680478,130199765570,7830,7890,8030,200,2.55,7810,-20,-0.26,7560,8140,1399-9-19
201,خاهن,آهنگري‌ تراكتورسازي‌ ايران‌,2608,4282203,174739104130,41570,41860,41400,-170,-0.41,40810,-760,-1.83,39550,43000,1399-9-19
202,ثباغ,شهر سازي و خانه سازي باغميشه,2574,4913924,120912874801,24047,25230,24190,143,0.59,24606,559,2.32,24002,25230,1399-9-19
203,قشرين,قند شيرين خراسان,2547,13327137,314395850421,23004,23000,23693,689,3.0,23591,587,2.55,22322,23694,1399-9-19
204,سپاها,سيمان‌سپاهان‌,2543,22783515,213267909630,9010,8890,9460,450,4.99,9360,350,3.88,8750,9460,1399-9-19
205,ثرود,سرمايه‌گذاري مسكن زاينده رود,2542,18452609,223412089238,11578,11950,12156,578,4.99,12107,529,4.57,11731,12156,1399-9-19
206,چكارن,كارتن‌ ايران‌,2528,24799417,106282848410,4130,4270,4330,200,4.84,4290,160,3.87,4150,4330,1399-9-19
207,ثالوند,سرمايه گذاري مسكن الوند,2524,7073940,121645471730,17365,17750,17122,-243,-1.4,17196,-169,-0.97,16690,17790,1399-9-19
208,ستران,سيمان‌ تهران‌,2521,3833318,148134692090,37340,37990,39200,1860,4.98,38640,1300,3.48,37000,39200,1399-9-19
209,پكرمان,گروه‌ صنعتي‌ بارز,2492,9641663,307643730820,32540,31240,31910,-630,-1.94,31910,-630,-1.94,30980,33400,1399-9-19
210,تاصيكو,سرمايه گذاري صدرتامين,2486,10742184,123904573750,11720,11770,11650,-70,-0.6,11530,-190,-1.62,11230,11770,1399-9-19
211,ريشمك,توليد و صادرات ريشمك,2475,3218054,184109280456,54527,57200,57253,2726,5.0,57211,2684,4.92,55100,57253,1399-9-19
212,حآسا,آسيا سير ارس,2464,8133582,210971111714,25721,24890,26740,1019,3.96,25938,217,0.84,24890,26940,1399-9-19
213,فايرا,آلومينيوم‌ايران‌,2459,12413708,347614874690,26750,26670,28080,1330,4.97,28000,1250,4.67,26200,28080,1399-9-19
214,بورس,بورس اوراق بهادار تهران,2454,6296981,420300778320,63760,64900,66940,3180,4.99,66750,2990,4.69,64190,66940,1399-9-19
215,پلاسك,پلاسكوكار,2442,15909338,139839273830,8540,8500,8960,420,4.92,8790,250,2.93,8260,8960,1399-9-19
216,قنيشا,قند  نيشابور,2428,2919447,230850872960,75390,79100,79150,3760,4.99,79070,3680,4.88,77470,79150,1399-9-19
217,كساوه,صنايع‌ كاشي‌ و سراميك‌ سينا,2415,3376335,338229828900,96050,100000,100810,4760,4.96,100180,4130,4.3,97510,100850,1399-9-19
218,غگلستا,شير پاستوريزه پگاه گلستان,2408,7935306,164658765435,20002,21002,21002,1000,5.0,20750,748,3.74,19100,21002,1399-9-19
219,زفكا,كشت و دامداري فكا,2356,2550936,137951901105,52240,53699,54100,1860,3.56,54079,1839,3.52,52251,54600,1399-9-19
220,همراه,شركت ارتباطات سيار ايران,2337,10077709,366586407380,35310,35040,37070,1760,4.98,36380,1070,3.03,33890,37070,1399-9-19
221,غمينوح,ح . شركت صنايع غذايي مينو شرق,2318,6521839,81149577459,12338,12350,12151,-187,-1.52,12443,105,0.85,12150,12700,1399-9-19
222,وسكاب,س.ص.بازنشستگي كاركنان بانكها,2280,19307341,135666870190,7030,7000,7120,90,1.28,7030,0,0.0,6890,7160,1399-9-19
223,افق,فروشگاههاي زنجيره اي افق كوروش,2261,1022584,83880830690,82840,82000,82830,-10,-0.01,82150,-690,-0.83,81110,83230,1399-9-19
224,وملي,گروه‌ صنعتي‌ ملي‌ (هلدينگ‌,2258,1068808,391974645920,349280,366740,366740,17460,5.0,366740,17460,5.0,366740,366740,1399-9-19
225,حپارسا,توسعه حمل و نقل ريلي پارسيان,2239,4977076,169211365067,35489,33960,34640,-849,-2.39,33998,-1491,-4.2,33715,35478,1399-9-19
226,غمارگ,مارگارين‌,2229,4937754,192837931050,37890,38250,39780,1890,4.99,39050,1160,3.06,37100,39780,1399-9-19
227,آريان,سرمايه گذاري پارس آريان,2192,18054750,278043201675,15817,15500,15700,-117,-0.74,15400,-417,-2.64,15343,15912,1399-9-19
228,كطبس,ذغال‌سنگ‌ نگين‌ ط‌بس‌,2187,2663036,186970811470,69930,70000,70300,370,0.53,70210,280,0.4,67500,73400,1399-9-19
229,سكرد,سيمان كردستان,2180,9736599,95066231590,9500,9500,9970,470,4.95,9760,260,2.74,9500,9970,1399-9-19
230,وسين,بيمه سينا,2132,11754183,306690421071,25071,25822,26324,1253,5.0,26092,1021,4.07,24700,26324,1399-9-19
231,ختراكح,ح . ريخته‌گري‌ تراكتورسازي‌,2106,6437794,89815893660,15010,14010,13510,-1500,-9.99,13950,-1060,-7.06,13510,14990,1399-9-19
232,سنير,سيمان‌ سفيد ني‌ريز,2092,1072194,90371181420,88090,84030,83710,-4380,-4.97,84290,-3800,-4.31,83690,89900,1399-9-19
233,توريل,توکاريل,2088,7749591,180539082297,22301,22800,23416,1115,5.0,23297,996,4.47,22500,23416,1399-9-19
234,زاگرس,پتروشيمي زاگرس,2060,1056835,196151381435,190180,185000,185501,-4679,-2.46,185603,-4577,-2.41,180800,191980,1399-9-19
235,سمگا,گروه سرمايه گذاري ميراث فرهنگي,2017,12516404,355478390004,27049,28401,28401,1352,5.0,28401,1352,5.0,28401,28401,1399-9-19
236,چفيبر,فيبر ايران‌,1978,19125528,154908848820,7800,8190,8190,390,5.0,8100,300,3.85,7880,8190,1399-9-19
237,وگردش,بانك گردشگري,1971,13058004,277551956456,21613,21899,21750,137,0.63,21255,-358,-1.66,20965,22261,1399-9-19
238,انرژي3,سايراشخاص بورس انرژي,1955,633003,234874253880,354420,370000,372140,17720,5.0,371050,16630,4.69,366600,372140,1399-9-19
239,زگلدشت,كشت و دام گلدشت نمونه اصفهان,1954,2516606,129154078247,48996,51439,51445,2449,5.0,51321,2325,4.75,49040,51445,1399-9-19
240,وآرين,شركت توسعه اقتصادي آرين,1951,15522178,87917775359,5799,5770,5730,-69,-1.19,5664,-135,-2.33,5626,5850,1399-9-19
241,وپسا,س. پتروشيمي ساختمان  خليج فارس,1949,25558451,100778894021,3904,3860,4010,106,2.72,3943,39,1.0,3844,4020,1399-9-19
242,وثنو,سرمايه گذاري ساختماني نوين,1927,9387449,177669894127,18052,18954,18954,902,5.0,18926,874,4.84,18656,18954,1399-9-19
243,غويتا,ويتانا,1922,4845615,232764546767,45797,47500,48086,2289,5.0,48036,2239,4.89,47300,48086,1399-9-19
244,شاوان,پالايش نفت لاوان,1912,1716032,200039975511,121634,117000,117000,-4634,-3.81,116571,-5063,-4.16,115553,123990,1399-9-19
245,مارون,پتروشيمي مارون,1910,950957,147965630272,162910,161600,154820,-8090,-4.97,155597,-7313,-4.49,154765,161600,1399-9-19
246,بساما,بيمه سامان,1909,5146445,180149686196,33557,33980,35234,1677,5.0,35005,1448,4.32,33820,35234,1399-9-19
247,بهپاك,صنعتي بهپاك,1909,3155030,141315500512,46190,44000,45840,-350,-0.76,44791,-1399,-3.03,43881,47000,1399-9-19
248,وسپه,سرمايه‌گذاري‌ سپه‌,1908,6748124,98839674030,14910,14510,14780,-130,-0.87,14650,-260,-1.74,14420,15050,1399-9-19
249,غشهد,شهد ايران ‌,1907,9783197,74163789360,7620,7920,7500,-120,-1.57,7580,-40,-0.52,7310,7920,1399-9-19
250,سپح,ح . پرداخت الكترونيك سامان كيش,1902,3028267,57733368690,17890,18390,19150,1260,7.04,19060,1170,6.54,18390,19500,1399-9-19
251,سرچشمه,سرمايه گذاري مس سرچشمه,1893,7637095,69352025939,9220,9220,9111,-109,-1.18,9081,-139,-1.51,9000,9220,1399-9-19
252,وبهمن,سرمايه‌گذاري‌بهمن‌,1880,12405957,264160676050,20300,20890,21310,1010,4.98,21290,990,4.88,20700,21310,1399-9-19
253,وكادو,تكادو,1859,7344794,164747034984,21932,22550,22589,657,3.0,22430,498,2.27,21900,22589,1399-9-19
254,امين يكم,صندوق درآمد ثابت امين يكم فردا,1855,61740593,630983943983,10207,10210,10215,8,0.08,10220,13,0.13,10210,10226,1399-9-19
255,وآذر,سرمايه‌گذاري‌توسعه‌آذربايجان‌,1854,1607993,203361817930,127880,131900,127300,-580,-0.45,126470,-1410,-1.1,123210,131900,1399-9-19
256,فجر,فولاد اميركبيركاشان,1853,2848258,185843190310,63390,63710,65850,2460,3.88,65250,1860,2.93,63220,66500,1399-9-19
257,وليز,ليزينگ‌ايران‌,1852,7940349,81195354230,10150,10480,10360,210,2.07,10230,80,0.79,9710,10480,1399-9-19
258,ميدكو,هلدينگ صنايع  معدني خاورميانه,1851,3830615,102184164633,26569,26750,26720,151,0.57,26660,91,0.34,26200,26798,1399-9-19
259,سخوز,سيمان خوزستان,1839,3149371,84376443380,26880,27750,27410,530,1.97,26790,-90,-0.33,25900,27750,1399-9-19
260,وتوسم,سرمايه‌گذاري‌توسعه‌ملي‌,1826,8501554,120933263320,14610,14890,14370,-240,-1.64,14220,-390,-2.67,14100,14890,1399-9-19
261,فلوله,لوله‌وماشين‌سازي‌ايران‌,1825,3454246,86037002530,25010,25000,25170,160,0.64,24910,-100,-0.4,24130,25520,1399-9-19
262,آپ,آسان پرداخت پرشين,1803,4553269,86884028850,18850,18610,19390,540,2.86,19080,230,1.22,18610,19470,1399-9-19
263,بخاور,بيمه زندگي خاورميانه,1800,13136135,125901828247,9181,9517,9640,459,5.0,9584,403,4.39,9300,9640,1399-9-19
264,زنگان,صنعت روي زنگان,1797,1129822,121998595321,104755,102660,109992,5237,5.0,107980,3225,3.08,102660,109992,1399-9-19
265,سپ,پرداخت الكترونيك سامان كيش,1790,4638953,92414411520,19010,19500,19960,950,5.0,19920,910,4.79,19030,19960,1399-9-19
266,غبهار,كشت وصنعت بهاران گلبهار خراسان,1788,5207158,238960639897,43733,45919,45919,2186,5.0,45891,2158,4.93,45000,45919,1399-9-19
267,سمايه,بانك سرمايه,1785,12415789,102699711160,8038,8135,8279,241,3.0,8272,234,2.91,8135,8279,1399-9-19
268,دسبحان,سبحان دارو,1773,2966501,77818060790,26220,27530,25940,-280,-1.07,26230,10,0.04,24920,27530,1399-9-19
269,سدور,سيمان‌ دورود,1772,13908851,140642895160,9730,9790,10210,480,4.93,10110,380,3.91,9730,10210,1399-9-19
270,لسرما,سرما آفرين‌,1751,5212025,177960379470,32600,34210,34230,1630,5.0,34140,1540,4.72,33400,34230,1399-9-19
271,ثپرديس,سرمايه گذاري مسكن پرديس,1744,11777877,141467066331,11490,12000,12064,574,5.0,12011,521,4.53,11600,12064,1399-9-19
272,تكشا,گسترش‌صنايع‌وخدمات‌كشاورزي‌,1742,1999134,119816072640,57600,59000,60480,2880,5.0,59930,2330,4.05,58000,60480,1399-9-19
273,چدن,توليدي چدن سازان,1737,12105243,471029564390,37210,38500,39070,1860,5.0,38910,1700,4.57,37200,39070,1399-9-19
274,بالاس,مهندسي ساختمان تاسيسات راه آهن,1735,2804226,173668630677,59015,61960,61965,2950,5.0,61931,2916,4.94,60000,61965,1399-9-19
275,شفارا,پتروشيمي فارابي,1725,14792278,72721175739,5032,4930,4882,-150,-2.98,4916,-116,-2.31,4882,5140,1399-9-19
276,دفارا,داروسازي‌ فارابي‌,1725,1348118,91371901680,69940,68000,68200,-1740,-2.49,67780,-2160,-3.09,66460,69700,1399-9-19
277,ما,بيمه  ما,1721,27258954,265049703420,9280,9670,9740,460,4.96,9720,440,4.74,9300,9740,1399-9-19
278,ومعلم,بيمه معلم,1688,8556789,72768375179,8160,8500,8568,408,5.0,8504,344,4.22,8215,8568,1399-9-19
279,وخاور,بانك خاورميانه,1670,12256153,135637932690,10750,10790,11200,450,4.19,11070,320,2.98,10510,11200,1399-9-19
280,شاراك,پتروشيمي شازند,1668,7406679,184927704830,25560,24890,24900,-660,-2.58,24970,-590,-2.31,24420,26090,1399-9-19
281,وبيمه,سرمايه‌ گذاري‌ صنعت‌ بيمه‌,1660,29462612,113867263130,3700,3800,3880,180,4.86,3860,160,4.32,3780,3880,1399-9-19
282,فلامي,لاميران‌,1651,1941294,78405767980,39540,39000,41510,1970,4.98,40390,850,2.15,37900,41510,1399-9-19
283,شبهرن,نفت‌ بهران‌,1648,1905635,120410845360,64020,64050,64000,-20,-0.03,63190,-830,-1.3,62320,64990,1399-9-19
284,كهمداح,ح . شيشه‌ همدان‌,1642,6707571,80344165240,12110,12250,11960,-150,-1.24,11980,-130,-1.07,11500,12600,1399-9-19
285,شدوص,دوده‌ صنعتي‌ پارس‌,1640,4761974,116564448900,25520,25820,24250,-1270,-4.98,24480,-1040,-4.08,24250,25820,1399-9-19
286,شفن,پتروشيمي فناوران,1632,388372,132184039350,334170,337950,339970,5800,1.74,340350,6180,1.85,334000,349800,1399-9-19
287,فخاس,فولاد خراسان,1624,1958915,71087418340,36490,38310,36350,-140,-0.38,36360,-130,-0.36,34870,38310,1399-9-19
288,پكوير,كوير تاير,1622,3161301,60328489400,18830,18850,19250,420,2.23,19080,250,1.33,17900,19400,1399-9-19
289,فن آوا,گروه فن آوا,1618,10745589,150248100340,13779,13460,14192,413,3.0,13982,203,1.47,13370,14192,1399-9-19
290,دانا,بيمه دانا,1617,24635112,218756499820,8460,8880,8880,420,4.96,8880,420,4.96,8800,8880,1399-9-19
291,رتاپح,ح.تجارت الكترونيك پارسيان,1611,8260318,45010602640,5490,5490,5470,-20,-0.36,5450,-40,-0.73,5370,5630,1399-9-19
292,ثعمرا,عمران و توسعه شاهد,1602,5195118,91045195869,16795,17620,17634,839,5.0,17525,730,4.35,17209,17634,1399-9-19
293,ثامان,سامان‌ گستراصفهان‌,1601,4822469,119463617440,23800,23980,24990,1190,5.0,24770,970,4.08,23980,24990,1399-9-19
294,وسبحان,سرمايه گذاري سبحان,1569,6971082,63213246122,9049,9198,9120,71,0.78,9068,19,0.21,8936,9198,1399-9-19
295,پارند,صندوق س. پارند پايدار سپهر,1566,954292592,10735801109735,11251,11252,11259,8,0.07,11250,-1,-0.01,11248,11261,1399-9-19
296,شتوكا,توكا رنگ فولاد سپاهان,1560,1962798,84602216881,42899,43936,43760,861,2.01,43103,204,0.48,41610,43936,1399-9-19
297,قشكر,شكرشاهرود,1543,1800419,83907180530,45010,45800,47260,2250,5.0,46600,1590,3.53,43210,47260,1399-9-19
298,كمرجان,بازرگاني و توليدي مرجان كار,1542,1804846,137682593176,72817,76457,76457,3640,5.0,76285,3468,4.76,74500,76457,1399-9-19
299,زنجان,صنايع كشاورزي وكود زنجان,1541,17470365,184583877801,10263,10570,10570,307,2.99,10566,303,2.95,10290,10570,1399-9-19
300,دسبحا,گروه دارويي سبحان,1534,3361290,81849067420,23840,25030,25000,1160,4.87,24350,510,2.14,23000,25030,1399-9-19
301,حريل,ريل پردازسير,1530,19983418,87275926948,4168,4360,4376,208,4.99,4367,199,4.77,4289,4376,1399-9-19
302,تسه9908,امتياز تسهيلات مسكن آبان99,1522,46909,28283017009,603304,600290,605000,1696,0.28,602934,-370,-0.06,595000,630000,1399-9-19
303,غالبر,لبنيات‌ كالبر,1520,8793887,112149881450,12340,12500,12950,610,4.94,12750,410,3.32,11930,12950,1399-9-19
304,دشيمي,شيمي‌ داروئي‌ داروپخش‌,1510,1282013,75666476080,57900,57990,59900,2000,3.45,59020,1120,1.93,56310,60680,1399-9-19
305,اعتماد,صندوق س.اعتماد آفرين پارسيان-د,1495,34571960,1166208307360,33715,33740,33730,15,0.04,33733,18,0.05,33730,33740,1399-9-19
306,غشاذر,پگاه‌آذربايجان‌غربي‌,1494,2641754,57456892600,21270,22200,21840,570,2.68,21750,480,2.26,21200,22200,1399-9-19
307,ثاباد,توريستي ورفاهي آبادگران ايران,1491,3286335,115250633370,33400,35070,35070,1670,5.0,35070,1670,5.0,35000,35070,1399-9-19
308,دلقما,دارويي‌ لقمان‌,1488,2311075,74500190530,31580,31200,33020,1440,4.56,32240,660,2.09,31200,33020,1399-9-19
309,سفاسي,شركت فارسيت اهواز,1482,9074860,132712985990,14382,14112,14813,431,3.0,14624,242,1.68,14112,14813,1399-9-19
310,شكربن,كربن‌ ايران‌,1479,1406485,134399633030,99470,99000,94500,-4970,-5.0,95560,-3910,-3.93,94500,101710,1399-9-19
311,فاما,صنعتي‌ آما,1449,2957146,89465869250,31020,31950,29700,-1320,-4.26,30250,-770,-2.48,29510,31950,1399-9-19
312,جم,پتروشيمي جم,1447,3491397,172640473610,50250,50000,50500,250,0.5,49450,-800,-1.59,48900,51000,1399-9-19
313,وهنر,گروه توسعه هنر ايران,1444,18188154,96217329748,5152,5306,5306,154,2.99,5290,138,2.68,5090,5306,1399-9-19
314,كپرور,فرآوري زغال سنگ پروده طبس,1440,3273455,149793415676,43667,45000,45850,2183,5.0,45760,2093,4.79,44113,45850,1399-9-19
315,وملت,سرمايه گذاري ملت,1433,10213800,42893650404,4132,4100,4214,82,1.98,4200,68,1.65,4090,4214,1399-9-19
316,كمينا,شيشه سازي مينا,1428,3390909,135825070703,38478,39239,40401,1923,5.0,40056,1578,4.1,38000,40401,1399-9-19
317,فباهنر,مس‌ شهيدباهنر,1428,1235867,65599677760,54050,51930,52990,-1060,-1.96,53080,-970,-1.79,51520,55460,1399-9-19
318,تكنو,تكنوتار,1424,5133288,75403911250,14090,14790,14790,700,4.97,14690,600,4.26,14260,14790,1399-9-19
319,قزوين,كارخانجات‌ قند قزوين‌,1418,1621061,69162833200,44290,44500,42450,-1840,-4.15,42670,-1620,-3.66,42080,44500,1399-9-19
320,سيدكو,سرمايه گذاري توسعه صنايع سيمان,1407,9270460,84409975260,8970,9120,9150,180,2.01,9110,140,1.56,8900,9390,1399-9-19
321,تايرا,تراكتورسازي‌ايران‌,1402,3476965,101857440570,28910,28900,29490,580,2.01,29290,380,1.31,28850,29770,1399-9-19
322,غپينو,پارس‌ مينو,1398,13291524,129991104720,9320,9780,9780,460,4.94,9780,460,4.94,9780,9780,1399-9-19
323,شبصير,توليدات پتروشيمي قائد بصير,1386,1446751,179832370603,123483,126400,125720,2237,1.81,124301,818,0.66,121500,126449,1399-9-19
324,وصندوق,سرمايه‌گذاري‌صندوق‌بازنشستگي‌,1385,6201707,105872201930,17300,17120,16860,-440,-2.54,17110,-190,-1.1,16740,17340,1399-9-19
325,وگستر,گسترش سرمايه گذاري ايرانيان,1380,2471420,63017540189,25613,24700,25180,-433,-1.69,25499,-114,-0.45,24700,26000,1399-9-19
326,تماوند,تامين سرمايه دماوند,1366,9112867,137656321603,14523,14250,15110,587,4.04,15106,583,4.01,14250,15249,1399-9-19
327,دابور,داروسازي‌ ابوريحان‌,1342,1085659,55117972970,50430,50000,50880,450,0.89,50770,340,0.67,49440,51600,1399-9-19
328,شراز,پالايش نفت شيراز,1329,2732818,349951037695,122101,128100,128206,6105,5.0,128055,5954,4.88,126000,128206,1399-9-19
329,شپديس,پتروشيمي پرديس,1309,1899168,208547919120,112090,111500,111400,-690,-0.62,109810,-2280,-2.03,107200,112000,1399-9-19
330,دسانكو,داروسازي سبحان انكولوژي,1305,3069461,58596846246,19240,19211,19410,170,0.88,19090,-150,-0.78,18663,19666,1399-9-19
331,پخش,پخش البرز,1301,1858877,86072080892,46727,48970,45580,-1147,-2.45,46303,-424,-0.91,44934,48970,1399-9-19
332,پلاست,كارخانجات توليدي پلاستيران,1300,2262518,94111530589,40662,40000,41881,1219,3.0,41596,934,2.3,40000,41881,1399-9-19
333,دعبيد,لابراتوارداروسازي‌  دكترعبيدي‌,1294,2434923,81208205830,33510,34850,34200,690,2.06,33350,-160,-0.48,32500,34850,1399-9-19
334,بفجر,فجر انرژي خليج فارس,1285,2322834,70371742390,29720,29200,30440,720,2.42,30230,510,1.72,29200,30630,1399-9-19
335,رتاپ,تجارت الكترونيك  پارسيان,1279,4315518,32522069950,7400,7600,7480,80,1.08,7480,80,1.08,7410,7650,1399-9-19
336,فنوال,نورد آلومينيوم‌,1264,4510607,134921977250,28600,28200,30030,1430,5.0,29910,1310,4.58,28200,30030,1399-9-19
337,كفپارس,فرآورده‌هاي‌ نسوز پارس‌,1254,6954366,64536516480,8840,9280,9280,440,4.98,9280,440,4.98,9280,9280,1399-9-19
338,گوهران,سرمايه گذاري توسعه گوهران اميد,1253,4644869,45530724604,9744,10210,9751,7,0.07,9791,47,0.48,9503,10210,1399-9-19
339,شپاكسا,پاكسان‌,1249,4067276,132657793950,32300,31200,32860,560,1.73,32620,320,0.99,31200,32960,1399-9-19
340,كلوند,كاشي‌ الوند,1247,3110498,90443684370,27720,29080,29100,1380,4.98,29080,1360,4.91,28190,29100,1399-9-19
341,آوا,صندوق س.سهام آواي معيار-س,1226,6254817,60544985241,9602,9600,9725,123,1.28,9680,78,0.81,9515,9799,1399-9-19
342,كرماشا,صنايع پتروشيمي كرمانشاه,1216,1969641,85349962020,42700,43640,44000,1300,3.04,43330,630,1.48,42500,44200,1399-9-19
343,وصنا,گروه‌صنايع‌بهشهرايران‌,1206,5095157,67296252500,13070,13300,13320,250,1.91,13210,140,1.07,12750,13440,1399-9-19
344,دامين,داروسازي‌ امين‌,1200,3443481,55115862370,15950,16650,15980,30,0.19,16000,50,0.31,15600,16650,1399-9-19
345,ساروم,سيمان‌اروميه‌,1199,1932274,53953900510,27390,27370,28110,720,2.63,27920,530,1.94,26710,28490,1399-9-19
346,غبشهر,صنعتي‌ بهشهر,1189,2109089,59644866510,28370,28370,27940,-430,-1.52,28280,-90,-0.32,27700,29190,1399-9-19
347,كساپا,سايپاشيشه‌,1175,3556666,98235272460,26430,25910,27750,1320,4.99,27620,1190,4.5,25810,27750,1399-9-19
348,بنيرو,نيروترانس‌,1147,1567289,88991094380,55250,57870,58000,2750,4.98,56780,1530,2.77,54580,58010,1399-9-19
349,مبين,مبين انرژي خليج فارس,1145,3586228,83830043830,23100,23670,23610,510,2.21,23340,240,1.04,23000,23670,1399-9-19
350,زكشت,كشاورزي مكانيزه اصفهان كشت,1141,1963580,63051106794,31052,30050,32604,1552,5.0,32110,1058,3.41,30050,32604,1399-9-19
351,كاردان,صندوق س تجارت شاخصي كاردان,1137,669906,128484025610,192020,190300,192700,680,0.35,191790,-230,-0.12,189840,194290,1399-9-19
352,فولاژ,فولاد آلياژي ايران,1134,1989256,53895009820,27670,26810,27110,-560,-2.02,27190,-480,-1.73,26360,28200,1399-9-19
353,فافزا,فولاد افزا سپاهان,1110,1963169,86795567826,42933,44220,44220,1287,3.0,44212,1279,2.98,43500,44220,1399-9-19
354,بميلا,توسعه بازرگاني آهن وفولادميلاد,1106,2990480,65575081404,22586,22000,21910,-676,-2.99,21928,-658,-2.91,21610,22870,1399-9-19
355,پارس,پتروشيمي پارس,1105,789788,125197188020,161060,158930,159890,-1170,-0.73,158520,-2540,-1.58,156950,162780,1399-9-19
356,وبشهر,توسعه‌ صنايع‌ بهشهر(هلدينگ,1067,3461942,62290807160,17920,18000,18100,180,1.0,17990,70,0.39,17410,18320,1399-9-19
357,پلوله,گازلوله‌,1053,4500544,81348649496,18105,17743,18465,360,1.99,18075,-30,-0.17,17743,18467,1399-9-19
358,پارسيان,بيمه پارسيان,1046,7452253,116228421150,14880,14710,15620,740,4.97,15600,720,4.84,14710,15620,1399-9-19
359,ركيش,كارت اعتباري ايران كيش,1045,3080300,52531806020,16790,16820,16990,200,1.19,17050,260,1.55,16820,17200,1399-9-19
360,غدشت,دشت‌ مرغاب‌,1042,305198,80634423900,269940,260000,264000,-5940,-2.2,264200,-5740,-2.13,256450,278000,1399-9-19
361,كاذرح,ح . فرآورده‌هاي‌نسوزآذر,1038,2460946,48108747160,18980,19330,19830,850,4.48,19550,570,3.0,19080,20000,1399-9-19
362,وثوق,سرمايه گذاري وثوق امين,1035,2306036,28704507002,12382,12753,12450,68,0.55,12448,66,0.53,12011,12753,1399-9-19
363,وآتوس,س.آرين توسكا قيمت اسمي 350ريال,1030,2082526,66155815325,33065,31412,31999,-1066,-3.22,31767,-1298,-3.93,31412,34715,1399-9-19
364,كنور,توسعه معدني و صنعتي صبانور,1028,1158008,54758797500,47110,47490,47150,40,0.08,47280,170,0.36,46020,48110,1399-9-19
365,شرانل,نفت ايرانول,1017,1257511,46889368664,38176,36500,37830,-346,-0.91,37391,-785,-2.06,36500,38500,1399-9-19
366,ثفارس,عمران‌وتوسعه‌فارس‌,1012,6991638,65721397200,8960,9400,9400,440,4.91,9400,440,4.91,9400,9400,1399-9-19
367,وتعاون,بيمه  تعاون,1011,14077691,107250632530,7412,7500,7634,222,3.0,7618,206,2.78,7389,7634,1399-9-19
368,ددام,داروسازي زاگرس فارمد پارس,1011,3397111,59328570520,16760,17100,17590,830,4.95,17460,700,4.18,16790,17590,1399-9-19
369,شخارك,پتروشيمي‌ خارك‌,1010,2005449,90999768700,46360,45610,45100,-1260,-2.72,45450,-910,-1.96,44100,47170,1399-9-19
370,سخزر,سيمان‌ خزر,1008,1674933,49028383910,30050,29000,29150,-900,-3.0,29340,-710,-2.36,28550,30200,1399-9-19
371,غسالم,سالمين‌,1003,13689932,82550289960,5750,6030,6030,280,4.87,6030,280,4.87,6030,6030,1399-9-19
372,كوير,توليدي فولاد سپيد فراب كوير,1002,3847811,85767707190,21230,22290,22290,1060,4.99,22170,940,4.43,22290,22290,1399-9-19
373,سفانو,سيمان فارس نو,997,2437231,86648693780,34450,33050,36170,1720,4.99,35550,1100,3.19,33050,36170,1399-9-19
374,لوتوس,تامين سرمايه لوتوس پارسيان,993,4146921,63115618080,15000,15450,15470,470,3.13,15220,220,1.47,14960,15500,1399-9-19
375,شوينده,مديريت صنعت شوينده ت.ص.بهشهر,992,1580771,65051313520,41110,41110,40850,-260,-0.63,41150,40,0.1,40250,42470,1399-9-19
376,سمازن,سيمان‌مازندران‌,977,5456098,63852264980,11170,11000,11720,550,4.92,11700,530,4.74,10840,11720,1399-9-19
377,جم پيلن,پلي پروپيلن جم - جم پيلن,974,1490660,127327519910,87320,85600,85270,-2050,-2.35,85420,-1900,-2.18,84900,88300,1399-9-19
378,پسهند,صنايع‌ لاستيكي‌  سهند,958,1365664,58504044840,44210,43500,42850,-1360,-3.08,42840,-1370,-3.1,42000,44100,1399-9-19
379,تيپيكو,سرمايه گذاري دارويي تامين,956,745959,44237717560,59820,59000,59910,90,0.15,59600,-220,-0.37,58500,60000,1399-9-19
380,خپويش,سازه‌ پويش‌,947,1218810,47285462520,39210,38000,38210,-1000,-2.55,38840,-370,-0.94,38000,39900,1399-9-19
381,افرا,افرانت,946,1279224,58653141767,48137,46520,45731,-2406,-5.0,45851,-2286,-4.75,45731,48000,1399-9-19
382,دارو,كارخانجات‌داروپخش‌,944,464397,27405852600,57680,59000,59540,1860,3.22,58370,690,1.2,56460,59750,1399-9-19
383,تاپكيش,تجارت الكترونيك پارسيان كيش,943,2572569,64697537781,23952,25149,25149,1197,5.0,25149,1197,5.0,25149,25149,1399-9-19
384,شگل,گلتاش‌,941,2277743,66773344480,28960,29880,29310,350,1.21,29320,360,1.24,28510,29880,1399-9-19
385,وسديد,گروه ‌صنعتي‌سديد,939,5458188,126318844884,22469,23143,23143,674,3.0,23143,674,3.0,23143,23143,1399-9-19
386,غشصفا,شيرپاستوريزه‌پگاه‌اصفهان‌,937,3761702,115026659530,29130,30520,30580,1450,4.98,30580,1450,4.98,30510,30580,1399-9-19
387,ثاصفا,شركت‌ ساختمان‌ اصفهان‌,932,3735863,131730810118,36321,35232,35232,-1089,-3.0,35261,-1060,-2.92,35232,36310,1399-9-19
388,اتكاي,بيمه اتكايي ايرانيان,921,2452570,37091725942,15047,15047,15270,223,1.48,15104,57,0.38,14595,15439,1399-9-19
389,فاسمين,كالسيمين‌,900,10864185,222281225100,19490,20460,20460,970,4.98,20460,970,4.98,20460,20460,1399-9-19
390,طلا,صندوق س.پشتوانه طلاي لوتوس,897,511747,47281103676,89732,91880,92600,2868,3.2,92392,2660,2.96,91800,92939,1399-9-19
391,خديزل,بهمن  ديزل,897,18148822,962047858239,50527,49000,53053,2526,5.0,53009,2482,4.91,49000,53053,1399-9-19
392,پاسا,ايران‌ياساتايرورابر,873,2336238,65963887220,29430,28100,27960,-1470,-4.99,28240,-1190,-4.04,27960,29000,1399-9-19
393,كشرق,صنعتي و معدني شمال شرق شاهرود,872,916701,74953365668,79917,81912,83000,3083,3.86,81764,1847,2.31,78000,83800,1399-9-19
394,ساراب,سيمان‌ داراب‌,866,3060502,43759885910,14070,14750,14460,390,2.77,14240,170,1.21,13950,14750,1399-9-19
395,گكيش,توريستي ورفاهي آبادگران كيش,864,940344,62917186624,67607,69635,65579,-2028,-3.0,66909,-698,-1.03,65579,69635,1399-9-19
396,خكاوه,سايپا ديزل,837,12900344,70577782024,5312,5471,5471,159,2.99,5471,159,2.99,5471,5471,1399-9-19
397,دالبر,البرزدارو,816,1181326,29754817550,24690,25840,25080,390,1.58,24960,270,1.09,24710,25840,1399-9-19
398,خفناور,مهندسي صنعتي روان فن آور,815,2628468,76172301597,28143,28987,28987,844,3.0,28980,837,2.97,28650,28987,1399-9-19
399,درازك,دارويي‌ رازك‌,810,1239910,56156169750,44950,43300,44500,-450,-1.0,45290,340,0.76,43300,47170,1399-9-19
400,غصينو,صنعتي مينو,808,6499789,523174516399,76659,80491,80491,3832,5.0,80491,3832,5.0,80491,80491,1399-9-19
401,خمحور,توليدمحورخودرو,805,676510,44263055040,68110,65520,64710,-3400,-4.99,65720,-2390,-3.51,64710,69650,1399-9-19
402,اوان,مبين وان كيش,795,1353821,85735036090,64405,65041,63500,-905,-1.41,63328,-1077,-1.67,61300,65041,1399-9-19
403,دسينا,داروسازي‌ سينا,792,1270852,42461763630,31840,32980,33430,1590,4.99,32960,1120,3.52,32600,33430,1399-9-19
404,كيان,صندوق س. با درآمد ثابت كيان,790,19869744,521414297679,26226,26248,26245,19,0.07,26242,16,0.06,26240,26249,1399-9-19
405,اطلس,صندوق س.توسعه اندوخته آينده-س,779,113843,24345805298,213091,215010,214980,1889,0.89,213854,763,0.36,213000,215990,1399-9-19
406,وحكمت,بيمه حكمت صبا,772,5076723,31348764525,5881,6175,6175,294,5.0,6175,294,5.0,6175,6175,1399-9-19
407,دتماد,توليدمواداوليه‌داروپخش‌,768,574075,31821167640,56100,56100,55660,-440,-0.78,55690,-410,-0.73,54140,57000,1399-9-19
408,خودكفا,اقتصادي و خودكفايي آزادگان,762,4799058,173183606046,35036,36087,36087,1051,3.0,36087,1051,3.0,36087,36087,1399-9-19
409,دكوثر,داروسازي‌ كوثر,762,1792186,48713225300,26020,27300,27320,1300,5.0,26950,930,3.57,26130,27320,1399-9-19
410,غپاك,لبنيات‌ پاك‌,761,4157711,63057737100,14540,14090,15260,720,4.95,15170,630,4.33,14090,15260,1399-9-19
411,لخزر,پارس‌ خزر,742,512757,100611487250,188430,190000,197850,9420,5.0,196220,7790,4.13,185000,197850,1399-9-19
412,وتوشه,سرمايه‌ گذاري‌ پارس‌ توشه‌,737,2708177,67316765610,24200,24000,25410,1210,5.0,24860,660,2.73,23710,25410,1399-9-19
413,قمرو,قند مرودشت‌,730,743936,21616524020,28890,29700,29350,460,1.59,28960,70,0.24,28000,29700,1399-9-19
414,شيراز,پتروشيمي‌شيراز,730,1453017,87060678220,60090,60950,59450,-640,-1.07,59940,-150,-0.25,58300,61000,1399-9-19
415,كمنگنز,معادن‌منگنزايران‌,712,537766,55166834280,103430,103500,100500,-2930,-2.83,102590,-840,-0.81,100500,105990,1399-9-19
416,فرآور,فرآوري‌موادمعدني‌ايران‌,706,4422203,118913038670,25610,26890,26890,1280,5.0,26890,1280,5.0,26890,26890,1399-9-19
417,ثقزوي,شركت عمران و سازندگي قزوين,699,1428118,39214692162,26660,27459,27459,799,3.0,27459,799,3.0,27459,27459,1399-9-19
418,عيار,صندوق س. پشتوانه طلاي مفيد,696,1016722,32122574854,30925,31400,31698,773,2.5,31594,669,2.16,31380,31750,1399-9-19
419,قلرست,قند لرستان‌,694,981612,26267929530,26480,27300,27000,520,1.96,26630,150,0.57,25690,27700,1399-9-19
420,حتايد,تايدواترخاورميانه,686,3627136,78214282200,20620,20510,21650,1030,5.0,21560,940,4.56,20510,21650,1399-9-19
421,فيروزه,صندوق شاخص30 شركت فيروزه- سهام,678,192229,36032912970,186900,188110,188330,1430,0.77,187450,550,0.29,185510,189600,1399-9-19
422,آ س پ,آ.س.پ,668,2806024,34376600024,11668,12251,12251,583,5.0,12041,373,3.2,12251,12251,1399-9-19
423,واعتبار,سرمايه گذاري اعتبار ايران,666,6116127,38607070030,5840,6330,6380,540,9.25,6190,350,5.99,6080,6640,1399-9-19
424,پارتا,مجتمع‌صنعتي‌آرتاويل‌تاير,655,757139,41516113257,56361,55100,54821,-1540,-2.73,54833,-1528,-2.71,54671,56313,1399-9-19
425,خاور,ايران خودرو ديزل,653,7659450,52697016000,6680,6880,6880,200,2.99,6880,200,2.99,6880,6880,1399-9-19
426,سكرما,سيمان‌ كرمان‌,652,3151605,53325156600,16120,16920,16920,800,4.96,16880,760,4.71,16920,16920,1399-9-19
427,شفا,سرمايه گذاري شفادارو,651,535070,33202251880,63150,64500,61530,-1620,-2.57,62470,-680,-1.08,60200,64500,1399-9-19
428,واميد,گروه مديريت سرمايه گذاري اميد,649,1122833,43799179200,39160,39200,39320,160,0.41,39110,-50,-0.13,38150,39700,1399-9-19
429,سبهان,سيمان‌ بهبهان‌,648,711345,45810856200,62280,63990,65390,3110,4.99,64000,1720,2.76,63000,65390,1399-9-19
430,سشمال,سيمان‌ شمال‌,625,2359447,22360877190,9250,9060,9520,270,2.92,9340,90,0.97,9060,9650,1399-9-19
431,فسازان,غلتك سازان سپاهان,622,4545221,163264338320,34210,35920,35920,1710,5.0,35920,1710,5.0,35920,35920,1399-9-19
432,حخزر,كشتيراني درياي خزر,614,1383118,34282386960,25209,25479,25002,-207,-0.82,24893,-316,-1.25,24000,25479,1399-9-19
433,لپيام,گسترش صنايع پيام,588,999598,31417197212,30733,31654,31654,921,3.0,31430,697,2.27,29812,31654,1399-9-19
434,سدبير,س. تدبيرگران فارس وخوزستان,588,1509686,70051568417,44207,46417,46417,2210,5.0,46401,2194,4.96,44901,46417,1399-9-19
435,ولملت,واسپاري ملت,587,2333634,26913694290,11300,11820,11550,250,2.21,11420,120,1.06,11300,11820,1399-9-19
436,كي بي سي,شركت كي بي سي,586,798966,25935795892,33451,32280,33219,-232,-0.69,32958,-493,-1.47,31790,33219,1399-9-19
437,غمهراح,ح . توليدي‌مهرام‌,584,780266,44070252270,51640,51830,56800,5160,9.99,56480,4840,9.37,51830,56800,1399-9-19
438,خشرق,الكتريك‌ خودرو شرق‌,584,2157795,52650198000,23240,24400,24400,1160,4.99,24230,990,4.26,24400,24400,1399-9-19
439,كاريس,صندوق س.سپهر كاريزما-س,571,665178,144062305972,214236,216998,217500,3264,1.52,216577,2341,1.09,212555,218790,1399-9-19
440,زر,صندوق س.پشتوانه سكه طلاي زر,568,923569,49116657449,52474,53101,53100,626,1.19,53181,707,1.35,52961,53450,1399-9-19
441,لابسا,آبسال‌,567,1166094,50794498820,41490,43560,43560,2070,4.99,43280,1790,4.31,43000,43560,1399-9-19
442,دپارس,پارس‌ دارو,565,208551,21844151540,104560,107200,103990,-570,-0.55,104640,80,0.08,100900,107700,1399-9-19
443,كپشير,پشم‌شيشه‌ايران‌,564,1476497,29791982530,19220,20180,20180,960,4.99,19760,540,2.81,19700,20180,1399-9-19
444,آساس,صندوق س.آسمان آرماني سهام-س,562,373750,66358480274,175575,178979,177499,1924,1.1,177548,1973,1.12,176010,179450,1399-9-19
445,سغرب,سيمان‌غرب‌,552,1743993,37251473920,20360,21370,21370,1010,4.96,21030,670,3.29,21100,21370,1399-9-19
446,دجابر,داروسازي‌ جابرابن‌حيان‌,551,1087247,53633862480,46990,49330,49330,2340,4.98,49060,2070,4.41,49320,49330,1399-9-19
447,خموتور,موتورسازان‌تراكتورسازي‌ايران‌,550,4987796,63095619400,12050,12650,12650,600,4.98,12650,600,4.98,12650,12650,1399-9-19
448,ثزاگرس,سرمايه گذاري توسعه عمران زاگرس,549,1030359,42554852983,40011,39100,42011,2000,5.0,41301,1290,3.22,38011,42011,1399-9-19
449,ثعتما,س. ساختماني اعتماد گستر,541,890963,38197576224,41780,41031,43033,1253,3.0,42872,1092,2.61,41031,43033,1399-9-19
450,غگلپا,شير پاستوريزه پگاه گلپايگان,534,800455,60660810648,72176,75784,75784,3608,5.0,75783,3607,5.0,75220,75784,1399-9-19
451,ثاژن,سخت آژند,528,2356595,19198796405,8097,8410,8180,83,1.03,8147,50,0.62,8000,8410,1399-9-19
452,خزر,فنرسازي‌زر,527,2067338,57616710060,26550,27870,27870,1320,4.97,27860,1310,4.93,27870,27870,1399-9-19
453,وشمال,س. چشم انداز توسعه شمال,524,366639,36999008046,97975,100914,100914,2939,3.0,100914,2939,3.0,100914,100914,1399-9-19
454,نمرينو,ايران‌ مرينوس‌,523,1016850,58191991240,55140,52500,57890,2750,4.99,57230,2090,3.79,52400,57890,1399-9-19
455,افق ملت,صندوق س در سهام افق ملت,519,152035,22388193530,147760,145550,148060,300,0.2,147260,-500,-0.34,145100,149700,1399-9-19
456,زشريف,كشت وصنعت شريف آباد,504,1268807,34288448424,25748,27035,27035,1287,5.0,26533,785,3.05,26500,27035,1399-9-19
457,دروز,داروسازي‌ روزدارو,501,1277293,22149978640,17850,17990,17480,-370,-2.07,17620,-230,-1.29,16990,18000,1399-9-19
458,شنفت,نفت‌ پارس‌,500,469487,28550906110,61710,60530,60430,-1280,-2.07,61290,-420,-0.68,59600,63860,1399-9-19
459,قاسم,قاسم ايران,499,4319690,67106384150,14796,15535,15535,739,4.99,15535,739,4.99,15535,15535,1399-9-19
460,بنو,بيمه تجارت نو,499,3372525,106406536275,30049,31551,31551,1502,5.0,31551,1502,5.0,31551,31551,1399-9-19
461,مفاخر,توسعه فناوري اطلاعات خوارزمي,497,1912831,90317166816,45196,46995,47455,2259,5.0,47216,2020,4.47,45196,47455,1399-9-19
462,غمينو,شركت صنايع غذايي مينو شرق,495,2497009,38885921157,14832,15573,15573,741,5.0,15299,467,3.15,15573,15573,1399-9-19
463,دكيمي,كيميدارو,493,1156162,33276531450,28700,29500,29290,590,2.06,28750,50,0.17,27710,29500,1399-9-19
464,كاسپين,داروسازي كاسپين تامين,492,818249,25182292403,30483,31000,31141,658,2.16,30614,131,0.43,30360,31990,1399-9-19
465,داسوه,داروسازي‌ اسوه‌,491,629185,19022703420,30290,29330,30500,210,0.69,30270,-20,-0.07,29330,31200,1399-9-19
466,تملتح,ح . تامين سرمايه بانك ملت,490,23414846,187318768000,8000,8000,8000,0,0.0,8000,0,0.0,8000,8000,1399-9-19
467,سجام,مجتمع سيمان غرب آسيا,489,4159601,62002124203,15106,15450,14654,-452,-2.99,14906,-200,-1.32,14653,15484,1399-9-19
468,حپترو,حمل و نقل پتروشيمي( سهامي عام,482,1816238,54590418610,28630,30060,30060,1430,4.99,29990,1360,4.75,29680,30060,1399-9-19
469,غشان,شيرپاستوريزه‌پگاه‌خراسان‌,481,2437168,22421945600,8770,9200,9200,430,4.9,8950,180,2.05,9200,9200,1399-9-19
470,ساينا,صنايع بهداشتي ساينا,479,207754,42972758989,199386,207000,209355,9969,5.0,205218,5832,2.92,198000,209355,1399-9-19
471,وحافظ,بيمه حافظ,478,1020654,71148769686,66390,69709,69709,3319,5.0,69709,3319,5.0,69709,69709,1399-9-19
472,قهكمت,قندهكمتان‌,475,455147,23652127570,52750,51420,52200,-550,-1.04,52380,-370,-0.7,50400,53500,1399-9-19
473,زدشت,كشت و صنعت دشت خرم دره,474,732404,45066592033,58728,61700,62350,3622,6.17,60782,2054,3.5,60000,62433,1399-9-19
474,بشهاب,لامپ‌  پارس‌ شهاب‌,473,537328,39752398040,70570,72500,74090,3520,4.99,72950,2380,3.37,71420,74090,1399-9-19
475,سفار,سيمان‌فارس‌,469,434639,43467554200,95260,100020,100020,4760,5.0,98700,3440,3.61,96700,100020,1399-9-19
476,فمراد,آلومراد,467,370583,48576019640,124840,131080,131080,6240,5.0,130990,6150,4.93,131080,131080,1399-9-19
477,بايكا,كارخانجات كابلسازي ‌ايران‌,460,531548,32639704940,59617,61405,61405,1788,3.0,61405,1788,3.0,61405,61405,1399-9-19
478,سيستم,همكاران سيستم,458,1062540,33658942090,32760,32000,32030,-730,-2.23,31980,-780,-2.38,31130,32760,1399-9-19
479,دلر,داروسازي‌ اكسير,455,154245,17942095020,118820,113470,116050,-2770,-2.33,117960,-860,-0.72,113470,118800,1399-9-19
480,خراسان,پتروشيمي خراسان,454,238939,17844365420,73880,74000,74890,1010,1.37,74150,270,0.37,74000,77550,1399-9-19
481,ديران,ايران‌دارو,451,1844272,56582264960,29220,30680,30680,1460,5.0,30610,1390,4.76,30680,30680,1399-9-19
482,كوثر,بيمه كوثر,441,3178993,67512274341,20226,21237,21237,1011,5.0,21237,1011,5.0,21237,21237,1399-9-19
483,وسنا,سرمايه گذاري نيروگاهي ايران,435,1949844,35371405164,17282,18146,18146,864,5.0,18141,859,4.97,17650,18146,1399-9-19
484,ضملت1128,اختيارخ وبملت-6000-1399/11/28,425,12888,8772326000,719,743,719,0,0.0,681,-38,-5.29,651,743,1399-9-19
485,سپاس,صندوق س. پاداش سهامداري توسعه1,423,14995349,150056104063,10006,10018,10008,2,0.02,10007,1,0.01,9999,10019,1399-9-19
486,خفنر,فنرسازي‌خاور,423,1244808,28020628080,21440,22510,22510,1070,4.99,21970,530,2.47,22510,22510,1399-9-19
487,بسويچ,پارس‌سويچ‌,417,716998,33595449490,44630,46860,46860,2230,5.0,46030,1400,3.14,46500,46860,1399-9-19
488,سصوفي,سيمان‌ صوفيان‌,416,2162931,37115895960,16350,17160,17160,810,4.95,16890,540,3.3,17160,17160,1399-9-19
489,دشيري,شيرين دارو,414,159785,25808901631,158908,158908,162198,3290,2.07,161523,2615,1.65,155000,163675,1399-9-19
490,حبندر,دريايي و کشتيراني خط دريابندر,413,715891,23498475485,31929,32885,32886,957,3.0,32824,895,2.8,32300,32886,1399-9-19
491,غپآذر,شير پگاه آذربايجان شرقي,411,763951,44477555306,56281,54600,59095,2814,5.0,58031,1750,3.11,54600,59095,1399-9-19
492,سباقر,سيمان باقران,411,1092284,16994659670,15126,15579,15579,453,2.99,15470,344,2.27,15300,15579,1399-9-19
493,ولتجار,واسپاري تجارت وسرمايه ايرانيان,409,2792273,20413116160,7099,7311,7311,212,2.99,7288,189,2.66,7208,7311,1399-9-19
494,كيسون,شركت كيسون,404,3882835,63899815595,15978,16457,16457,479,3.0,16457,479,3.0,16457,16457,1399-9-19
495,آتيمس,صندوق س.آرمان آتيه درخشان مس-س,401,80190,18387729625,227336,224555,229552,2216,0.97,229302,1966,0.86,224555,230990,1399-9-19
496,تابا,تابان نيرو سپاهان,398,896387,27578242442,29870,30766,30766,896,3.0,30766,896,3.0,30766,30766,1399-9-19
497,دارا,صندوق س. دارا الگوريتم-د,391,13268904,133346459801,10055,10058,10053,-2,-0.02,10050,-5,-0.05,10040,10058,1399-9-19
498,سخواف,سيمان مجد خواف,386,1167688,16662907760,13855,14270,14270,415,3.0,14244,389,2.81,14270,14270,1399-9-19
499,دفرا,فرآورده‌هاي‌ تزريقي‌ ايران‌,381,565892,15280248540,26790,27790,27980,1190,4.44,26850,60,0.22,26000,28000,1399-9-19
500,سهرمز,سيمان‌هرمزگان‌,378,1722769,37021383820,20480,21500,21500,1020,4.98,21140,660,3.22,20870,21500,1399-9-19
501,كاذر,فرآورده‌هاي‌نسوزآذر,368,1637885,37786006950,21980,23070,23070,1090,4.96,22660,680,3.09,23070,23070,1399-9-19
502,وساغربي,شركت س استان آذربايجان غربي,363,13324505,11015742710,860,830,830,-30,-3.49,850,-10,-1.16,820,850,1399-9-19
503,حتوكا,حمل‌ونقل‌توكا,363,1579308,35660774640,21510,22580,22580,1070,4.97,22140,630,2.93,22580,22580,1399-9-19
504,وسكرد,شركت س استان كردستان,348,13381934,10992761930,850,830,820,-30,-3.53,840,-10,-1.18,810,830,1399-9-19
505,ثنور,سرمايه گذاري كوه نور,348,3328373,25884756821,7407,7777,7777,370,5.0,7777,370,5.0,7777,7777,1399-9-19
506,اتكام,شركت بيمه اتكايي امين,347,3688322,29178315342,7535,7911,7911,376,4.99,7726,191,2.53,7911,7911,1399-9-19
507,واحصا,احياء صنايع خراسان,347,2283876,65127185931,27957,28795,28795,838,3.0,28516,559,2.0,27119,28795,1399-9-19
508,دمعيار,صندوق س. توازن معيار-د,340,20224811,204123742806,10089,10095,10090,1,0.01,10093,4,0.04,10036,10100,1399-9-19
509,قجام,فرآوردههاي غذايي وقندتربت‌جام‌,338,1856473,22830904954,11940,12298,12298,358,3.0,12298,358,3.0,12298,12298,1399-9-19
510,زعف0008پ10,زعفران0008نگين طلاي سرخ(پ),331,154661,19531993699,126345,125000,125900,-445,-0.35,126289,-56,-0.04,125000,126991,1399-9-19
511,ضخود1044,اختيارخ خودرو-4000-1399/10/07,331,10862,4865206000,461,480,453,-8,-1.74,448,-13,-2.82,420,483,1399-9-19
512,ثشرق,سرمايه گذاري مسكن شمال شرق,326,4413770,28557091900,6170,6470,6470,300,4.86,6310,140,2.27,6470,6470,1399-9-19
513,شجم,صنايع پتروشيمي تخت جمشيد,326,13057527,133983284547,9773,10261,10261,488,4.99,10261,488,4.99,10261,10261,1399-9-19
514,خلنت,لنت‌ ترمزايران‌,325,110304,9070889480,81850,80510,82800,950,1.16,81920,70,0.09,80510,84040,1399-9-19
515,سيمرغ,سيمرغ,324,685398,13365261000,18580,19500,19500,920,4.95,18800,220,1.18,19500,19500,1399-9-19
516,ثنظام,س. ساختماني نظام مهندسي ايران,322,545095,24711881825,44015,45335,45335,1320,3.0,45335,1320,3.0,45335,45335,1399-9-19
517,وسكرمان,س.سهام عدالت استان كرمان,320,5744293,6087976430,1020,1070,1060,40,3.92,1020,0,0.0,1040,1070,1399-9-19
518,خنصير,مهندسي‌نصيرماشين‌,320,1729023,91811121300,50580,53100,53100,2520,4.98,53100,2520,4.98,53100,53100,1399-9-19
519,دتوزيع,توزيع دارو پخش,319,1626475,46240684250,27077,28430,28430,1353,5.0,28269,1192,4.4,28430,28430,1399-9-19
520,شساخت,مهندسي و ساختمان صنايع نفت,316,1146975,52567011225,44497,45831,45831,1334,3.0,45831,1334,3.0,45831,45831,1399-9-19
521,گشان,توسعه بين المللي پديده شانديز,315,94183,6712799142,72728,71274,71274,-1454,-2.0,72498,-230,-0.32,71274,71274,1399-9-19
522,ثجوان,تامين مسكن جوانان,307,2622621,23673864770,8616,9046,9046,430,4.99,9027,411,4.77,8800,9046,1399-9-19
523,مداران,داده‌پردازي‌ايران‌,301,1008659,27889421350,26340,27650,27650,1310,4.97,26960,620,2.35,27650,27650,1399-9-19
524,قشهد,شهد,299,395804,11673715050,30490,30000,29800,-690,-2.26,30250,-240,-0.79,28970,30830,1399-9-19
525,بمپنا,توليد برق عسلويه  مپنا,299,111201,11344554655,100096,100100,100600,504,0.5,100504,408,0.41,96760,104900,1399-9-19
526,فروس,فروسيليس‌ ايران‌,295,3106653,16962325380,5200,5460,5460,260,5.0,5280,80,1.54,5460,5460,1399-9-19
527,كفرآور,فرآورده هاي سيمان شرق,294,966318,18439482083,18542,19097,19098,556,3.0,19027,485,2.62,18601,19098,1399-9-19
528,ضصاد1103,اختيارخ وبصادر-4000-1399/11/12,294,11860,5486191000,483,470,450,-33,-6.83,463,-20,-4.14,440,478,1399-9-19
529,وسگيلا,شركت س استان گيلان,285,7974414,6767522410,880,850,860,-20,-2.27,880,0,0.0,840,870,1399-9-19
530,غدام,خوراك‌  دام‌ پارس‌,282,180267,60400261020,319110,335060,335060,15950,5.0,335060,15950,5.0,335060,335060,1399-9-19
531,كفرا,فراورده‌ هاي‌ نسوزايران‌,281,1577690,95686898500,57770,60650,60650,2880,4.99,60650,2880,4.99,60650,60650,1399-9-19
532,ثشرقح,ح. سرمايه گذاري مسكن شمال شرق,278,1807491,10844946000,5450,6000,6000,550,10.09,6000,550,10.09,6000,6000,1399-9-19
533,زپارس,ملي كشت و صنعت و دامپروري پارس,268,636824,55527308470,83060,87210,87210,4150,5.0,87050,3990,4.8,86000,87210,1399-9-19
534,ياقوت,صندوق س ياقوت آگاه-ثابت,268,7201545,83241270631,11551,11554,11560,9,0.08,11559,8,0.07,11536,11560,1399-9-19
535,سخاش,سيمان‌خاش‌,266,155347,15638782490,95880,100670,100670,4790,5.0,97210,1330,1.39,100670,100670,1399-9-19
536,سرود,سيمان‌شاهرود,266,1006037,17404440100,16480,17300,17300,820,4.98,16720,240,1.46,17300,17300,1399-9-19
537,الماس,صندوق س.امين تدبيرگران فردا-س,266,74507,10225534683,132463,133905,139990,7527,5.68,137243,4780,3.61,133905,139990,1399-9-19
538,نطرين,عطرين نخ قم,260,1287325,16992690000,11280,13200,13200,1920,17.02,11838,558,4.95,13200,13200,1399-9-19
539,شلعاب,لعابيران‌,258,1428952,13460727840,8980,9420,9420,440,4.9,9080,100,1.11,9420,9420,1399-9-19
540,آرمان,بيمه آرمان,254,5753822,65656862842,11079,11411,11411,332,3.0,11411,332,3.0,11411,11411,1399-9-19
541,ورازي,بيمه رازي,252,2518328,34423025432,13019,13669,13669,650,4.99,13669,650,4.99,13669,13669,1399-9-19
542,تشتاد,صنايع توليدي اشتاد ايران‌,250,636140,10174274048,16330,16493,16200,-130,-0.8,16162,-168,-1.03,15841,16500,1399-9-19
543,شاملا,معدني‌ املاح‌  ايران‌,247,518988,36006990800,66080,69380,69380,3300,4.99,68260,2180,3.3,69000,69380,1399-9-19
544,گوهر,صندوق سكه طلاي كيان,246,200365,12406707274,61011,62400,61901,890,1.46,61921,910,1.49,61220,62400,1399-9-19
545,وپخش,داروپخش‌ (هلدينگ‌,246,59823,8566930050,145470,143500,143060,-2410,-1.66,145100,-370,-0.25,142000,146300,1399-9-19
546,غپونه,نوش پونه مشهد,246,1321912,26156588219,19211,19787,19787,576,3.0,19787,576,3.0,19780,19787,1399-9-19
547,فنفت,صنايع تجهيزات نفت,244,1755278,26469799236,14653,14320,15092,439,3.0,15080,427,2.91,14320,15092,1399-9-19
548,شپترو,پتروشيمي آبادان,243,2650939,13877665665,5083,5235,5235,152,2.99,5178,95,1.87,5235,5235,1399-9-19
549,تسه9907,امتياز تسهيلات مسكن مهر99,243,2881,1729762983,602464,600000,591112,-11352,-1.88,600404,-2060,-0.34,591112,618000,1399-9-19
550,ولراز,ليزينگ رازي,242,282565,11621898450,39933,41130,41130,1197,3.0,40531,598,1.5,41130,41130,1399-9-19
551,زماهان,مجتمع توليد گوشت مرغ ماهان,241,231469,6763061242,27827,29218,29218,1391,5.0,27992,165,0.59,29218,29218,1399-9-19
552,وسيستا,شركت س استان سيستان وبلوچستان,235,8224442,6836355960,870,830,840,-30,-3.45,860,-10,-1.15,830,850,1399-9-19
553,ضملت1129,اختيارخ وبملت-7000-1399/11/28,234,11064,3390628000,237,333,320,83,35.02,306,69,29.11,281,348,1399-9-19
554,ثاختح,ح . بين‌المللي‌توسعه‌ساختمان,230,4828744,15540267280,3210,3300,3200,-10,-0.31,3220,10,0.31,3200,3300,1399-9-19
555,غفارس,شير پاستوريزه پگاه فارس,229,819116,8400853696,9768,10256,10256,488,5.0,9843,75,0.77,10256,10256,1399-9-19
556,غمهرا,توليدي‌مهرام‌,228,294666,18425464980,59560,62530,62530,2970,4.99,60540,980,1.65,62530,62530,1399-9-19
557,سكه0012پ01,سكه تمام بهارتحويلي 1روزه رفاه,227,55900,70122156900,1232050,1250001,1264001,31951,2.59,1254421,22371,1.82,1249000,1265000,1399-9-19
558,دقاضي,داروسازي شهيد قاضي,222,109290,10260035787,94112,96160,94720,608,0.65,94000,-112,-0.12,91320,96160,1399-9-19
559,آكورد,صندوق س. آرمان آتي كوثر-د,216,4737316,140475469803,29630,29649,29654,24,0.08,29653,23,0.08,29648,29670,1399-9-19
560,وايرا,سرمايه گذاري صنايع ايران,215,2283594,21020482770,8937,9205,9205,268,3.0,9180,243,2.72,9205,9205,1399-9-19
561,دبالك,مواد اوليه دارويي البرز بالك,211,594726,12479730384,19985,20984,20984,999,5.0,20197,212,1.06,20984,20984,1399-9-19
562,ضخود1048,اختيارخ خودرو-7000-1399/10/07,209,11016,55752000,8,5,7,-1,-12.5,5,-3,-37.5,4,9,1399-9-19
563,پست0008پ04,پسته فندقي32-30سبزدانه0008(پ),206,7005,13146945809,1855508,1926135,1889999,34491,1.86,1876794,21286,1.15,1750000,1926135,1399-9-19
564,رتكو,كنترل‌خوردگي‌تكين‌كو,205,1055626,21355313980,19270,20230,20230,960,4.98,19630,360,1.87,20230,20230,1399-9-19
565,كقزوي,شيشه‌ قزوين‌,205,1356897,12030248802,8608,8866,8866,258,3.0,8748,140,1.63,8866,8866,1399-9-19
566,دكپسول,توليد ژلاتين كپسول ايران,202,1786986,78169915584,41661,43744,43744,2083,5.0,43744,2083,5.0,43744,43744,1399-9-19
567,شپارس,بين‌ المللي‌ محصولات‌  پارس‌,199,749647,12556587250,15960,16750,16750,790,4.95,16130,170,1.07,16750,16750,1399-9-19
568,سقاين,سيمان‌ قائن‌,195,309678,15607771200,48000,50400,50400,2400,5.0,48650,650,1.35,50400,50400,1399-9-19
569,وزمين,بانك ايران زمين,195,4620242,60326499794,12801,13057,13057,256,2.0,13057,256,2.0,13057,13057,1399-9-19
570,آبين,كشت و صنعت آبشيرين,192,1071022,4951334706,4403,4623,4623,220,5.0,4450,47,1.07,4623,4623,1399-9-19
571,فپنتا,سپنتا,190,46803,17242693230,350870,368410,368410,17540,5.0,356200,5330,1.52,368410,368410,1399-9-19
572,حاريا,كشتيراني آريا,189,735946,21332130756,28142,28986,28986,844,3.0,28986,844,3.0,28986,28986,1399-9-19
573,وتوكا,سرمايه‌گذاري‌توكافولاد(هلدينگ,187,1904414,23424292200,11720,12300,12300,580,4.95,11960,240,2.05,12300,12300,1399-9-19
574,وكار,بانك‌ كارآفرين‌,186,4505656,22933789040,4850,5090,5090,240,4.95,4940,90,1.86,5090,5090,1399-9-19
575,درهآور,دارويي ره آورد تامين,185,270612,11764586088,41404,43474,43474,2070,5.0,41845,441,1.07,43474,43474,1399-9-19
576,داوه,داروسازي آوه سينا,183,572670,10243920960,17037,17888,17888,851,5.0,17198,161,0.95,17888,17888,1399-9-19
577,سصفها,سيمان‌اصفهان‌,180,338079,85858542840,241870,253960,253960,12090,5.0,253960,12090,5.0,253960,253960,1399-9-19
578,تسه9710,امتياز تسهيلات مسكن دي 97,180,3052,1754987601,582022,561000,586490,4468,0.77,575029,-6993,-1.2,555001,588000,1399-9-19
579,وسهمدا,شركت س استان همدان,179,3026046,2616047290,900,870,880,-20,-2.22,900,0,0.0,860,880,1399-9-19
580,تسه9711,امتياز تسهيلات مسكن بهمن 97,178,2309,1369477368,594294,580000,600000,5706,0.96,593104,-1190,-0.2,580000,609998,1399-9-19
581,ختراك,ريخته‌گري‌ تراكتورسازي‌ ايران‌,177,2651763,33040966980,11870,12460,12460,590,4.97,12220,350,2.95,12460,12460,1399-9-19
582,نتوس,پشم‌ بافي‌ توس,173,726731,8020203316,10715,11036,11036,321,3.0,10831,116,1.08,11036,11036,1399-9-19
583,بالبر,كابل‌ البرز,169,475144,12619824640,25300,26560,26560,1260,4.98,25580,280,1.11,26560,26560,1399-9-19
584,فوكا,فولاد كاويان,168,2423319,45686833107,19845,18853,18853,-992,-5.0,18853,-992,-5.0,18853,18853,1399-9-19
585,معيار,سرمايه گذاري معيار صنعت پارس,165,301279,8700033683,28311,28877,28877,566,2.0,28797,486,1.72,28877,28877,1399-9-19
586,شسينا,صنايع‌شيميايي‌سينا,165,240846,34578260220,136740,143570,143570,6830,4.99,141090,4350,3.18,143570,143570,1399-9-19
587,صايند,صندوق س. گنجينه آينده روشن-د,162,3513490,35096964050,9999,9972,9994,-5,-0.05,9989,-10,-0.1,9972,10000,1399-9-19
588,ولانا,شركت ليزينگ آريا دانا,161,1028355,20118737220,18995,19564,19564,569,3.0,19558,563,2.96,19564,19564,1399-9-19
589,تسه9902,امتياز تسهيلات مسكن ارديبهشت99,161,1942,1182459612,603995,634194,580005,-23990,-3.97,608888,4893,0.81,577506,634194,1399-9-19
590,تسه9906,امتياز تسهيلات مسكن شهريور99,158,1338,814481751,622555,592322,605000,-17555,-2.82,608731,-13824,-2.22,591755,639998,1399-9-19
591,شپاس,نفت پاسارگاد,158,723984,17120773632,22522,23648,23648,1126,5.0,22856,334,1.48,23648,23648,1399-9-19
592,وسرمد,بيمه  سرمد,155,4471148,33162504716,7201,7417,7417,216,3.0,7417,216,3.0,7417,7417,1399-9-19
593,سكه9912پ04,سكه تمام بهارتحويل1روزه صادرات,154,43500,54581557400,1231570,1248000,1262100,30530,2.48,1254748,23178,1.88,1246674,1267000,1399-9-19
594,زعف0008پ11,زعفران0008نگين سحرخيز(پ),154,49803,6278100761,125298,124000,127000,1702,1.36,126059,761,0.61,124000,128091,1399-9-19
595,فنورد,نوردوقطعات‌ فولادي‌,153,216705,40601848800,178440,187360,187360,8920,5.0,185180,6740,3.78,187360,187360,1399-9-19
596,وارس,سرمايه گذاري ارس صبا,152,207765,19151427729,89555,91250,92241,2686,3.0,92178,2623,2.93,91250,92241,1399-9-19
597,سفارود,كارخانه فارسيت درود,151,1052858,11233994860,10461,10670,10670,209,2.0,10670,209,2.0,10670,10670,1399-9-19
598,اعتلا,شركت سرمايه گذاري اعتلاء البرز,149,2943746,30370627482,9826,10317,10317,491,5.0,10089,263,2.68,10317,10317,1399-9-19
599,فاهواز,نورد و لوله اهواز,149,372246,7000458276,19189,18806,18806,-383,-2.0,19126,-63,-0.33,18806,18806,1399-9-19
600,نيرو,نيرو سرمايه,148,297402,14991715516,48946,50414,50414,1468,3.0,49944,998,2.04,49352,50414,1399-9-19
601,لبوتان,گروه‌صنعتي‌بوتان‌,147,836155,71382552350,81310,85370,85370,4060,4.99,85370,4060,4.99,85370,85370,1399-9-19
602,فالوم,آلومتك‌,147,470253,10828515831,22357,23027,23027,670,3.0,22729,372,1.66,23027,23027,1399-9-19
603,تسه9712,امتياز تسهيلات مسكن اسفند97,145,1413,852673196,603428,574000,620000,16572,2.75,603449,21,0.0,574000,620000,1399-9-19
604,تسه9810,امتياز تسهيلات مسكن دي98,139,2443,1462659402,595749,585432,605199,9450,1.59,598714,2965,0.5,585432,620000,1399-9-19
605,تسه9904,امتياز تسهيلات مسكن تير99,138,2376,1458531261,606353,593000,610000,3647,0.6,613860,7507,1.24,591355,636670,1399-9-19
606,سپر,صندوق س سپر سرمايه بيدار- ثابت,137,1370195,15001213625,11019,11025,10951,-68,-0.62,10948,-71,-0.64,10810,11050,1399-9-19
607,غشوكوح,ح . شوكو پارس,135,854372,24800628100,28921,30100,29000,79,0.27,29028,107,0.37,29000,30100,1399-9-19
608,آساميد,صندوق س.مشترك آسمان اميد -د,134,3702037,41351658902,11164,11167,11173,9,0.08,11170,6,0.05,11166,11174,1399-9-19
609,ساذريح,ح . آذريت‌,133,1271630,6551855655,5212,5173,5089,-123,-2.36,5152,-60,-1.15,5056,5300,1399-9-19
610,سبجنو,سيمان‌ بجنورد,130,308378,11801626060,36450,38270,38270,1820,4.99,36840,390,1.07,38270,38270,1399-9-19
611,فنرژي,گسترش صنايع انرژي آذرآب,128,851787,8835586551,10170,10373,10373,203,2.0,10346,176,1.73,10373,10373,1399-9-19
612,بذر,صندوق س بذر اميد آفرين-سهام,128,36945,4273181690,115400,115340,115310,-90,-0.08,115660,260,0.23,115000,116700,1399-9-19
613,كگهر,سنگ آهن گهرزمين,125,282797,13386761589,45083,47337,47337,2254,5.0,45310,227,0.5,47337,47337,1399-9-19
614,ضخود1042,اختيارخ خودرو-3000-1399/10/07,125,2954,3506632000,1160,1035,1190,30,2.59,1187,27,2.33,1035,1286,1399-9-19
615,وسفارس,شركت س استان فارس,124,4292509,4206658820,1030,980,980,-50,-4.85,1030,0,0.0,980,980,1399-9-19
616,زعف0008پ08,زعفران0008نگين روستا(پ),123,9013,1125015633,124506,122010,126000,1494,1.2,124821,315,0.25,122010,126000,1399-9-19
617,ضصاد1104,اختيارخ وبصادر-4500-1399/11/12,123,5169,1469293000,282,295,300,18,6.38,284,2,0.71,260,308,1399-9-19
618,قپيرا,فرآورده‌هاي‌غدايي‌وقندپيرانشهر,122,56685,4962500060,89330,88990,88800,-530,-0.59,89150,-180,-0.2,87000,90500,1399-9-19
619,گپارس,امور رفاهي كارگزاران پارس,122,52197,7218413891,134291,138319,138319,4028,3.0,135691,1400,1.04,138100,138319,1399-9-19
620,ضفلا1156,اختيارخ فولاد-16000-1399/11/28,120,2995,4599721000,1589,1500,1680,91,5.73,1536,-53,-3.34,1451,1697,1399-9-19
621,وثخوز,سرمايه گذاري و توسعه خوزستان,119,259809,12909389592,47322,49688,49688,2366,5.0,48554,1232,2.6,49688,49688,1399-9-19
622,تسه9801,امتياز تسهيلات مسكن فروردين98,115,1020,621113014,601814,605000,600001,-1813,-0.3,608934,7120,1.18,582100,631900,1399-9-19
623,زعف0008پ05,زعفران0008نگين زرين(پ),113,127772,16033791274,124840,125000,125450,610,0.49,125488,648,0.52,124500,126200,1399-9-19
624,اخزا810,اسنادخزانه-م10بودجه98-001006,112,9599,8070296393,838587,836800,840400,1813,0.22,840743,2156,0.26,836800,841126,1399-9-19
625,تسه9903,امتياز تسهيلات مسكن خرداد99,111,1135,692508114,605152,574896,600000,-5152,-0.85,610139,4987,0.82,574896,635000,1399-9-19
626,خفولا,خدمات فني فولاد يزد,111,325834,12132428990,36151,37235,37235,1084,3.0,36765,614,1.7,37235,37235,1399-9-19
627,بموتو,موتوژن‌,107,114724,5582469840,46350,48660,48660,2310,4.98,46590,240,0.52,48660,48660,1399-9-19
628,صنوين,صندوق سرمايه‌گذاري صنوين-مختلط,105,27886,2914638800,104080,105000,104830,750,0.72,104520,440,0.42,104000,105200,1399-9-19
629,فلات,گروه صنايع معادن فلات ايرانيان,104,588130,9733551500,16068,16550,16550,482,3.0,16290,222,1.38,16550,16550,1399-9-19
630,سلار,شركت سيمان لارستان,98,699914,27153163630,37666,38795,38795,1129,3.0,38795,1129,3.0,38795,38795,1399-9-19
631,وجامي,سرمايه گذاري جامي,97,246838,2554526462,10048,10349,10349,301,3.0,10083,35,0.35,10349,10349,1399-9-19
632,تسه9905,امتياز تسهيلات مسكن مرداد99,97,584,351851495,600492,600001,629000,28508,4.75,602485,1993,0.33,583988,629000,1399-9-19
633,تسه9901,امتياز تسهيلات مسكن فروردين99,96,759,457885216,610094,579590,601000,-9094,-1.49,603274,-6820,-1.12,579590,615000,1399-9-19
634,ضصاد1102,اختيارخ وبصادر-3500-1399/11/12,96,1979,1448654000,772,850,721,-51,-6.61,732,-40,-5.18,701,850,1399-9-19
635,جوين,كشت و صنعت جوين,87,375619,9289433489,23554,24731,24731,1177,5.0,24055,501,2.13,24731,24731,1399-9-19
636,فيروزا,صندوق بادرآمد ثابت فيروزه آسيا,86,365421,7865992050,21531,21610,21528,-3,-0.01,21526,-5,-0.02,21471,21619,1399-9-19
637,تسه9803,امتياز تسهيلات مسكن خرداد98,86,559,334720380,595158,600000,600000,4842,0.81,598784,3626,0.61,580000,605000,1399-9-19
638,شزنگ,تجهيزنيروي‌زنگان‌,86,120779,22343511105,179607,184995,184995,5388,3.0,184995,5388,3.0,184995,184995,1399-9-19
639,تسه9802,امتياز تسهيلات مسكن ارديبهشت98,83,489,300717909,601211,631271,630000,28789,4.79,614965,13754,2.29,584200,631271,1399-9-19
640,ضجار1016,اختيارخ وتجارت-4000-1399/10/21,82,2678,1185289000,467,441,443,-24,-5.14,443,-24,-5.14,430,474,1399-9-19
641,آينده,بازرگاني آينده سازان بهشت پارس,81,169201,3485540600,21684,20600,20600,-1084,-5.0,21481,-203,-0.94,20600,20600,1399-9-19
642,سنوين,سرمايه گذاري اقتصاد نوين,80,151064,1512503070,10095,9980,10000,-95,-0.94,10083,-12,-0.12,9894,10260,1399-9-19
643,ضخود1043,اختيارخ خودرو-3500-1399/10/07,78,1981,1543880000,789,890,800,11,1.39,779,-10,-1.27,720,890,1399-9-19
644,شكبير,پتروشيمي اميركبير,78,1432180,90028266980,59868,62861,62861,2993,5.0,62845,2977,4.97,62861,62861,1399-9-19
645,وگردشح,ح . بانك گردشگري,76,686392,12617249130,18000,18540,18250,250,1.39,18382,382,2.12,18250,18540,1399-9-19
646,تكنار,مجتمع معادن مس تكنار,75,111517,13305427821,115838,119313,119313,3475,3.0,117802,1964,1.7,119313,119313,1399-9-19
647,تسه9812,امتياز تسهيلات مسكن اسفند98,74,556,332946186,595549,590000,600000,4451,0.75,598824,3275,0.55,590000,610000,1399-9-19
648,كخاك,صنايع‌خاك‌چيني‌ايران‌,73,532463,29525073350,52810,55450,55450,2640,5.0,54090,1280,2.42,55450,55450,1399-9-19
649,كتوكا,توليدي و خدمات صنايع نسوز توكا,73,411163,9634782579,22318,23433,23433,1115,5.0,22519,201,0.9,23433,23433,1399-9-19
650,اخزا903,اسنادخزانه-م3بودجه99-011110,69,189540,127139704207,667339,664099,672312,4973,0.75,670780,3441,0.52,663011,672312,1399-9-19
651,شتولي,تولي‌پرس‌,68,471309,12675384246,26367,26894,26894,527,2.0,26894,527,2.0,26894,26894,1399-9-19
652,شكف,كف,68,56982,4004296086,68896,70273,70273,1377,2.0,69402,506,0.73,70273,70273,1399-9-19
653,ضمخا1024,اختيارخ اخابر-14000-1399/10/30,63,850,2492992000,3125,3200,3600,475,15.2,2933,-192,-6.14,2300,3600,1399-9-19
654,تسه9811,امتياز تسهيلات مسكن بهمن98,63,386,230287799,600396,587000,599900,-496,-0.08,596600,-3796,-0.63,580122,620000,1399-9-19
655,سكه0011پ02,سكه تمام بهارتحويلي 1روزه ملت,61,11700,14696601400,1228434,1249500,1267000,38566,3.14,1256120,27686,2.25,1249500,1267997,1399-9-19
656,ثروتم,صندوق س. ثروت آفرين پارسيان-س,61,33400,3280849540,98631,98010,98500,-131,-0.13,98229,-402,-0.41,97002,98510,1399-9-19
657,هترول911,اختيارف ت پترول-14730-99/11/15,58,406034,512008874,734,1261,1261,527,71.8,1261,527,71.8,1261,1261,1399-9-19
658,كيان2,صندوق س. با درآمد ثابت كيان,58,5800000,5800000,26226,1,1,-26225,-100.0,1,-26225,-100.0,1,1,1399-9-19
659,ضفلا1155,اختيارخ فولاد-14000-1399/11/28,58,1150,2876385000,2383,2600,2630,247,10.37,2501,118,4.95,2400,2640,1399-9-19
660,وسرضوي,س.سهام عدالت استان خراسان رضوي,55,1082504,1060853920,1030,980,980,-50,-4.85,1030,0,0.0,980,980,1399-9-19
661,ضخود1045,اختيارخ خودرو-4500-1399/10/07,55,1563,356597000,256,215,240,-16,-6.25,228,-28,-10.94,215,250,1399-9-19
662,سمتاز,سيمان ممتازان كرمان,54,68270,1637251140,23284,23982,23982,698,3.0,23334,50,0.21,23982,23982,1399-9-19
663,سايرا,ايرانيت‌,54,64126,2229040538,35043,34735,34343,-700,-2.0,34979,-64,-0.18,34343,35743,1399-9-19
664,ضملي1153,اختيارخ فملي-20280-1399/11/05,54,864,849413364,475,500,519,44,9.26,499,24,5.05,450,600,1399-9-19
665,تصميم,صندوق س با درآمد ثابت تصميم,53,298494,4520051986,15132,15140,15140,8,0.05,15143,11,0.07,15130,15150,1399-9-19
666,اخزا902,اسنادخزانه-م2بودجه99-011019,52,147877,99821622631,675213,670219,675111,-102,-0.02,675031,-182,-0.03,670219,677870,1399-9-19
667,ضجار1014,اختيارخ وتجارت-3000-1399/10/21,50,1528,1583217000,1103,1035,1030,-73,-6.62,1036,-67,-6.07,1020,1081,1399-9-19
668,اخزا815,اسنادخزانه-م15بودجه98-010406,50,45282,34331775916,758408,758450,758200,-208,-0.03,758177,-231,-0.03,757050,758450,1399-9-19
669,سخند,صندوق س.سپهرخبرگان نفت-د,49,636550,6365720000,10001,10001,10000,-1,-0.01,10000,-1,-0.01,9999,10023,1399-9-19
670,اخزا808,اسنادخزانه-م8بودجه98-000817,48,31230,26920275502,862833,859000,860111,-2722,-0.32,862000,-833,-0.1,859000,864990,1399-9-19
671,تسه9809,امتياز تسهيلات مسكن آذر98,47,363,217555052,594822,580388,600000,5178,0.87,599325,4503,0.76,580388,600000,1399-9-19
672,ضپاس1005,اختيارخ وپارس-4500-1399/10/30,47,1206,584071000,487,496,460,-27,-5.54,484,-3,-0.62,460,510,1399-9-19
673,پست0008پ08,پسته فندقي32-30مه ولات0008(پ),47,2669,4737893051,1810679,1810000,1782000,-28679,-1.58,1775157,-35522,-1.96,1753000,1810000,1399-9-19
674,ضملي1152,اختيارخ فملي-18252-1399/11/05,46,664,1196193508,955,1197,939,-16,-1.68,914,-41,-4.29,860,1198,1399-9-19
675,شصفها,پتروشيمي‌ اصفهان‌,46,16442,1743838520,103981,106060,106060,2079,2.0,104266,285,0.27,106060,106060,1399-9-19
676,ضشنا1036,اختيارخ شپنا-16000-1399/10/23,45,153,475981000,3622,3033,3319,-303,-8.37,3111,-511,-14.11,2809,3400,1399-9-19
677,آسام,صندوق س.آرمان سپهر آشنا-م,45,24910,2707016550,108780,106115,108003,-777,-0.71,108672,-108,-0.1,106115,110000,1399-9-19
678,افران,صندوق س افرا نماد پايدار-ثابت,43,525228,6438481898,12258,12258,12258,0,0.0,12258,0,0.0,12258,12262,1399-9-19
679,سكه0112پ03,سكه تمام بهارتحويلي1روزه سامان,43,10700,13376448000,1232512,1246660,1264000,31488,2.55,1250135,17623,1.43,1240000,1264000,1399-9-19
680,هصيكو402,اختيارف ت تاصيكو13500-00/02/20,42,407322,484305858,915,1189,1189,274,29.95,1189,274,29.95,1189,1189,1399-9-19
681,فسديد,لوله‌وتجهيزات‌ سديد - ورشكسته,42,55208,6133884840,110005,111105,111105,1100,1.0,111105,1100,1.0,111105,111105,1399-9-19
682,كابگن,توليدي و صنعتي آبگينه‌,42,329117,1636698841,4924,4973,4973,49,1.0,4940,16,0.32,4973,4973,1399-9-19
683,تسه9808,امتياز تسهيلات مسكن آبان98,42,281,170897541,595306,610000,610000,14694,2.47,608176,12870,2.16,565541,625000,1399-9-19
684,وسخراج,شركت س استان خراسان جنوبي,41,318349,674899880,2230,2120,2120,-110,-4.93,2230,0,0.0,2120,2120,1399-9-19
685,تسه9805,امتياز تسهيلات مسكن مرداد98,40,131,77604902,605894,575600,595000,-10894,-1.8,592404,-13490,-2.23,575600,595000,1399-9-19
686,گوهر2,صندوق سكه طلاي كيان,40,400000,400000,61011,1,1,-61010,-100.0,1,-61010,-100.0,1,1,1399-9-19
687,تسه9807,امتياز تسهيلات مسكن مهر98,40,183,108069508,592183,572422,600000,7817,1.32,590544,-1639,-0.28,572422,602640,1399-9-19
688,ضملت1127,اختيارخ وبملت-5000-1399/11/28,39,1208,1312224000,1316,1060,1350,34,2.58,1086,-230,-17.48,695,1350,1399-9-19
689,پدرخش,درخشان‌ تهران‌,39,5360,1070070400,210140,199640,199640,-10500,-5.0,209900,-240,-0.11,199640,199640,1399-9-19
690,اخزا809,اسنادخزانه-م9بودجه98-000923,39,34367,29165695746,846663,842500,849101,2438,0.29,848654,1991,0.24,842500,851000,1399-9-19
691,اخزا814,اسنادخزانه-م14بودجه98-010318,39,85886,66061978942,773117,766552,768001,-5116,-0.66,769182,-3935,-0.51,766251,770000,1399-9-19
692,داريك,صندوق س.اعتماد داريك-د,39,61556,635507897,10240,10300,10400,160,1.56,10324,84,0.82,10250,10500,1399-9-19
693,ضخود1046,اختيارخ خودرو-5000-1399/10/07,38,1149,151704000,140,140,125,-15,-10.71,132,-8,-5.71,120,166,1399-9-19
694,ضسپا1104,اختيارخ خساپا-3000-1399/11/26,36,877,643088000,707,653,740,33,4.67,733,26,3.68,653,750,1399-9-19
695,هفارس912,اختيارف ت فارس-14576-99/12/13,35,926465,926465,1,1,1,0,0.0,1,0,0.0,1,1,1399-9-19
696,اخزا818,اسنادخزانه-م18بودجه98-010614,34,88129,64555826927,732593,730000,732701,108,0.01,732515,-78,-0.01,730000,733000,1399-9-19
697,تسه9806,امتياز تسهيلات مسكن شهريور98,34,122,72408541,606725,587200,600000,-6725,-1.11,593513,-13212,-2.18,577001,605000,1399-9-19
698,پست0008پ02,پسته فندقي32-30طلاسبززرند0008,34,209,389444101,1839092,1861000,1865000,25908,1.41,1863369,24277,1.32,1770007,1870000,1399-9-19
699,ضصاد1106,اختيارخ وبصادر-6000-1399/11/12,33,1499,101970000,120,51,99,-21,-17.5,68,-52,-43.33,51,100,1399-9-19
700,ضشنا1035,اختيارخ شپنا-14000-1399/10/23,31,291,1309552000,5241,4998,4894,-347,-6.62,4500,-741,-14.14,4300,4999,1399-9-19
701,اخزا817,اسنادخزانه-م17بودجه98-010512,31,34359,25605296045,743797,744500,745225,1428,0.19,745228,1431,0.19,744500,749999,1399-9-19
702,وسخوز,شركت س استان خوزستان,30,544094,506007420,970,930,930,-40,-4.12,970,0,0.0,930,930,1399-9-19
703,وآفري,بيمه كارآفرين,30,671028,11401436748,16497,16991,16991,494,2.99,16759,262,1.59,16991,16991,1399-9-19
704,ضسپا1103,اختيارخ خساپا-2500-1399/11/26,30,1048,1010586000,1023,900,1020,-3,-0.29,964,-59,-5.77,900,1049,1399-9-19
705,غشوكو,شوكو پارس,29,51335,2150423150,43185,41890,41890,-1295,-3.0,43040,-145,-0.34,41890,41890,1399-9-19
706,ساروج,بين المللي ساروج بوشهر,28,416626,8747896122,19998,20997,20997,999,5.0,20381,383,1.92,20997,20997,1399-9-19
707,ضگل1144,اختيارخ كگل-20000-1399/11/21,28,621,1339310000,2550,2000,2300,-250,-9.8,2157,-393,-15.41,2000,2500,1399-9-19
708,ثروت,ص.خ.ثروت آفرين فيروزه 35%تاديه,28,38470,13464500000,350000,350000,350000,0,0.0,350000,0,0.0,350000,350000,1399-9-19
709,هبركت912,اختيارف ت بركت-22100-99/12/17,27,337961,337961,262,1,1,-261,-99.62,1,-261,-99.62,1,1,1399-9-19
710,ارمغان,ص سرمايه گذاري ارمغان ايرانيان,26,155524,1560043017,10028,10021,10025,-3,-0.03,10031,3,0.03,10021,10040,1399-9-19
711,ضفلا1157,اختيارخ فولاد-18000-1399/11/28,26,296,309143000,1098,1099,1080,-18,-1.64,1044,-54,-4.92,989,1100,1399-9-19
712,اخزا816,اسنادخزانه-م16بودجه98-010503,26,51326,38359663053,747395,747005,747400,5,0.0,747373,-22,0.0,747005,747500,1399-9-19
713,كصدف,كاشي صدف سرام استقلال آباده,25,142831,3137711408,21329,21968,21968,639,3.0,21422,93,0.44,21968,21968,1399-9-19
714,ضسپا1106,اختيارخ خساپا-4000-1399/11/26,25,1301,489362000,343,345,360,17,4.96,376,33,9.62,345,400,1399-9-19
715,اخزا904,اسنادخزانه-م4بودجه99-011215,25,76533,50259127871,655257,655500,657900,2643,0.4,656699,1442,0.22,655000,658000,1399-9-19
716,اخزا821,اسنادخزانه-م21بودجه98-020906,23,2671,1529709892,570532,568299,572500,1968,0.34,572711,2179,0.38,568299,574980,1399-9-19
717,وسقم,شركت س استان قم,23,163829,219530860,1410,1340,1340,-70,-4.96,1410,0,0.0,1340,1340,1399-9-19
718,وسيلام,شركت س استان ايلام,23,770939,909708020,1240,1180,1180,-60,-4.84,1240,0,0.0,1180,1180,1399-9-19
719,اخزا811,اسنادخزانه-م11بودجه98-001013,23,70815,59358430554,837552,826703,841980,4428,0.53,838218,666,0.08,826703,842000,1399-9-19
720,ضپاس1002,اختيارخ وپارس-3000-1399/10/30,21,536,775037000,1421,1500,1490,69,4.86,1446,25,1.76,1402,1500,1399-9-19
721,اخزا820,اسنادخزانه-م20بودجه98-020806,21,25922,15094336511,581006,582000,581101,95,0.02,582298,1292,0.22,581003,584440,1399-9-19
722,ضپاس1001,اختيارخ وپارس-2500-1399/10/30,20,220,391982000,1782,1500,1880,98,5.5,1782,0,0.0,1500,1880,1399-9-19
723,نگين,ص.س. زمين و ساختمان نگين شهرري,19,7541,369614400,48510,48500,49850,1340,2.76,49010,500,1.03,48500,49850,1399-9-19
724,زعف0008پ16,زعفران0008نگين بيرجند(پ),19,17918,2231605100,124405,124050,124500,95,0.08,124545,140,0.11,123500,125500,1399-9-19
725,اخزا704,اسنادخزانه-م4بودجه97-991022,19,66079,65309563956,987097,983012,990000,2903,0.29,988356,1259,0.13,983012,991000,1399-9-19
726,آكورد2,صندوق س. آرمان آتي كوثر-د,19,1900000,1900000,29630,1,1,-29629,-100.0,1,-29629,-100.0,1,1,1399-9-19
727,ضچاد1017,اختيارخ كچاد-20000-1399/10/02,19,126,241844000,1913,2000,1990,77,4.03,1919,6,0.31,1600,2100,1399-9-19
728,ضسپا1105,اختيارخ خساپا-3500-1399/11/26,18,1102,613202000,500,555,514,14,2.8,556,56,11.2,514,580,1399-9-19
729,شستا991,اجاره تامين اجتماعي-امين991226,16,440,441449240,1001324,1008000,1008000,6676,0.67,1003294,1970,0.2,1000000,1008000,1399-9-19
730,ضصاد1100,اختيارخ وبصادر-2500-1399/11/12,16,220,305370000,1468,1301,1496,28,1.91,1388,-80,-5.45,1300,1496,1399-9-19
731,اخزا806,اسنادخزانه-م6بودجه98-000519,16,16608,14839975811,896659,892750,895101,-1558,-0.17,893544,-3115,-0.35,892750,895101,1399-9-19
732,وسبوشهر,شركت س استان بوشهر,16,87167,104600400,1260,1200,1200,-60,-4.76,1260,0,0.0,1200,1200,1399-9-19
733,ضجار1015,اختيارخ وتجارت-3500-1399/10/21,16,293,216272000,754,731,740,-14,-1.86,738,-16,-2.12,718,750,1399-9-19
734,ضمخا1025,اختيارخ اخابر-16000-1399/10/30,16,110,244024000,1907,1700,2290,383,20.08,2218,311,16.31,1700,2300,1399-9-19
735,زعف0008پ18,زعفران0008نگين بهرامن(پ),16,48601,6320927925,10000,130000,130995,120995,1209.95,130058,120058,1200.58,126000,131729,1399-9-19
736,ضملي1151,اختيارخ فملي-16224-1399/11/05,15,246,1054138516,2384,2300,2248,-136,-5.7,2173,-211,-8.85,1304,2300,1399-9-19
737,لخانه,لوازم‌ خانگي‌ پارس‌,14,21487,1201316683,57638,55909,55909,-1729,-3.0,57530,-108,-0.19,55909,55909,1399-9-19
738,ضملي1148,اختيارخ فملي-10140-1399/11/05,14,32,348058000,6553,6000,6650,97,1.48,5516,-1037,-15.82,1010,6650,1399-9-19
739,حرهشا,رهشاد سپاهان (سهامي عام,14,3417,203226075,61314,59475,59475,-1839,-3.0,61295,-19,-0.03,59475,59475,1399-9-19
740,ضمخا7070,اختيارخ اخابر-20000-1400/07/28,13,55,256405000,4303,4689,4640,337,7.83,4662,359,8.34,4640,4689,1399-9-19
741,ضغدر1119,اختيارخ وغدير-10000-1399/11/26,13,98,444000000,4481,4500,4800,319,7.12,4531,50,1.12,4500,4800,1399-9-19
742,ضپنا1022,اختيارخ رمپنا-18806-1399/10/09,13,63,290826932,3288,3198,3060,-228,-6.93,3117,-171,-5.2,3000,3200,1399-9-19
743,ضفلا1154,اختيارخ فولاد-12000-1399/11/28,13,166,661738000,3676,3800,4300,624,16.97,3986,310,8.43,3601,4300,1399-9-19
744,ضخوز1014,اختيارخ فخوز-12191-1399/10/16,13,32,303272000,3187,9000,10000,6813,213.77,9477,6290,197.36,9000,10000,1399-9-19
745,اوصتا,صندوق انديشه ورزان صباتامين -د,12,7992,138176720,17280,17285,17285,5,0.03,17289,9,0.05,17285,17295,1399-9-19
746,ضخود1047,اختيارخ خودرو-6000-1399/10/07,12,595,12373000,30,30,19,-11,-36.67,21,-9,-30.0,19,30,1399-9-19
747,ضجار1017,اختيارخ وتجارت-4500-1399/10/21,12,892,219320000,267,242,238,-29,-10.86,246,-21,-7.87,235,260,1399-9-19
748,ضپيك1020,اختيارخ تاپيكو-14000-99/10/16,12,63,232741000,3446,3500,3860,414,12.01,3694,248,7.2,3500,3860,1399-9-19
749,سپرمي,پرميت‌,11,31736,269502112,8326,8492,8492,166,1.99,8335,9,0.11,8492,8492,1399-9-19
750,سرو2,صندوق س سروسودمند مدبران-سهام,11,1100000,1100000,73040,1,1,-73039,-100.0,1,-73039,-100.0,1,1,1399-9-19
751,ضترا1118,اختيارخ شتران-12000-1399/11/14,11,72,240740000,3382,3151,3500,118,3.49,3344,-38,-1.12,3150,3500,1399-9-19
752,ضملت1130,اختيارخ وبملت-8000-1399/11/28,11,616,123151000,150,200,200,50,33.33,200,50,33.33,151,200,1399-9-19
753,اخزا721,اسنادخزانه-م21بودجه97-000728,10,18320,15780693780,866175,866001,868999,2824,0.33,861392,-4783,-0.55,857554,869000,1399-9-19
754,كرونا2,تامين مالي جمعي صرفا اهداي سود,10,3099,30990000,10000,10000,10000,0,0.0,10000,0,0.0,10000,10000,1399-9-19
755,گنجين,صندوق س. گنجينه يكم آويد-د,10,209300,2464827300,11775,11790,11771,-4,-0.03,11777,2,0.02,11771,11790,1399-9-19
756,اخزا901,اسنادخزانه-م1بودجه99-010621,10,7404,5360709123,730226,725538,723551,-6675,-0.91,724029,-6197,-0.85,716776,732000,1399-9-19
757,عيار2,صندوق س. پشتوانه طلاي مفيد,10,100000,100000,30925,1,1,-30924,-100.0,1,-30924,-100.0,1,1,1399-9-19
758,وساربيل,شركت س استان اردبيل,10,121037,147665140,1280,1220,1220,-60,-4.69,1280,0,0.0,1220,1220,1399-9-19
759,تملي612,تسهيلات مسكن بانك ملي-اسفند96,10,86,75749918,838870,880813,880813,41943,5.0,880813,41943,5.0,880813,880813,1399-9-19
760,وسگلستا,شركت س استان گلستان,10,112468,132712240,1240,1180,1180,-60,-4.84,1240,0,0.0,1180,1180,1399-9-19
761,زعف0008پ15,زعفران0008پوشالمعمول طلاسرخ(پ),9,4481,408131374,95092,90500,90333,-4759,-5.0,91080,-4012,-4.22,90333,96999,1399-9-19
762,كشم0001پ01,كشمش سبز0001خليل آباد(پ),9,196,72437739,388528,370101,369102,-19426,-5.0,369580,-18948,-4.88,369102,380000,1399-9-19
763,زعف0008پ09,زعفران0008نگين نوين(پ),9,7501,945116901,124967,125999,124401,-566,-0.45,125999,1032,0.83,124401,125999,1399-9-19
764,اخزا905,اسنادخزانه-م5بودجه99-020218,9,4462,2810965554,630134,630000,630000,-134,-0.02,629979,-155,-0.02,626502,630000,1399-9-19
765,شسم,توليد سموم‌ علف‌ كش,9,785,68499885,85550,87261,87261,1711,2.0,85561,11,0.01,87261,87261,1399-9-19
766,ضچاد1014,اختيارخ كچاد-14000-1399/10/02,9,147,1024187000,6449,7300,7000,551,8.54,6967,518,8.03,6510,7300,1399-9-19
767,ضفار1122,اختيارخ فارس-11826-1399/11/07,9,50,335240000,3673,3100,3360,-313,-8.52,3352,-321,-8.74,3100,3400,1399-9-19
768,ضجار1018,اختيارخ وتجارت-5000-1399/10/21,9,429,63850000,156,150,145,-11,-7.05,149,-7,-4.49,145,150,1399-9-19
769,وسخراش,شركت س استان خراسان شمالي,8,43858,57453980,1370,1310,1310,-60,-4.38,1370,0,0.0,1310,1310,1399-9-19
770,زعف0008پ12,زعفران0008پوشالمعمول سحرخيز(پ),8,3870,349588710,95082,90333,90333,-4749,-4.99,90333,-4749,-4.99,90333,90333,1399-9-19
771,اخزا812,اسنادخزانه-م12بودجه98-001111,8,12138,10075022200,824878,815459,831999,7121,0.86,830040,5162,0.63,815459,833500,1399-9-19
772,ضپاس1003,اختيارخ وپارس-3500-1399/10/30,7,155,166932000,1019,1000,1079,60,5.89,1077,58,5.69,1000,1079,1399-9-19
773,ضپيك1021,اختيارخ تاپيكو-16000-99/10/16,7,303,766581000,2776,2980,2700,-76,-2.74,2530,-246,-8.86,2200,3400,1399-9-19
774,ونچر,ص.ج.فيروزه10%تاديه,7,16050,2247000000,214137,120000,160000,-54137,-25.28,140000,-74137,-34.62,120000,160000,1399-9-19
775,ساذري,آذريت‌,7,11030,65992490,5809,5983,5983,174,3.0,5810,1,0.02,5983,5983,1399-9-19
776,ضصاد1101,اختيارخ وبصادر-3000-1399/11/12,7,230,226132000,1079,991,950,-129,-11.96,983,-96,-8.9,942,991,1399-9-19
777,ضغدر1120,اختيارخ وغدير-12000-1399/11/26,7,27,81852000,3699,3000,3350,-349,-9.43,3032,-667,-18.03,3000,3350,1399-9-19
778,وسكهبو,س.عدالت ا. كهگيلويه وبويراحمد,7,147889,159720120,1130,1080,1080,-50,-4.42,1130,0,0.0,1080,1080,1399-9-19
779,اراد55,مرابحه عام دولت5-ش.خ 0209,6,1003800,928605342000,925020,925090,925090,70,0.01,925090,70,0.01,925090,925090,1399-9-19
780,وسزنجان,شركت س استان زنجان,6,64759,87424650,1420,1350,1350,-70,-4.93,1420,0,0.0,1350,1350,1399-9-19
781,اخزا804,اسنادخزانه-م4بودجه98-000421,5,3222,2915702160,904775,908000,905000,225,0.02,904935,160,0.02,904775,908000,1399-9-19
782,ضپيك1019,اختيارخ تاپيكو-12000-99/10/16,5,32,171900000,5323,5300,5300,-23,-0.43,5372,49,0.92,5300,5500,1399-9-19
783,ضفلا1151,اختيارخ فولاد-8000-1399/11/28,5,57,407510000,7000,7220,7140,140,2.0,7149,149,2.13,7130,7220,1399-9-19
784,ضبدر1150,اختيارخ شبندر-32000-1399/11/19,5,27,113510000,4220,4220,4200,-20,-0.47,4204,-16,-0.38,4200,4220,1399-9-19
785,اخزا807,اسنادخزانه-م7بودجه98-000719,5,5102,4457351984,870003,875000,870402,399,0.05,873648,3645,0.42,870001,875000,1399-9-19
786,وسكرشا,س.سهام عدالت استان كرمانشاه,5,32586,39103200,1260,1200,1200,-60,-4.76,1260,0,0.0,1200,1200,1399-9-19
787,ضملي1149,اختيارخ فملي-12168-1399/11/05,4,19,181424000,4536,4900,4800,264,5.82,4842,306,6.75,4800,4900,1399-9-19
788,وسيزد,شركت س استان يزد,4,34000,41480000,1280,1220,1220,-60,-4.69,1280,0,0.0,1220,1220,1399-9-19
789,اخزا713,اسنادخزانه-م13بودجه97-000518,4,4860,4340149000,894972,891725,895000,28,0.0,893035,-1937,-0.22,891725,895000,1399-9-19
790,ضفار1126,اختيارخ فارس-19826-1399/11/07,4,145,138296000,499,307,400,-99,-19.84,477,-22,-4.41,400,500,1399-9-19
791,ضخود1041,اختيارخ خودرو-2500-1399/10/07,4,23,36260000,1683,1650,1600,-83,-4.93,1577,-106,-6.3,1530,1650,1399-9-19
792,تملي803,تسهيلات مسكن ب. ملي-خرداد98,4,73,45043117,587647,617029,617029,29382,5.0,617029,29382,5.0,617029,617029,1399-9-19
793,وغدير4,سرمايه‌گذاري‌غدير(هلدينگ‌,4,1046025105,10000000003800,13820,9560,9560,-4260,-30.82,9560,-4260,-30.82,9560,9560,1399-9-19
794,ضسپا1102,اختيارخ خساپا-2000-1399/11/26,4,300,361689000,1327,1201,1600,273,20.57,1206,-121,-9.12,1201,1600,1399-9-19
795,ضملت1126,اختيارخ وبملت-4500-1399/11/28,4,104,157350000,1630,1500,1650,20,1.23,1513,-117,-7.18,1470,1650,1399-9-19
796,وسمازن,س.سهام عدالت استان مازندران,4,28000,26320000,980,940,940,-40,-4.08,980,0,0.0,940,940,1399-9-19
797,ياقوت2,صندوق س ياقوت آگاه-ثابت,4,6440000,6440000,11551,1,1,-11550,-99.99,1,-11550,-99.99,1,1,1399-9-19
798,صينا205,صكوك منفعت سينا دارو-3ماهه 19%,4,2140,2140000000,1000004,1000000,1000000,-4,0.0,1000000,-4,0.0,1000000,1000000,1399-9-19
799,اخزا805,اسنادخزانه-م5بودجه98-000422,4,25480,23084818240,905920,904456,906000,80,0.01,905998,78,0.01,904456,906000,1399-9-19
800,شستا993,اجاره ت.اجتماعي-كاردان991226,4,155,155488000,1000000,1004000,1000000,0,0.0,1003148,3148,0.31,1000000,1008000,1399-9-19
801,ضغدر1121,اختيارخ وغدير-14000-1399/11/26,3,39,82932000,2300,2000,2548,248,10.78,2126,-174,-7.57,2000,2548,1399-9-19
802,اراد384,مرابحه عام دولت3-ش.خ 0105,3,6243944,5974797532044,948000,955117,957810,9810,1.03,956895,8895,0.94,955117,957810,1399-9-19
803,ضپاس1004,اختيارخ وپارس-4000-1399/10/30,3,55,49290000,657,898,888,231,35.16,896,239,36.38,888,898,1399-9-19
804,افق ملت2,صندوق س در سهام افق ملت,3,300000,300000,147760,1,1,-147759,-100.0,1,-147759,-100.0,1,1,1399-9-19
805,شرق1400,مشاركت ليزينگ ايران وشرق140010,3,398,401980000,1020000,1010000,1010000,-10000,-0.98,1010000,-10000,-0.98,1010000,1010000,1399-9-19
806,شستا992,اجاره تامين اجتماعي-سپهر991226,3,30,30049990,1000119,1004999,1000000,-119,-0.01,1001666,1547,0.15,1000000,1004999,1399-9-19
807,صايپا308,صكوك مرابحه سايپا308-3ماهه 18%,3,36,35840000,1000000,990000,1000000,0,0.0,995556,-4444,-0.44,990000,1000000,1399-9-19
808,اطلس2,صندوق س.توسعه اندوخته آينده-س,3,30000,30000,213091,1,1,-213090,-100.0,1,-213090,-100.0,1,1,1399-9-19
809,ضخوز1016,اختيارخ فخوز-15238-1399/10/16,3,7,28000000,1010,3000,5000,3990,395.05,4000,2990,296.04,3000,5000,1399-9-19
810,ضجار1013,اختيارخ وتجارت-2500-1399/10/21,3,7,11042000,1290,1700,1271,-19,-1.47,1577,287,22.25,1271,1700,1399-9-19
811,ضچاد1012,اختيارخ كچاد-10000-1399/10/02,3,6,65800000,11207,10500,11100,-107,-0.95,10967,-240,-2.14,10500,11100,1399-9-19
812,افران2,صندوق س افرا نماد پايدار-ثابت,3,300000,300000,12258,1,1,-12257,-99.99,1,-12257,-99.99,1,1,1399-9-19
813,اخزا8144,اسنادخزانه-م14بودجه98-010318,2,711142,548126563769,773117,760840,780699,7582,0.98,770769,-2348,-0.3,760840,780699,1399-9-19
814,اخزا813,اسنادخزانه-م13بودجه98-010219,2,1162,904851100,777529,800000,777501,-28,0.0,778701,1172,0.15,777501,800000,1399-9-19
815,اراد38,مرابحه عام دولت3-ش.خ 0105,2,1000,948000000,948000,911000,985000,37000,3.9,948000,0,0.0,911000,985000,1399-9-19
816,دومينو4,اجاره دومينو14040208,2,5000,4620752500,918052,933300,915001,-3051,-0.33,924150,6098,0.66,915001,933300,1399-9-19
817,اراد314,مرابحه عام دولت3-ش.خ 0208,2,22500000,19911925000000,1000000,884954,885000,-115000,-11.5,884974,-115026,-11.5,884954,885000,1399-9-19
818,صگل1411,ص اجاره گل گهر 1411-3 ماهه 17%,2,11,10736000,956000,1000000,956000,0,0.0,976000,20000,2.09,956000,1000000,1399-9-19
819,پست0008پ09,پسته بادامي30-28مه ولات0008(پ),2,20,30894780,1625766,1545000,1544478,-81288,-5.0,1544739,-81027,-4.98,1544478,1545000,1399-9-19
820,افاد744,منفعت دولت7-ش.خاص ساير0204,2,4000000,3843992000000,983890,962596,959400,-24490,-2.49,960998,-22892,-2.33,959400,962596,1399-9-19
821,ضپاس1000,اختيارخ وپارس-2000-1399/10/30,2,2,4850000,2360,2400,2450,90,3.81,2425,65,2.75,2400,2450,1399-9-19
822,اخزا718,اسنادخزانه-م18بودجه97-000525,2,1005,895451255,885294,890051,891001,5707,0.64,890996,5702,0.64,890051,891001,1399-9-19
823,زير0003پ02,زيره سبز0003 دانش(پ),2,20,11891720,624288,594586,594586,-29702,-4.76,594586,-29702,-4.76,594586,594586,1399-9-19
824,اراد374,مرابحه عام دولت3-ش.خ 0005,2,16331712,16107673574784,1011177,980314,992250,-18927,-1.87,986282,-24895,-2.46,980314,992250,1399-9-19
825,شستا003,اجاره تامين اجتماعي-سپهر000523,2,38,37940030,1007073,990001,1030000,22927,2.28,998422,-8651,-0.86,990001,1030000,1399-9-19
826,اخزا8124,اسنادخزانه-م12بودجه98-001111,2,1264156,1042996964424,824878,821917,828191,3313,0.4,825054,176,0.02,821917,828191,1399-9-19
827,ضشنا1045,اختيارخ شپنا-12000-1399/10/23,2,9,56005000,2093,6500,6001,3908,186.72,6223,4130,197.32,6001,6500,1399-9-19
828,اخزا722,اسنادخزانه-م22بودجه97-000428,2,3260,2946494260,903766,901901,904000,234,0.03,903833,67,0.01,901901,904000,1399-9-19
829,اخزا716,اسنادخزانه-م16بودجه97-000407,2,811,738015362,908778,910000,910007,1229,0.14,910007,1229,0.14,910000,910007,1399-9-19
830,ضسپا1100,اختيارخ خساپا-1600-1399/11/26,2,3,4443000,1760,1481,1481,-279,-15.85,1481,-279,-15.85,1481,1481,1399-9-19
831,ضفلا1159,اختيارخ فولاد-24000-1399/11/28,2,2,490000,80,200,290,210,262.5,245,165,206.25,200,290,1399-9-19
832,شلرد2,كود شيميايي اوره لردگان,2,44000000,510884000000,11304,11611,11611,307,2.72,11611,307,2.72,11611,11611,1399-9-19
833,ضپار1116,اختيارخ خپارس-6000-1399/11/19,2,12,42800000,3222,2800,3700,478,14.84,3567,345,10.71,3300,3700,1399-9-19
834,اخزا8154,اسنادخزانه-م15بودجه98-010406,2,1013288,762272243488,758408,746346,758206,-202,-0.03,752276,-6132,-0.81,746346,758206,1399-9-19
835,تملي806,تسهيلات مسكن ب. ملي-شهريور98,2,38,18858982,472657,496289,496289,23632,5.0,496289,23632,5.0,496289,496289,1399-9-19
836,اخزا720,اسنادخزانه-م20بودجه97-000324,2,46,42182000,917009,916000,918000,991,0.11,917000,-9,0.0,916000,918000,1399-9-19
837,ضفار1123,اختيارخ فارس-13826-1399/11/07,2,105,459000000,2621,1900,2200,-421,-16.06,2186,-435,-16.6,1900,2200,1399-9-19
838,اراد50,مرابحه عام دولت5-ش.خ0302,2,50000,50000000000,1000000,1000000,1000000,0,0.0,1000000,0,0.0,1000000,1000000,1399-9-19
839,ومشان,س. فني و مهندسي مشانير,2,622,35662370,59108,57335,57335,-1773,-3.0,59105,-3,-0.01,57335,57335,1399-9-19
840,افاد44,منفعت دولتي4-شرايط خاص14010729,2,6000000,5863407000000,1030000,976119,978350,-51650,-5.01,977234,-52766,-5.12,976119,978350,1399-9-19
841,اخزا7134,اسنادخزانه-م13بودجه97-000518,2,3271676,2910283397364,894972,890269,888809,-6163,-0.69,889539,-5433,-0.61,888809,890269,1399-9-19
842,دشيري2,شيرين دارو,1,250000,40265500000,158908,161062,161062,2154,1.36,161062,2154,1.36,161062,161062,1399-9-19
843,دلر4,داروسازي‌ اكسير,1,2250000,265410000000,118820,117960,117960,-860,-0.72,117960,-860,-0.72,117960,117960,1399-9-19
844,ضملي1150,اختيارخ فملي-14196-1399/11/05,1,100,650760000,3329,3300,3300,-29,-0.87,3300,-29,-0.87,3300,3300,1399-9-19
845,ضسان1039,اختيارخ پارسان-20000-99/10/14,1,1,5220000,3200,5220,5220,2020,63.13,5220,2020,63.13,5220,5220,1399-9-19
846,صگل411,ص اجاره گل گهر 411- 3 ماهه 17%,1,9,8820000,980000,980000,980000,0,0.0,980000,0,0.0,980000,980000,1399-9-19
847,زفكا2,كشت و دامداري فكا,1,1500000,81112500000,52240,54075,54075,1835,3.51,54075,1835,3.51,54075,54075,1399-9-19
848,اخزا8064,اسنادخزانه-م6بودجه98-000519,1,155543,138939562465,896659,893255,893255,-3404,-0.38,893255,-3404,-0.38,893255,893255,1399-9-19
849,اخزا723,اسنادخزانه-م23بودجه97-000824,1,6,5178000,861874,863000,863000,1126,0.13,863000,1126,0.13,863000,863000,1399-9-19
850,پا ر 27,بار پايه روز 27,1,10000,3900000,350,390,390,40,11.43,390,40,11.43,390,390,1399-9-19
851,ضپاس1006,اختيارخ وپارس-5000-1399/10/30,1,50,15000000,300,300,300,0,0.0,300,0,0.0,300,300,1399-9-19
852,پارس2,پتروشيمي پارس,1,2531867,402060479600,161060,158800,158800,-2260,-1.4,158800,-2260,-1.4,158800,158800,1399-9-19
853,دتوزيع4,توزيع دارو پخش,1,3000000,84807000000,27077,28269,28269,1192,4.4,28269,1192,4.4,28269,28269,1399-9-19
854,اخابر2,مخابرات ايران,1,20000000,324800000000,15470,16240,16240,770,4.98,16240,770,4.98,16240,16240,1399-9-19
855,اخزا7234,اسنادخزانه-م23بودجه97-000824,1,208149,178383693000,861874,857000,857000,-4874,-0.57,857000,-4874,-0.57,857000,857000,1399-9-19
856,ضخود1040,اختيارخ خودرو-2000-1399/10/07,1,34,68000000,2191,2000,2000,-191,-8.72,2000,-191,-8.72,2000,2000,1399-9-19
857,كاسپين4,داروسازي كاسپين تامين,1,3500000,107149000000,30483,30614,30614,131,0.43,30614,131,0.43,30614,30614,1399-9-19
858,درهآور4,دارويي ره آورد تامين,1,1000000,41845000000,41404,41845,41845,441,1.07,41845,441,1.07,41845,41845,1399-9-19
859,ضجار1010,اختيارخ وتجارت-1600-1399/10/21,1,6,16380000,2747,2730,2730,-17,-0.62,2730,-17,-0.62,2730,2730,1399-9-19
860,ضسپا1108,اختيارخ خساپا-5000-1399/11/26,1,100,20000000,150,200,200,50,33.33,200,50,33.33,200,200,1399-9-19
861,دتماد4,توليدمواداوليه‌داروپخش‌,1,3575000,199091750000,56100,55690,55690,-410,-0.73,55690,-410,-0.73,55690,55690,1399-9-19
862,ضپار1117,اختيارخ خپارس-7000-1399/11/19,1,25,62500000,2355,2500,2500,145,6.16,2500,145,6.16,2500,2500,1399-9-19
863,ضخوز1013,اختيارخ فخوز-10667-1399/10/16,1,5,64400000,14400,12880,12880,-1520,-10.56,12880,-1520,-10.56,12880,12880,1399-9-19
864,شلرد02,كود شيميايي اوره لردگان,1,5,5000000,1006250,1000000,1000000,-6250,-0.62,1000000,-6250,-0.62,1000000,1000000,1399-9-19
865,زير0003پ01,زيره سبز0003كيميابذر(پ),1,10,5945860,626799,594586,594586,-32213,-5.14,594586,-32213,-5.14,594586,594586,1399-9-19
866,افاد61,منفعت دولت6-ش.خاص140109,1,3000,2985000000,985000,995000,995000,10000,1.02,995000,10000,1.02,995000,995000,1399-9-19
867,دقاضي2,داروسازي شهيد قاضي,1,2025000,190109025000,94112,93881,93881,-231,-0.25,93881,-231,-0.25,93881,93881,1399-9-19
868,دمعيار2,صندوق س. توازن معيار-د,1,6800000,6800000,10089,1,1,-10088,-99.99,1,-10088,-99.99,1,1,1399-9-19
869,دابور4,داروسازي‌ ابوريحان‌,1,3000000,152310000000,50430,50770,50770,340,0.67,50770,340,0.67,50770,50770,1399-9-19
870,دزهراوي4,داروسازي‌زهراوي‌,1,12520000,179036000000,14070,14300,14300,230,1.63,14300,230,1.63,14300,14300,1399-9-19
871,ضپيك1023,اختيارخ تاپيكو-20000-99/10/16,1,10,8000000,786,800,800,14,1.78,800,14,1.78,800,800,1399-9-19
872,اخزا8054,اسنادخزانه-م5بودجه98-000422,1,168200,151991575200,905920,903636,903636,-2284,-0.25,903636,-2284,-0.25,903636,903636,1399-9-19
873,دشيمي4,شيمي‌ داروئي‌ داروپخش‌,1,1275000,75250500000,57900,59020,59020,1120,1.93,59020,1120,1.93,59020,59020,1399-9-19
874,خكاوه2,سايپا ديزل,1,10000000,54710000000,5312,5471,5471,159,2.99,5471,159,2.99,5471,5471,1399-9-19
875,زگلدشت2,كشت و دام گلدشت نمونه اصفهان,1,1000000,50183000000,48996,50183,50183,1187,2.42,50183,1187,2.42,50183,50183,1399-9-19
876,دكپسول4,توليد ژلاتين كپسول ايران,1,1000000,43744000000,41661,43744,43744,2083,5.0,43744,2083,5.0,43744,43744,1399-9-19
877,اراد53,مرابحه عام دولت5-ش.خ 0207,1,500,462000000,926902,924000,924000,-2902,-0.31,924000,-2902,-0.31,924000,924000,1399-9-19
878,زملارد2,كشاورزي و دامپروري ملارد شير,1,1500000,65920500000,42294,43947,43947,1653,3.91,43947,1653,3.91,43947,43947,1399-9-19
879,غنيلي,مجتمع توليدي نيلي صنعت كرمان,1,50000,850000000,16700,17000,17000,300,1.8,17000,300,1.8,17000,17000,1399-9-19
880,اراد414,مرابحه عام دولت4-ش.خ 0006,1,2500000,2470800000000,1016011,988320,988320,-27691,-2.73,988320,-27691,-2.73,988320,988320,1399-9-19
881,كروي4,توسعه‌ معادن‌ روي‌ ايران‌,1,2500000,93475000000,36260,37390,37390,1130,3.12,37390,1130,3.12,37390,37390,1399-9-19
882,ضبدر1157,اختيارخ شبندر-20000-1399/11/19,1,3,38997000,13375,12999,12999,-376,-2.81,12999,-376,-2.81,12999,12999,1399-9-19
883,اخزا819,اسنادخزانه-م19بودجه98-020322,1,1600,998868800,633800,624293,624293,-9507,-1.5,624293,-9507,-1.5,624293,624293,1399-9-19
884,تملي809,تسهيلات مسكن ب. ملي-آذر98,1,31,7479649,229790,241279,241279,11489,5.0,241279,11489,5.0,241279,241279,1399-9-19
885,فبستم,صنايع ‌بسته‌بندي‌ مشهد,1,6756,5512896,793,816,816,23,2.9,793,0,0.0,816,816,1399-9-19
886,پا ر 26,بار پايه روز 26,1,36000,14040000,350,390,390,40,11.43,390,40,11.43,390,390,1399-9-19
887,ضخوز1017,اختيارخ فخوز-18286-1399/10/16,1,5,9000000,1000,1800,1800,800,80.0,1800,800,80.0,1800,1800,1399-9-19
888,ضسان1038,اختيارخ پارسان-18000-99/10/14,1,1,7000000,8000,7000,7000,-1000,-12.5,7000,-1000,-12.5,7000,7000,1399-9-19
889,ضفار1120,اختيارخ فارس-8826-1399/11/07,1,30,405000000,6750,6750,6750,0,0.0,6750,0,0.0,6750,6750,1399-9-19
890,ضغدر1118,اختيارخ وغدير-9000-1399/11/26,1,1,5700000,5700,5700,5700,0,0.0,5700,0,0.0,5700,5700,1399-9-19
891,جم2,پتروشيمي جم,1,3000000,148200000000,50250,49400,49400,-850,-1.69,49400,-850,-1.69,49400,49400,1399-9-19
892,اراد474,مرابحه عام دولت4-ش.خ 0008,1,2000000,1956480000000,980000,978240,978240,-1760,-0.18,978240,-1760,-0.18,978240,978240,1399-9-19
893,ددام4,داروسازي زاگرس فارمد پارس,1,4601115,80335467900,16760,17460,17460,700,4.18,17460,700,4.18,17460,17460,1399-9-19
894,صايپا203,صكوك مرابحه سايپا203-3ماهه 16%,1,1000,952200000,960826,952200,952200,-8626,-0.9,952200,-8626,-0.9,952200,952200,1399-9-19
895,فاسمين4,كالسيمين‌,1,5000000,102300000000,19490,20460,20460,970,4.98,20460,970,4.98,20460,20460,1399-9-19
896,اخزا7042,اسنادخزانه-م4بودجه97-991022,1,150000,148500000000,987097,990000,990000,2903,0.29,990000,2903,0.29,990000,990000,1399-9-19
897,پاكشو2,گروه صنعتي پاكشو,1,1000000,82000000000,83800,82000,82000,-1800,-2.15,82000,-1800,-2.15,82000,82000,1399-9-19
898,وهنر2,گروه توسعه هنر ايران,1,8000000,42320000000,5152,5290,5290,138,2.68,5290,138,2.68,5290,5290,1399-9-19
899,دپارس4,پارس‌ دارو,1,2625000,274680000000,104560,104640,104640,80,0.08,104640,80,0.08,104640,104640,1399-9-19
900,ضمخا7068,اختيارخ اخابر-16000-1400/07/28,1,1,5555000,5000,5555,5555,555,11.1,5555,555,11.1,5555,5555,1399-9-19
901,صخود412,ص مرابحه خودرو412- 3ماهه 18%,1,1000,982000000,991857,982000,982000,-9857,-0.99,982000,-9857,-0.99,982000,982000,1399-9-19
902,اراد344,مرابحه عام دولت3-ش.خ 0305,1,3000000,2743116000000,999970,914372,914372,-85598,-8.56,914372,-85598,-8.56,914372,914372,1399-9-19
903,ما2,بيمه  ما,1,19950000,185136000000,9280,9280,9280,0,0.0,9280,0,0.0,9280,9280,1399-9-19
904,درازك4,دارويي‌ رازك‌,1,4447500,201427275000,44950,45290,45290,340,0.76,45290,340,0.76,45290,45290,1399-9-19
905,فافزا2,فولاد افزا سپاهان,1,800000,35366400000,42933,44208,44208,1275,2.97,44208,1275,2.97,44208,44208,1399-9-19
906,دارو4,كارخانجات‌داروپخش‌,1,3750000,218887500000,57680,58370,58370,690,1.2,58370,690,1.2,58370,58370,1399-9-19
907,كلر4,كلر پارس,1,1637500,127307437500,74231,77745,77745,3514,4.73,77745,3514,4.73,77745,77745,1399-9-19
908,دفارا4,داروسازي‌ فارابي‌,1,3000000,203340000000,69940,67780,67780,-2160,-3.09,67780,-2160,-3.09,67780,67780,1399-9-19
909,صمسكن912,ص دين مسكن جنوب-ماهانه16درصد,1,80,4888640,61476,61108,61108,-368,-0.6,61108,-368,-0.6,61108,61108,1399-9-19
910,لپارس2,پارس‌ الكتريك‌,1,1500000,253770000000,161450,169180,169180,7730,4.79,169180,7730,4.79,169180,169180,1399-9-19
911,وپخش4,داروپخش‌ (هلدينگ‌,1,4200000,609420000000,145470,145100,145100,-370,-0.25,145100,-370,-0.25,145100,145100,1399-9-19
912,كگل2,معدني و صنعتي گل گهر,1,6300000,129150000000,19960,20500,20500,540,2.71,20500,540,2.71,20500,20500,1399-9-19
913,عسناسنگ2,سلف كنستانتره سنگ آهن سناباد2,1,1,7824590,7529215,7824590,7824590,295375,3.92,7824590,295375,3.92,7824590,7824590,1399-9-19
914,ضمخا7067,اختيارخ اخابر-14000-1400/07/28,1,13,97500000,6980,7500,7500,520,7.45,7500,520,7.45,7500,7500,1399-9-19
915,غگرجي4,بيسكويت‌  گرجي‌,1,5000000,202400000000,38730,40480,40480,1750,4.52,40480,1750,4.52,40480,40480,1399-9-19
916,كيش1402,اجاره س. و توسعه كيش14020820,1,9,8820000,980000,980000,980000,0,0.0,980000,0,0.0,980000,980000,1399-9-19
917,كرمان02,مرابحه كرمان موتور14020306,1,2500,2500000000,1020000,1000000,1000000,-20000,-1.96,1000000,-20000,-1.96,1000000,1000000,1399-9-19
918,غدشت4,دشت‌ مرغاب‌,1,2500000,660500000000,269940,264200,264200,-5740,-2.13,264200,-5740,-2.13,264200,264200,1399-9-19
919,زشريف4,كشت وصنعت شريف آباد,1,1350000,35819550000,25748,26533,26533,785,3.05,26533,785,3.05,26533,26533,1399-9-19
920,زماهان4,مجتمع توليد گوشت مرغ ماهان,1,910000,25472720000,27827,27992,27992,165,0.59,27992,165,0.59,27992,27992,1399-9-19
