,نماد,نام,تعداد,حجم,ارزش,دیروز,اولین,آخرین معامله - مقدار,آخرین معامله - تغییر,آخرین معامله - درصد,قیمت پایانی - مقدار,قیمت پایانی - تغییر,قیمت پایانی - درصد,کمترین,بیشترین,تاریخ
0,شستا,سرمايه گذاري تامين اجتماعي,60454,153705270,3759193690240,25360,24700,24100,-1260,-4.97,24460,-900,-3.55,24100,25330,1399-10-1
1,پالايش,صندوق پالايشي يکم-سهام,53582,24842583,2223703142090,91210,89200,87800,-3410,-3.74,89510,-1700,-1.86,86520,93350,1399-10-1
2,شپنا,پالايش نفت اصفهان,52319,282833484,4048073953630,14720,14350,13990,-730,-4.96,14310,-410,-2.79,13990,15060,1399-10-1
3,خودرو,ايران‌ خودرو,48972,1059440381,3580270547500,3510,3430,3340,-170,-4.84,3380,-130,-3.7,3340,3540,1399-10-1
4,كاما,باما,45035,234574346,5015254470770,21360,20300,22420,1060,4.96,21380,20,0.09,20300,22420,1399-10-1
5,بپيوند,برق و انرژي پيوندگستر پارس,37525,44119810,1450351287402,33196,33100,32030,-1166,-3.51,32873,-323,-0.97,31530,34250,1399-10-1
6,وسپهر,سرمايه گذاري مالي سپهرصادرات,36948,80959556,909959857514,11492,11230,11103,-389,-3.38,11240,-252,-2.19,11032,11681,1399-10-1
7,وتجارت,بانك تجارت,34036,687082937,2279198517420,3390,3310,3250,-140,-4.13,3320,-70,-2.06,3240,3450,1399-10-1
8,بوعلي,پتروشيمي بوعلي سينا,30369,3762180,219297472200,55520,58290,58290,2770,4.99,58290,2770,4.99,58290,58290,1399-10-1
9,دي,بانك دي,29741,57795093,2535007116333,45555,44300,43829,-1726,-3.79,43862,-1693,-3.72,43278,45555,1399-10-1
10,دارا يكم,صندوق واسطه گري مالي يكم-سهام,29078,9571102,1673193729460,176220,174920,173640,-2580,-1.46,174820,-1400,-0.79,172300,178500,1399-10-1
11,فملي,ملي‌ صنايع‌ مس‌ ايران‌,28266,86725424,1379421938830,15900,15930,15900,0,0.0,15910,10,0.06,15500,16400,1399-10-1
12,خساپا,سايپا,26509,758732052,1882473599750,2570,2530,2450,-120,-4.67,2480,-90,-3.5,2450,2590,1399-10-1
13,زدشت,كشت و صنعت دشت خرم دره,25177,34392520,2319533464569,67948,67586,64750,-3198,-4.71,67443,-505,-0.74,63020,71380,1399-10-1
14,سيتا,سرمايه گذاري سيمان تامين,23841,33932749,571474170200,16670,16310,16720,50,0.3,16840,170,1.02,16310,17400,1399-10-1
15,بگيلان,توسعه مسير برق گيلان,23403,11424556,303263974588,25698,26100,26350,652,2.54,26545,847,3.3,25600,26982,1399-10-1
16,خگستر,گسترش‌سرمايه‌گذاري‌ايران‌خودرو,22924,393132324,1642233021950,4350,4280,4140,-210,-4.83,4180,-170,-3.91,4140,4340,1399-10-1
17,فولاد,فولاد مباركه اصفهان,22858,125040946,1791779774280,14510,14510,14150,-360,-2.48,14330,-180,-1.24,14010,14790,1399-10-1
18,امين,تامين سرمايه امين,22366,37637419,438518366590,11250,11300,11570,320,2.84,11650,400,3.56,11260,11810,1399-10-1
19,ثاميد,توسعه و عمران اميد,21478,126094201,285720922360,2280,2270,2260,-20,-0.88,2270,-10,-0.44,2220,2340,1399-10-1
20,وكبهمن,مديريت سرمايه گذاري كوثربهمن,21428,1145590,21272460710,17685,18569,18569,884,5.0,18020,335,1.89,18569,18569,1399-10-1
21,شتران,پالايش نفت تهران,21417,83003141,966491772450,11800,11500,11360,-440,-3.73,11640,-160,-1.36,11250,12200,1399-10-1
22,چخزر,صنايع چوب خزر كاسپين,20426,177061,5009586873,26946,28293,28293,1347,5.0,27073,127,0.47,28293,28293,1399-10-1
23,شاروم,پتروشيمي اروميه,20146,23099195,721368428061,29868,31349,31361,1493,5.0,31229,1361,4.56,29868,31361,1399-10-1
24,شبندر,پالايش نفت بندرعباس,20023,55744578,1580408898270,28240,27800,27980,-260,-0.92,28350,110,0.39,27150,29500,1399-10-1
25,زملارد,كشاورزي و دامپروري ملارد شير,19374,3650238,160986329002,45538,45000,43280,-2258,-4.96,44103,-1435,-3.15,43262,46010,1399-10-1
26,آبادا,توليد نيروي برق آبادان,18953,15717365,283067408020,18320,17960,17600,-720,-3.93,18010,-310,-1.69,17410,18900,1399-10-1
27,ثبهساز,بهساز كاشانه تهران,18749,114243325,317076404340,2850,2840,2770,-80,-2.81,2780,-70,-2.46,2710,2890,1399-10-1
28,غزر,صنعتي زر ماكارون,17385,3678485,216670505990,58110,58300,60000,1890,3.25,58900,790,1.36,56500,60490,1399-10-1
29,ثشاهد,سرمايه‌ گذاري‌ شاهد,17085,60893527,1482498469160,25260,25000,24630,-630,-2.49,24350,-910,-3.6,24000,25190,1399-10-1
30,حكشتي,كشتيراني جمهوري اسلامي ايران,16874,39078645,993179598760,26520,25700,25200,-1320,-4.98,25410,-1110,-4.19,25200,26350,1399-10-1
31,وبصادر,بانك صادرات ايران,16364,327399482,994918691330,3100,3000,3030,-70,-2.26,3040,-60,-1.94,2960,3150,1399-10-1
32,پترول,گروه پتروشيمي س. ايرانيان,15563,72900884,886988909920,12090,12020,12090,0,0.0,12170,80,0.66,11780,12550,1399-10-1
33,وپارس,بانك‌پارسيان‌,14905,308885694,1239140151120,4050,3970,4000,-50,-1.23,4010,-40,-0.99,3890,4190,1399-10-1
34,حسينا,توسعه خدمات دريايي وبندري سينا,14892,12815834,1256105795381,101962,97100,94700,-7262,-7.12,98012,-3950,-3.87,93500,104490,1399-10-1
35,آريا,پليمر آريا ساسول,14489,2469790,463699049680,191211,189900,184861,-6350,-3.32,187748,-3463,-1.81,184670,193250,1399-10-1
36,انرژي3,سايراشخاص بورس انرژي,13700,3692908,1404470170110,364810,380000,383050,18240,5.0,380320,15510,4.25,348540,383050,1399-10-1
37,فخوز,فولاد  خوزستان,13546,80048327,1368063789160,16370,16890,17180,810,4.95,17090,720,4.4,16370,17180,1399-10-1
38,شسينا,صنايع‌شيميايي‌سينا,13509,7357244,1413518349570,195690,185910,187230,-8460,-4.32,192130,-3560,-1.82,185910,204900,1399-10-1
39,گدنا,تهيه توزيع غذاي دنا آفرين فدك,13236,666740,28841838920,41199,43258,43258,2059,5.0,42255,1056,2.56,43258,43258,1399-10-1
40,وبملت,بانك ملت,13140,234000863,1142532146540,4890,4790,4830,-60,-1.23,4880,-10,-0.2,4720,5030,1399-10-1
41,ونيكي,سرمايه‌گذاري‌ ملي‌ايران‌,12916,59785026,1244020570500,20700,19670,21730,1030,4.98,20810,110,0.53,19670,21730,1399-10-1
42,وپويا,سرمايه گذاري پويا,12536,23241659,193111948928,8381,8113,8155,-226,-2.7,8309,-72,-0.86,8080,8650,1399-10-1
43,كرمان,س. توسعه و عمران استان كرمان,12171,16216353,1447443470832,85644,88000,89926,4282,5.0,89258,3614,4.22,86000,89926,1399-10-1
44,پيزد,مجتمع صنايع لاستيك يزد,11402,1901213,168326066965,85220,89481,89481,4261,5.0,88536,3316,3.89,83932,89481,1399-10-1
45,چكاپا,گروه صنايع كاغذ پارس,11310,103485468,782906073660,7730,7600,7390,-340,-4.4,7570,-160,-2.07,7350,7990,1399-10-1
46,شگويا,پتروشيمي تندگويان,11152,45103837,518938240465,11589,11500,11357,-232,-2.0,11505,-84,-0.72,11154,11980,1399-10-1
47,تليسه,دامداري تليسه نمونه,10380,75949023,534202668477,6874,6600,7217,343,4.99,7034,160,2.33,6534,7217,1399-10-1
48,غصينو,صنعتي مينو,10210,13368577,1140550959057,83220,84000,82500,-720,-0.87,85316,2096,2.52,80000,87381,1399-10-1
49,خزاميا,زامياد,10174,52009715,663894495170,13000,13200,12620,-380,-2.92,12760,-240,-1.85,12400,13200,1399-10-1
50,كالا,بورس كالاي ايران,10041,20705804,1076652166820,50230,52740,51280,1050,2.09,52000,1770,3.52,50560,52740,1399-10-1
51,خپارس,پارس‌ خودرو,9557,100485503,749891188660,7660,7360,7510,-150,-1.96,7460,-200,-2.61,7280,7790,1399-10-1
52,ذوب,سهامي ذوب آهن  اصفهان,9114,97733529,545541552739,5685,5750,5465,-220,-3.87,5582,-103,-1.81,5420,5840,1399-10-1
53,فرابورس,فرابورس ايران,9074,12780203,764820335261,59518,60840,58200,-1318,-2.21,59844,326,0.55,57332,62017,1399-10-1
54,وحكمت,بيمه حكمت صبا,8764,85114747,531740017269,6115,5810,6420,305,4.99,6247,132,2.16,5810,6420,1399-10-1
55,ونوين,بانك‌اقتصادنوين‌,8702,298127981,1655713872000,5310,5290,5570,260,4.9,5550,240,4.52,5170,5570,1399-10-1
56,رافزا,رايان هم افزا,8701,52384,2031556288,36936,38782,38782,1846,5.0,37007,71,0.19,38782,38782,1399-10-1
57,وملي,گروه‌ صنعتي‌ ملي‌ (هلدينگ‌,8238,2008700,623877634310,318920,318000,305000,-13920,-4.36,310590,-8330,-2.61,303020,329000,1399-10-1
58,شبريز,پالايش نفت تبريز,8126,20852013,646038699310,30940,30300,30870,-70,-0.23,30980,40,0.13,30030,32480,1399-10-1
59,وساپا,سرمايه‌گذاري‌ سايپا,8124,66730486,551770079760,8420,8130,8160,-260,-3.09,8270,-150,-1.78,8040,8700,1399-10-1
60,وخارزم,سرمايه گذاري خوارزمي,7965,47149186,483644096260,10290,10010,10110,-180,-1.75,10260,-30,-0.29,9980,10650,1399-10-1
61,قاسم,قاسم ايران,7946,35234958,613631761861,17229,16550,17680,451,2.62,17415,186,1.08,16370,18080,1399-10-1
62,ثاخت,بين‌المللي‌توسعه‌ساختمان,7834,115182599,519281306840,4650,4650,4420,-230,-4.95,4510,-140,-3.01,4420,4780,1399-10-1
63,ملت,بيمه ملت,7759,44971419,959420896230,20620,21060,21200,580,2.81,21330,710,3.44,20630,21650,1399-10-1
64,زاگرس,پتروشيمي زاگرس,7605,13747903,2958132835592,205067,215320,212450,7383,3.6,215170,10103,4.93,210001,215320,1399-10-1
65,فاراك,ماشين‌ سازي‌ اراك‌,7502,105405292,844393868820,7660,7460,8040,380,4.96,8010,350,4.57,7460,8040,1399-10-1
66,شلرد,كود شيميايي اوره لردگان,7124,46264462,468011779885,10380,10380,10069,-311,-3.0,10116,-264,-2.54,10069,10380,1399-10-1
67,خصدرا,صنعتي‌ دريايي‌ ايران‌,7086,88988958,452076762559,5231,5080,5085,-146,-2.79,5080,-151,-2.89,5075,5150,1399-10-1
68,تملت,تامين سرمايه بانك ملت,7046,35120082,375510526980,10250,10580,10750,500,4.88,10690,440,4.29,10200,10760,1399-10-1
69,حآسا,آسيا سير ارس,7038,21639580,829388836703,35910,38300,38190,2280,6.35,38327,2417,6.73,37705,40215,1399-10-1
70,سبزوا,سيمان لار سبزوار,7035,53412049,276491066478,5324,5101,5210,-114,-2.14,5177,-147,-2.76,5058,5500,1399-10-1
71,وغدير,سرمايه‌گذاري‌غدير(هلدينگ‌,6998,34008738,436555903570,12970,12610,12600,-370,-2.85,12840,-130,-1.0,12480,13250,1399-10-1
72,هرمز,فولاد هرمزگان جنوب,6946,33322172,533059376811,16141,16149,15700,-441,-2.73,15997,-144,-0.89,15458,16680,1399-10-1
73,لپارس,پارس‌ الكتريك‌,6930,2360239,341982373370,149710,147770,143790,-5920,-3.95,144890,-4820,-3.22,142230,152600,1399-10-1
74,خبهمن,گروه‌بهمن‌,6633,39387061,1171066107240,28520,28350,29940,1420,4.98,29730,1210,4.24,27670,29940,1399-10-1
75,نوري,پتروشيمي نوري,6521,5838912,408142550820,70310,69800,69150,-1160,-1.65,69900,-410,-0.58,68180,72000,1399-10-1
76,بكهنوج,توليد برق ماهتاب كهنوج,6504,122307016,340557086204,2917,2800,2772,-145,-4.97,2784,-133,-4.56,2772,2880,1399-10-1
77,هاي وب,داده گسترعصرنوين-هاي وب,6490,16612073,498561212930,30390,29890,29500,-890,-2.93,30010,-380,-1.25,29400,31100,1399-10-1
78,غچين,كشت‌ و صنعت‌ چين‌ چين,6465,11243733,768036212700,67860,71250,67010,-850,-1.25,68310,450,0.66,64610,71250,1399-10-1
79,حفاري,حفاري شمال,6424,41414577,519112364790,12360,12060,12840,480,3.88,12530,170,1.38,11950,12950,1399-10-1
80,شيران,س. صنايع‌شيميايي‌ايران,6341,10524927,431354562980,40690,40000,40590,-100,-0.25,40980,290,0.71,40000,42200,1399-10-1
81,فسا,پتروشيمي فسا,6316,136492768,338892870505,2521,2395,2600,79,3.13,2483,-38,-1.51,2395,2638,1399-10-1
82,غمينو,شركت صنايع غذايي مينو شرق,6261,21135081,349679189249,16270,16450,15800,-470,-2.89,16545,275,1.69,15500,17083,1399-10-1
83,تاپيكو,س. نفت و گاز و پتروشيمي تأمين,6222,34000157,492084164560,14830,14400,14090,-740,-4.99,14470,-360,-2.43,14090,15030,1399-10-1
84,البرز,بيمه البرز,6105,136326250,756317719610,5300,5480,5560,260,4.91,5550,250,4.72,5350,5560,1399-10-1
85,صبا,سرمايه گذاري صبا تامين,6103,20095523,172941674045,8726,8600,8494,-232,-2.66,8606,-120,-1.38,8421,8980,1399-10-1
86,ختوقا,قطعات‌ اتومبيل‌ ايران‌,6064,87928118,376703328060,4470,4270,4250,-220,-4.92,4280,-190,-4.25,4250,4430,1399-10-1
87,ونيرو,سرمايه‌گذاري‌نيرو,5890,60321362,246410690430,4190,4130,4060,-130,-3.1,4080,-110,-2.63,4000,4240,1399-10-1
88,فارس,صنايع پتروشيمي خليج فارس,5816,23126503,306976811450,13250,12860,12980,-270,-2.04,13270,20,0.15,12760,13650,1399-10-1
89,قنيشا,قند  نيشابور,5722,5883336,400221832780,67910,70400,67000,-910,-1.34,68030,120,0.18,65110,70990,1399-10-1
90,ديران,ايران‌دارو,5648,18590281,536457182720,28020,28740,28700,680,2.43,28860,840,3.0,27000,29420,1399-10-1
91,ريشمك,توليد و صادرات ريشمك,5596,7877726,515768651910,62643,65775,65775,3132,5.0,65472,2829,4.52,63550,65775,1399-10-1
92,ماديرا,صنايع ماشين هاي اداري ايران,5518,11203776,357649629307,31667,32292,31480,-187,-0.59,31922,255,0.81,30400,32900,1399-10-1
93,كپارس,كاشي‌ پارس‌,5509,3778461,588261815720,155060,147310,159570,4510,2.91,155690,630,0.41,147310,161100,1399-10-1
94,غشهد,شهد ايران ‌,5372,39980079,356846401390,9130,9040,9100,-30,-0.33,8930,-200,-2.19,8680,9390,1399-10-1
95,فاسمين,كالسيمين‌,5344,30149966,631357595930,20150,20300,20900,750,3.72,20940,790,3.92,19500,21150,1399-10-1
96,ولغدر,ليزينگ‌خودروغدير,5172,17947107,475263899280,26250,27000,26250,0,0.0,26480,230,0.88,25000,27560,1399-10-1
97,بجهرم,توسعه مولد نيروگاهي جهرم,5145,47133224,180810236484,3888,3875,3799,-89,-2.29,3836,-52,-1.34,3769,3967,1399-10-1
98,شپترو,پتروشيمي آبادان,4798,74002458,483777385604,6252,6564,6390,138,2.21,6537,285,4.56,6360,6564,1399-10-1
99,فروي,ذوب روي اصفهان,4751,4824000,335563274879,66569,68000,69897,3328,5.0,69561,2992,4.49,67000,69897,1399-10-1
100,خمحركه,نيرو محركه‌,4745,33561440,234711278440,7310,6960,6950,-360,-4.92,6990,-320,-4.38,6950,7260,1399-10-1
101,زقيام,كشت و دام قيام اصفهان,4736,7376713,303067404164,41720,39700,40450,-1270,-3.04,41084,-636,-1.52,39634,43400,1399-10-1
102,بكام,كارخانجات توليدي شهيد قندي,4715,64182426,281331549190,4290,4220,4500,210,4.9,4380,90,2.1,4150,4500,1399-10-1
103,شگل,گلتاش‌,4696,11637411,349327271590,30020,30800,29800,-220,-0.73,30020,0,0.0,29200,31100,1399-10-1
104,كفپارس,فرآورده‌هاي‌ نسوز پارس‌,4671,28002239,209374585550,7800,7490,7410,-390,-5.0,7480,-320,-4.1,7410,7750,1399-10-1
105,فنوال,نورد آلومينيوم‌,4642,12053808,337299202590,29240,27850,27780,-1460,-4.99,27980,-1260,-4.31,27780,29060,1399-10-1
106,ارفع,شركت آهن و فولاد ارفع,4622,24239584,397844600134,16974,17050,16200,-774,-4.56,16413,-561,-3.31,16126,17350,1399-10-1
107,غگل,گلوكوزان‌,4616,54928720,276284378400,4880,4940,5120,240,4.92,5030,150,3.07,4700,5120,1399-10-1
108,شسپا,نفت سپاهان,4460,9781665,288741123320,28980,30000,28780,-200,-0.69,29520,540,1.86,28310,30170,1399-10-1
109,ساوه,سيمان ساوه,4421,1885670,103866573393,56362,56000,54450,-1912,-3.39,55082,-1280,-2.27,53544,57900,1399-10-1
110,وسين,بيمه سينا,4411,26981198,716501704416,25499,26773,26350,851,3.34,26556,1057,4.15,25560,26773,1399-10-1
111,كچاد,معدني‌وصنعتي‌چادرملو,4386,12568410,259234030630,20980,20900,20160,-820,-3.91,20630,-350,-1.67,20010,21200,1399-10-1
112,وپاسار,بانك  پاسارگاد,4354,45616669,544944760000,11880,11880,12040,160,1.35,11950,70,0.59,11460,12050,1399-10-1
113,فسازان,غلتك سازان سپاهان,4299,13164849,525660601310,39610,39400,38630,-980,-2.47,39930,320,0.81,37630,41590,1399-10-1
114,خريخت,صنايع‌ريخته‌گري‌ايران‌,4250,47972465,204653935930,4440,4240,4280,-160,-3.6,4270,-170,-3.83,4220,4420,1399-10-1
115,ولساپا,ليزينگ رايان‌ سايپا,4242,52182180,232821932600,4470,4390,4450,-20,-0.45,4460,-10,-0.22,4310,4590,1399-10-1
116,چدن,توليدي چدن سازان,4217,21289720,843932779210,37790,39670,39670,1880,4.97,39640,1850,4.9,38090,39670,1399-10-1
117,اخابر,مخابرات ايران,4190,26345269,381821899500,14920,14850,14260,-660,-4.42,14490,-430,-2.88,14180,15230,1399-10-1
118,ثنوسا,نوسازي‌وساختمان‌تهران‌,4072,35513430,555213954580,16040,16650,15240,-800,-4.99,15630,-410,-2.56,15240,16780,1399-10-1
119,شغدير,پتروشيمي غدير,4037,8071960,575305678048,71951,71000,71300,-651,-0.9,71272,-679,-0.94,68690,74000,1399-10-1
120,ميدكو,هلدينگ صنايع  معدني خاورميانه,3995,12435626,384772116902,30207,30220,30900,693,2.29,30941,734,2.43,30209,31490,1399-10-1
121,وصنعت,سرمايه گذاري توسعه صنعت وتجارت,3982,23544993,180184315410,7810,7890,7530,-280,-3.59,7650,-160,-2.05,7420,7890,1399-10-1
122,فاذر,صنايع‌ آذرآب‌,3901,11570082,455391911060,37490,39360,39360,1870,4.99,39360,1870,4.99,39040,39360,1399-10-1
123,دماوند,توليد نيروي برق دماوند,3886,3739293,248839890511,67929,65100,65999,-1930,-2.84,66547,-1382,-2.03,65100,68970,1399-10-1
124,ختور,رادياتور ايران‌,3851,7509606,277980517770,38750,37000,36820,-1930,-4.98,37020,-1730,-4.46,36820,38450,1399-10-1
125,كمند,صندوق س. با درآمد ثابت كمند,3841,185924150,1875767328911,10084,10093,10090,6,0.06,10089,5,0.05,10087,10093,1399-10-1
126,ومعلم,بيمه معلم,3821,31816381,224693467280,7394,7025,7025,-369,-4.99,7062,-332,-4.49,7025,7320,1399-10-1
127,تنوينح,ح . تامين سرمايه نوين,3798,19073472,98881084639,4975,4950,5300,325,6.53,5184,209,4.2,4870,5350,1399-10-1
128,تپمپي,پمپ‌ سازي‌ ايران‌,3738,7458208,260947836100,35060,35500,35950,890,2.54,34990,-70,-0.2,33310,36400,1399-10-1
129,كحافظ,كاشي‌ وسراميك‌ حافظ‌,3724,13932839,237692458050,17870,17200,16980,-890,-4.98,17060,-810,-4.53,16980,17780,1399-10-1
130,لوتوس,تامين سرمايه لوتوس پارسيان,3716,26344411,439551230920,16200,15410,17010,810,5.0,16680,480,2.96,15410,17010,1399-10-1
131,كگل,معدني و صنعتي گل گهر,3685,18583177,337177277950,18540,18020,18400,-140,-0.76,18140,-400,-2.16,17950,18870,1399-10-1
132,بايكا,كارخانجات كابلسازي ‌ايران‌,3679,5688704,357504762799,61069,62900,62901,1832,3.0,62845,1776,2.91,62000,62901,1399-10-1
133,دشيمي,شيمي‌ داروئي‌ داروپخش‌,3664,5599924,457619242870,79490,83460,78960,-530,-0.67,81720,2230,2.81,77800,83460,1399-10-1
134,دزهراوي,داروسازي‌زهراوي‌,3661,15750105,212751840040,13120,12600,13770,650,4.95,13510,390,2.97,12600,13770,1399-10-1
135,كاوه,فولاد كاوه جنوب كيش,3658,17797795,407211355210,22750,22210,22500,-250,-1.1,22880,130,0.57,22130,23700,1399-10-1
136,ومعادن,توسعه‌معادن‌وفلزات‌,3615,20844512,298693472350,14440,14310,14180,-260,-1.8,14330,-110,-0.76,14000,14690,1399-10-1
137,وتوكا,سرمايه‌گذاري‌توكافولاد(هلدينگ,3475,28692605,403886063520,13490,13790,14160,670,4.97,14080,590,4.37,13400,14160,1399-10-1
138,حبندر,دريايي و کشتيراني خط دريابندر,3473,7146622,244764966588,34015,34680,34400,385,1.13,34249,234,0.69,32995,35035,1399-10-1
139,ورنا,سرمايه‌گذاري‌ رنا(هلدينگ‌,3428,24805779,204458911880,8350,8150,8250,-100,-1.2,8240,-110,-1.32,8000,8640,1399-10-1
140,ودي,بيمه  دي,3390,13637125,383961594201,27722,27721,28150,428,1.54,28156,434,1.57,26690,29000,1399-10-1
141,كوير,توليدي فولاد سپيد فراب كوير,3352,14315417,317605665020,21410,21000,22480,1070,5.0,22190,780,3.64,20420,22480,1399-10-1
142,غگيلا,شيرپاستوريزه پگاه گيلان,3352,898176,17507246592,18564,19492,19492,928,5.0,18867,303,1.63,19492,19492,1399-10-1
143,ثعمرا,عمران و توسعه شاهد,3262,13789494,198901961920,14387,13960,14800,413,2.87,14424,37,0.26,13830,14973,1399-10-1
144,نطرين,عطرين نخ قم,3255,19921505,223945044183,11070,10709,11623,553,5.0,11241,171,1.54,10517,11623,1399-10-1
145,فباهنر,مس‌ شهيدباهنر,3229,4489437,255001428750,54440,56970,57160,2720,5.0,56800,2360,4.34,54510,57160,1399-10-1
146,وهور,مديريت انرژي اميد  تابان هور,3224,6801392,298411030321,42831,44400,43270,439,1.02,43875,1044,2.44,42533,44972,1399-10-1
147,ثغرب,شركت سرمايه گذاري مسكن شمالغرب,3219,25729748,278289392331,11305,10740,10740,-565,-5.0,10816,-489,-4.33,10740,11160,1399-10-1
148,وايران,ليزينگ ايرانيان,3148,14812158,206855811200,14210,13700,13500,-710,-5.0,13970,-240,-1.69,13500,14500,1399-10-1
149,كرازي,كارخانجات‌توليدي‌شيشه‌رازي‌,3114,8797133,227314186880,24680,25500,25910,1230,4.98,25840,1160,4.7,24900,25910,1399-10-1
150,فسرب,ملي‌ سرب‌وروي‌ ايران‌,3079,1642104,237431663680,138360,144950,145270,6910,4.99,144590,6230,4.5,139100,145270,1399-10-1
151,خاذين,سايپاآذين‌,3066,29027406,186444463090,6690,6430,6360,-330,-4.93,6420,-270,-4.04,6360,6680,1399-10-1
152,ثنام,س ساختماني ب نام آوران مهندسي,3045,10237090,221422176025,21086,21718,21490,404,1.92,21629,543,2.58,20750,21718,1399-10-1
153,وسينا,بانك سينا,3020,28076884,323043888750,11050,11000,11600,550,4.98,11510,460,4.16,10700,11600,1399-10-1
154,وبانك,سرمايه گذاري گروه توسعه ملي,3012,20748793,210402572320,10060,10100,10070,10,0.1,10140,80,0.8,9800,10290,1399-10-1
155,بورس,بورس اوراق بهادار تهران,3010,4497811,288749326620,64110,63980,62640,-1470,-2.29,64200,90,0.14,62000,66180,1399-10-1
156,نوين,بيمه نوين,2939,19613800,166865770522,8689,8690,8350,-339,-3.9,8508,-181,-2.08,8300,8919,1399-10-1
157,رنيك,جنرال مكانيك,2935,13581036,377171533202,26608,26608,27938,1330,5.0,27772,1164,4.37,25940,27938,1399-10-1
158,كنور,توسعه معدني و صنعتي صبانور,2930,6338757,320195984310,48350,48350,50500,2150,4.45,50510,2160,4.47,47500,50760,1399-10-1
159,تبرك,گروه كارخانجات صنعتي تبرك,2903,10972913,285005783928,24901,24020,26146,1245,5.0,25974,1073,4.31,24020,26146,1399-10-1
160,رمپنا,گروه مپنا (سهامي عام),2895,18159869,369177327760,19450,19700,20420,970,4.99,20330,880,4.52,18750,20420,1399-10-1
161,وپست,پست بانك ايران,2873,17653453,336331803230,18200,18900,19110,910,5.0,19050,850,4.67,17620,19110,1399-10-1
162,تنوين,تامين سرمايه نوين,2872,65258182,460280738010,6730,6740,7060,330,4.9,7050,320,4.75,6740,7060,1399-10-1
163,شفن,پتروشيمي فناوران,2856,1064037,336699751120,325030,326500,310500,-14530,-4.47,316440,-8590,-2.64,308790,330690,1399-10-1
164,حسير,ريل سير كوثر,2855,10069756,176459527674,18304,17401,17389,-915,-5.0,17524,-780,-4.26,17389,18100,1399-10-1
165,ستران,سيمان‌ تهران‌,2815,6500138,221223545030,35210,33460,33450,-1760,-5.0,34030,-1180,-3.35,33450,35100,1399-10-1
166,رتاپ,تجارت الكترونيك  پارسيان,2776,11708418,98231795660,8390,8060,8540,150,1.79,8390,0,0.0,8040,8690,1399-10-1
167,غاذر,كشت‌وصنعت‌پياذر,2741,2902218,271357879350,89890,92990,94380,4490,4.99,93500,3610,4.02,86020,94380,1399-10-1
168,دتوليد,داروسازي توليد دارو,2740,5575558,199756475597,34581,36000,36310,1729,5.0,35827,1246,3.6,34590,36310,1399-10-1
169,وسبحان,سرمايه گذاري سبحان,2732,43279901,409411394859,9013,9463,9463,450,4.99,9460,447,4.96,9150,9463,1399-10-1
170,شپارس,بين‌ المللي‌ محصولات‌  پارس‌,2730,10060159,183813759480,19070,19070,18450,-620,-3.25,18270,-800,-4.2,18120,19070,1399-10-1
171,تماوند,تامين سرمايه دماوند,2696,14822367,236180806315,16065,15969,16074,9,0.06,15934,-131,-0.82,15262,16790,1399-10-1
172,كيسون,شركت كيسون,2692,15252323,235400440297,15737,15422,15265,-472,-3.0,15434,-303,-1.93,15265,16000,1399-10-1
173,بركت,گروه دارويي بركت,2672,10051180,258717373200,24520,25740,25740,1220,4.98,25740,1220,4.98,25740,25740,1399-10-1
174,پكوير,كوير تاير,2672,6138169,137689047840,22050,22500,22210,160,0.73,22430,380,1.72,21630,23000,1399-10-1
175,سمايه,بانك سرمايه,2639,13018923,101917349867,7914,8110,7677,-237,-2.99,7828,-86,-1.09,7677,8110,1399-10-1
176,خكاوه,سايپا ديزل,2639,32322539,164134713336,5037,4950,5188,151,3.0,5078,41,0.81,4887,5188,1399-10-1
177,غپينو,پارس‌ مينو,2617,31915725,341423187340,10210,10670,10720,510,5.0,10700,490,4.8,10310,10720,1399-10-1
178,خوساز,محورسازان‌ايران‌خودرو,2584,26635098,230782403690,8460,8060,8880,420,4.96,8660,200,2.36,8050,8880,1399-10-1
179,سرو,صندوق س سروسودمند مدبران-سهام,2582,2911603,214414293730,73350,72700,73890,540,0.74,73640,290,0.4,71400,74850,1399-10-1
180,ومهان,گروه توسعه مالي مهر آيندگان,2576,5844467,95765091882,16232,16150,16270,38,0.23,16386,154,0.95,15598,16767,1399-10-1
181,فجر,فولاد اميركبيركاشان,2574,5391320,352104542270,62300,65410,64410,2110,3.39,65310,3010,4.83,64080,65410,1399-10-1
182,غشهداب,كشت و صنعت شهداب ناب خراسان,2559,29283414,156578509857,5115,5080,5370,255,4.99,5347,232,4.54,5080,5370,1399-10-1
183,غويتا,ويتانا,2545,7063530,361796151488,48919,50400,51364,2445,5.0,51220,2301,4.7,50100,51364,1399-10-1
184,خفنر,فنرسازي‌خاور,2541,8931546,172586151720,19470,18500,20440,970,4.98,19320,-150,-0.77,18500,20440,1399-10-1
185,وملل,اعتباري ملل,2519,14005666,227714673433,16098,16070,15950,-148,-0.92,16259,161,1.0,15800,16550,1399-10-1
186,ددام,داروسازي زاگرس فارمد پارس,2481,8958743,148861461300,16270,15740,17080,810,4.98,16620,350,2.15,15460,17080,1399-10-1
187,خمهر,مهركام‌پارس‌,2459,31576961,218500563460,7230,6900,6920,-310,-4.29,6920,-310,-4.29,6870,7160,1399-10-1
188,وشهر,بانك شهر,2448,22044541,154212346429,7042,7190,6982,-60,-0.85,6995,-47,-0.67,6775,7190,1399-10-1
189,غسالم,سالمين‌,2445,23569369,160483459460,6510,6820,6830,320,4.92,6810,300,4.61,6540,6830,1399-10-1
190,شپلي,پلي اكريل ايران,2432,38563750,392938626175,9707,10192,10192,485,5.0,10189,482,4.97,9900,10192,1399-10-1
191,شكلر,نيروكلر,2430,3211855,202381106070,62380,63500,62290,-90,-0.14,63010,630,1.01,61000,64700,1399-10-1
192,مدير,ص.س.مديريت ثروت ص.بازنشستگي-س,2400,14160941,160891735458,11394,11350,11190,-204,-1.79,11362,-32,-0.28,11120,11640,1399-10-1
193,وساخت,سرمايه‌ گذاري‌ ساختمان‌ايران‌,2386,4392260,277419608560,60310,60500,63320,3010,4.99,63160,2850,4.73,60500,63320,1399-10-1
194,بالاس,مهندسي ساختمان تاسيسات راه آهن,2344,2585599,126689763375,51284,48750,48810,-2474,-4.82,48998,-2286,-4.46,48720,50460,1399-10-1
195,آگاس,صندوق س.هستي بخش آگاه-س,2341,2198500,166980817683,75564,75000,75720,156,0.21,75952,388,0.51,74720,76739,1399-10-1
196,ونفت,سرمايه‌گذاري‌ صنعت‌ نفت‌,2337,10027145,173228113740,17700,17340,17060,-640,-3.62,17280,-420,-2.37,16840,17980,1399-10-1
197,اميد,تامين سرمايه اميد,2245,12790628,149567060150,12140,11700,11700,-440,-3.62,11690,-450,-3.71,11540,12340,1399-10-1
198,كساپا,سايپاشيشه‌,2234,5624182,202714113700,34770,35630,36500,1730,4.98,36040,1270,3.65,34770,36500,1399-10-1
199,وبوعلي,سرمايه‌گذاري‌بوعلي‌,2228,15522986,111135843930,7160,7200,7060,-100,-1.4,7160,0,0.0,6910,7340,1399-10-1
200,وكار,بانك‌ كارآفرين‌,2224,29368980,132747182670,4550,4370,4440,-110,-2.42,4520,-30,-0.66,4370,4690,1399-10-1
201,فالوم,آلومتك‌,2218,8024375,229175658721,28542,28881,29398,856,3.0,28560,18,0.06,27686,29398,1399-10-1
202,پلاسك,پلاسكوكار,2192,12029360,98644259590,8530,8320,8160,-370,-4.34,8200,-330,-3.87,8110,8650,1399-10-1
203,امين يكم,صندوق درآمد ثابت امين يكم فردا,2173,59763063,605297550299,10278,10126,10131,-147,-1.43,10128,-150,-1.46,10117,10155,1399-10-1
204,لخانه,لوازم‌ خانگي‌ پارس‌,2157,2342628,124861758427,53458,51855,54150,692,1.29,53300,-158,-0.3,51855,54800,1399-10-1
205,قشرين,قند شيرين خراسان,2155,8982509,192820567580,20904,21390,21531,627,3.0,21466,562,2.69,20400,21531,1399-10-1
206,زكوثر,سرمايه گذاري كشاورزي كوثر,2125,4549251,117034716630,24570,25700,25790,1220,4.97,25730,1160,4.72,24980,25790,1399-10-1
207,كترام,توليدي‌ كاشي‌ تكسرام‌,2117,8526268,327905989690,36630,38460,38460,1830,5.0,38460,1830,5.0,38040,38460,1399-10-1
208,قچار,فراوردههاي غذايي وقند چهارمحال,2109,4506663,326589748923,70486,74010,67300,-3186,-4.52,72468,1982,2.81,66962,74010,1399-10-1
209,كروي,توسعه‌ معادن‌ روي‌ ايران‌,2109,5569250,202259938800,34850,35480,36590,1740,4.99,36320,1470,4.22,34530,36590,1399-10-1
210,حفارس,حمل و نقل بين المللي خليج فارس,2106,22706429,98509604920,4460,4360,4240,-220,-4.93,4340,-120,-2.69,4240,4540,1399-10-1
211,غمينوح,ح . شركت صنايع غذايي مينو شرق,2071,6767609,78130019585,11647,11530,11130,-517,-4.44,11545,-102,-0.88,11110,12190,1399-10-1
212,بساما,بيمه سامان,2068,4536303,148878073868,33804,32114,33000,-804,-2.38,32819,-985,-2.91,32114,34350,1399-10-1
213,ثپرديس,سرمايه گذاري مسكن پرديس,2066,11810903,125819122388,10348,10700,10865,517,5.0,10653,305,2.95,10100,10865,1399-10-1
214,خشرق,الكتريك‌ خودرو شرق‌,2064,7840549,170350745300,22440,21330,21320,-1120,-4.99,21730,-710,-3.16,21320,23190,1399-10-1
215,پكرمان,گروه‌ صنعتي‌ بارز,2063,5550737,198618455470,34420,36300,35390,970,2.82,35780,1360,3.95,34490,36700,1399-10-1
216,مرقام,ايران‌ارقام‌,2063,6639447,148660211000,23220,22590,22730,-490,-2.11,22390,-830,-3.57,22060,23290,1399-10-1
217,ما,بيمه  ما,1993,20789855,198196390550,9150,9150,9590,440,4.81,9530,380,4.15,9100,9600,1399-10-1
218,خفناور,مهندسي صنعتي روان فن آور,1983,7889168,200079424604,25228,24472,25984,756,3.0,25361,133,0.53,24472,25984,1399-10-1
219,سفارس,سيمان فارس و خوزستان,1974,5963710,106875577010,17690,17350,17820,130,0.73,17920,230,1.3,17200,18390,1399-10-1
220,اتكاي,بيمه اتكايي ايرانيان,1969,9587517,171968868300,17434,17910,18305,871,5.0,17937,503,2.89,17350,18305,1399-10-1
221,وآذر,سرمايه‌گذاري‌توسعه‌آذربايجان‌,1953,1345661,134923417970,105130,105000,99880,-5250,-4.99,100270,-4860,-4.62,99880,105000,1399-10-1
222,غشان,شيرپاستوريزه‌پگاه‌خراسان‌,1942,20148282,169024949600,8060,7720,8460,400,4.96,8390,330,4.09,7710,8460,1399-10-1
223,زگلدشت,كشت و دام گلدشت نمونه اصفهان,1935,2532745,119477752725,45235,45900,47496,2261,5.0,47173,1938,4.28,45000,47496,1399-10-1
224,وآوا,سرمايه گذاري آوا نوين,1890,9192254,75258353652,8532,8190,8106,-426,-4.99,8187,-345,-4.04,8106,8492,1399-10-1
225,ركيش,كارت اعتباري ايران كيش,1873,8188023,168337274120,20590,21000,20500,-90,-0.44,20560,-30,-0.15,20050,21400,1399-10-1
226,ثباغ,شهر سازي و خانه سازي باغميشه,1870,4922589,108962495384,23133,22000,21977,-1156,-5.0,22135,-998,-4.31,21977,23100,1399-10-1
227,پارسيان,بيمه پارسيان,1862,14487810,216941079440,14350,14550,15060,710,4.95,14970,620,4.32,14400,15060,1399-10-1
228,دتوزيع,توزيع دارو پخش,1859,3928400,113963358415,28078,27990,29481,1403,5.0,29010,932,3.32,27000,29481,1399-10-1
229,وپترو,سرمايه‌گذاري صنايع پتروشيمي‌,1856,5793926,114466582740,19310,19970,19890,580,3.0,19760,450,2.33,19050,20100,1399-10-1
230,ثمسكن,سرمايه‌گذاري‌ مسكن‌,1851,16787719,102079055030,5970,5860,6060,90,1.51,6080,110,1.84,5810,6260,1399-10-1
231,سشرق,سيمان‌ شرق‌,1843,16240955,115827424070,7110,6980,7160,50,0.7,7130,20,0.28,6900,7300,1399-10-1
232,قشير,قند شيروان قوچان و بجنورد,1822,4228425,134367836556,30561,30000,32089,1528,5.0,31777,1216,3.98,29190,32089,1399-10-1
233,تاپكيش,تجارت الكترونيك پارسيان كيش,1805,4342421,123292942894,27124,27666,28480,1356,5.0,28393,1269,4.68,27666,28480,1399-10-1
234,فولاي,صنايع فولاد آلياژي يزد,1795,3230593,127301487737,37620,39450,39501,1881,5.0,39405,1785,4.74,38000,39501,1399-10-1
235,تيپيكو,سرمايه گذاري دارويي تامين,1791,2602875,156031476980,57990,55500,60880,2890,4.98,59950,1960,3.38,55500,60880,1399-10-1
236,لابسا,آبسال‌,1766,2963503,132809349600,42820,44790,44960,2140,5.0,44810,1990,4.65,41000,44960,1399-10-1
237,پارسان,گسترش نفت و گاز پارسيان,1762,9182678,218444024830,23440,23000,24150,710,3.03,23790,350,1.49,23000,24200,1399-10-1
238,كطبس,ذغال‌سنگ‌ نگين‌ ط‌بس‌,1760,2948805,202851640070,66280,66670,68300,2020,3.05,68790,2510,3.79,63210,69590,1399-10-1
239,وبيمه,سرمايه‌ گذاري‌ صنعت‌ بيمه‌,1759,18303531,62528568530,3520,3410,3350,-170,-4.83,3420,-100,-2.84,3350,3600,1399-10-1
240,وهنر,گروه توسعه هنر ايران,1745,21737322,111993646961,5089,5000,5241,152,2.99,5152,63,1.24,4937,5241,1399-10-1
241,ضخود1044,اختيارخ خودرو-4000-1399/10/07,1739,94222,1591941000,47,33,7,-40,-85.11,17,-30,-63.83,5,34,1399-10-1
242,فلامي,لاميران‌,1734,2564333,121944410500,46300,44030,48610,2310,4.99,47550,1250,2.7,44030,48610,1399-10-1
243,فمراد,آلومراد,1723,1469323,221258427600,143530,150700,150700,7170,5.0,150590,7060,4.92,147000,150700,1399-10-1
244,وپسا,س. پتروشيمي ساختمان  خليج فارس,1718,32782402,122928805232,3708,3601,3819,111,2.99,3750,42,1.13,3597,3819,1399-10-1
245,حتايد,تايدواترخاورميانه,1713,6742414,153650251830,22580,22150,23700,1120,4.96,22790,210,0.93,21470,23700,1399-10-1
246,شخارك,پتروشيمي‌ خارك‌,1710,2925505,142179473430,48200,49000,47610,-590,-1.22,48600,400,0.83,47100,49890,1399-10-1
247,سصوفي,سيمان‌ صوفيان‌,1709,5155448,77446875110,15310,14630,15020,-290,-1.89,15020,-290,-1.89,14550,15700,1399-10-1
248,وبشهر,توسعه‌ صنايع‌ بهشهر(هلدينگ,1706,11294191,195236114330,16630,17220,17460,830,4.99,17290,660,3.97,16300,17460,1399-10-1
249,پاكشو,گروه صنعتي پاكشو,1692,1440960,118504017940,82620,82760,82000,-620,-0.75,82240,-380,-0.46,80200,84380,1399-10-1
250,اعتلا,شركت سرمايه گذاري اعتلاء البرز,1687,10271996,105433113406,10022,9650,10523,501,5.0,10264,242,2.41,9550,10523,1399-10-1
251,تاصيكو,سرمايه گذاري صدرتامين,1674,11842723,137447063800,11490,11280,11740,250,2.18,11610,120,1.04,11200,11910,1399-10-1
252,فرآور,فرآوري‌موادمعدني‌ايران‌,1673,7196423,220534439310,29280,29700,30740,1460,4.99,30650,1370,4.68,29500,30740,1399-10-1
253,دعبيد,لابراتوارداروسازي‌  دكترعبيدي‌,1672,3104503,99768774080,31100,29910,32650,1550,4.98,32140,1040,3.34,29910,32650,1399-10-1
254,خاهن,آهنگري‌ تراكتورسازي‌ ايران‌,1613,4415821,177013286030,40080,39300,40370,290,0.72,40090,10,0.02,39000,41000,1399-10-1
255,وگردشح,ح . بانك گردشگري,1590,149990000,2031621542298,13127,13914,13600,473,3.6,13545,418,3.18,13400,13914,1399-10-1
256,غپاك,لبنيات‌ پاك‌,1578,7955406,126319708220,15910,16300,15860,-50,-0.31,15880,-30,-0.19,15200,16430,1399-10-1
257,شمواد,توليد مواداوليه الياف مصنوعي,1572,1818599,98109767329,54550,53010,56186,1636,3.0,53948,-602,-1.1,52914,56186,1399-10-1
258,ثرود,سرمايه‌گذاري مسكن زاينده رود,1569,9269455,99146810058,10301,9900,10816,515,5.0,10696,395,3.83,9786,10816,1399-10-1
259,كگاز,شيشه‌ و گاز,1555,2659162,61387686440,22920,22330,23000,80,0.35,23090,170,0.74,22330,23700,1399-10-1
260,غنوش,نوش‌ مازندران‌,1552,2761328,166782562150,57770,59130,60650,2880,4.99,60400,2630,4.55,58010,60650,1399-10-1
261,دتوزيعح,ح . توزيع دارو پخش,1547,2506333,62554987674,24032,23507,25233,1201,5.0,24959,927,3.86,23032,25233,1399-10-1
262,سرچشمه,سرمايه گذاري مس سرچشمه,1547,9554406,83105254342,8705,9000,8590,-115,-1.32,8698,-7,-0.08,8423,9000,1399-10-1
263,سپاها,سيمان‌سپاهان‌,1546,10329500,97035578620,8990,9290,9430,440,4.89,9390,400,4.45,9050,9430,1399-10-1
264,شتوكا,توكا رنگ فولاد سپاهان,1542,1723060,76399655323,42889,42000,45033,2144,5.0,44340,1451,3.38,41200,45033,1399-10-1
265,تايرا,تراكتورسازي‌ايران‌,1535,14863496,461864298280,29620,31000,31100,1480,5.0,31070,1450,4.9,30100,31100,1399-10-1
266,والبر,سرمايه‌ گذاري‌ البرز(هلدينگ‌,1523,11769045,240824201610,19550,19870,20520,970,4.96,20460,910,4.65,19000,20520,1399-10-1
267,وسپه,سرمايه‌گذاري‌ سپه‌,1504,7614056,113839717840,14470,14020,14780,310,2.14,14950,480,3.32,14010,15190,1399-10-1
268,غمارگ,مارگارين‌,1503,3647654,153877265250,40670,39020,42700,2030,4.99,42190,1520,3.74,39020,42700,1399-10-1
269,اعتماد,صندوق س.اعتماد آفرين پارسيان-د,1501,42620570,1446190805860,33919,33939,33940,21,0.06,33932,13,0.04,33929,33940,1399-10-1
270,ارزش,صندوق س ارزش آفرين بيدار-سهام,1497,9807238,108800255220,10990,10970,11090,100,0.91,11090,100,0.91,10800,11230,1399-10-1
271,كيميا,معدني كيمياي زنجان گستران,1479,3517417,144388585106,39106,41061,41061,1955,5.0,41050,1944,4.97,39200,41061,1399-10-1
272,افق,فروشگاههاي زنجيره اي افق كوروش,1465,887398,73222414580,82080,84000,82020,-60,-0.07,82400,320,0.39,81200,84030,1399-10-1
273,لسرما,سرما آفرين‌,1461,2475348,76485291250,31030,31980,30130,-900,-2.9,30900,-130,-0.42,30000,31980,1399-10-1
274,چافست,افست‌,1461,2948048,62905216050,22170,21250,21070,-1100,-4.96,21340,-830,-3.74,21070,22380,1399-10-1
275,قزوين,كارخانجات‌ قند قزوين‌,1460,3779890,165022907080,41870,41140,43960,2090,4.99,43660,1790,4.28,41140,43960,1399-10-1
276,حريل,ريل پردازسير,1459,20023653,106261316428,5065,5318,5318,253,5.0,5307,242,4.78,5218,5318,1399-10-1
277,غبهنوش,بهنوش‌ ايران‌,1456,742170,121812362100,172760,164130,164130,-8630,-5.0,164130,-8630,-5.0,164130,164130,1399-10-1
278,پتاير,ايران‌ تاير,1451,708385,137185839100,203850,193660,193660,-10190,-5.0,193660,-10190,-5.0,193660,193660,1399-10-1
279,آريان,سرمايه گذاري پارس آريان,1445,17643604,285698742948,16049,16200,15910,-139,-0.87,16193,144,0.9,15811,16389,1399-10-1
280,وگستر,گسترش سرمايه گذاري ايرانيان,1441,5186004,129611279907,23829,25020,25020,1191,5.0,24993,1164,4.88,24100,25020,1399-10-1
281,تابا,تابان نيرو سپاهان,1440,2735922,96888865068,35243,35700,36300,1057,3.0,35414,171,0.49,34186,36300,1399-10-1
282,شصدف,صنعتي دوده فام,1438,48178,1264287076,24993,26242,26242,1249,5.0,25023,30,0.12,26242,26242,1399-10-1
283,خمحور,توليدمحورخودرو,1437,1538832,124010116690,82210,78190,79000,-3210,-3.9,80590,-1620,-1.97,78190,83960,1399-10-1
284,شبهرن,نفت‌ بهران‌,1411,1639448,94817844040,58630,56250,57110,-1520,-2.59,57840,-790,-1.35,56010,59990,1399-10-1
285,بميلا,توسعه بازرگاني آهن وفولادميلاد,1402,4850322,94146876862,19635,19950,18680,-955,-4.86,19410,-225,-1.15,18654,20616,1399-10-1
286,زبينا,كشاورزي و دامپروري بينالود,1400,2515889,129244976867,49295,49890,51759,2464,5.0,51371,2076,4.21,49012,51759,1399-10-1
287,ساربيل,سيمان آرتا اردبيل,1398,1380754,68613987360,52030,49430,49430,-2600,-5.0,49690,-2340,-4.5,49430,51000,1399-10-1
288,ثتران,سرمايه گذاري مسكن تهران,1389,13949586,69812147207,5085,5120,4923,-162,-3.19,5005,-80,-1.57,4861,5163,1399-10-1
289,وبهمن,سرمايه‌گذاري‌بهمن‌,1361,6013864,121191857860,20060,19370,20080,20,0.1,20150,90,0.45,19060,20800,1399-10-1
290,وليز,ليزينگ‌ايران‌,1351,7605088,67894147460,9320,9000,8860,-460,-4.94,8930,-390,-4.18,8860,9200,1399-10-1
291,وآرين,شركت توسعه اقتصادي آرين,1328,10437138,54761547340,5239,5178,5200,-39,-0.74,5247,8,0.15,5178,5335,1399-10-1
292,اتكام,شركت بيمه اتكايي امين,1325,10767417,80110488036,7190,7023,7549,359,4.99,7440,250,3.48,6860,7549,1399-10-1
293,تسه9908,امتياز تسهيلات مسكن آبان99,1310,30052,17915584638,597030,592222,590000,-7030,-1.18,596153,-877,-0.15,585000,610000,1399-10-1
294,سدور,سيمان‌ دورود,1295,7338247,78407083070,10210,10500,10720,510,5.0,10680,470,4.6,10350,10720,1399-10-1
295,شوينده,مديريت صنعت شوينده ت.ص.بهشهر,1289,4175576,163897677770,37890,37880,39780,1890,4.99,39250,1360,3.59,36500,39780,1399-10-1
296,آپ,آسان پرداخت پرشين,1268,2829759,52540927290,18760,18970,18320,-440,-2.35,18570,-190,-1.01,17970,19180,1399-10-1
297,كهمدا,شيشه‌ همدان‌,1248,4438832,54566129810,12410,12260,11800,-610,-4.92,12290,-120,-0.97,11790,12710,1399-10-1
298,كلوند,كاشي‌ الوند,1246,5491773,169690972140,29470,30700,30940,1470,4.99,30900,1430,4.85,29710,30940,1399-10-1
299,كويرح,ح. توليدي فولاد سپيد فراب كوير,1238,13483495,236936639040,17500,19250,17520,20,0.11,17570,70,0.4,17250,19250,1399-10-1
300,سنير,سيمان‌ سفيد ني‌ريز,1238,810002,79805777910,94000,98450,98700,4700,5.0,98530,4530,4.82,96930,98700,1399-10-1
301,كاذرح,ح . فرآورده‌هاي‌نسوزآذر,1236,3527595,73475452680,20210,20300,20850,640,3.17,20830,620,3.07,20290,21200,1399-10-1
302,جم,پتروشيمي جم,1232,2985956,144950700840,48740,47100,47410,-1330,-2.73,48540,-200,-0.41,47100,50020,1399-10-1
303,كمرجان,بازرگاني و توليدي مرجان كار,1219,875295,67360661371,73580,77200,77259,3679,5.0,76958,3378,4.59,74100,77259,1399-10-1
304,كرماشا,صنايع پتروشيمي كرمانشاه,1217,2795913,117431413040,42920,41600,42100,-820,-1.91,42000,-920,-2.14,41170,44000,1399-10-1
305,همراه,شركت ارتباطات سيار ايران,1208,1662711,55682760590,33990,34430,33730,-260,-0.76,33700,-290,-0.85,32310,34450,1399-10-1
306,آ س پ,آ.س.پ,1201,4502475,50887715230,11579,11750,11060,-519,-4.48,11302,-277,-2.39,11001,11750,1399-10-1
307,سپ,پرداخت الكترونيك سامان كيش,1200,3062600,63809150350,21070,20200,21070,0,0.0,20830,-240,-1.14,20200,21360,1399-10-1
308,لكما,كارخانجات‌مخابراتي‌ايران‌,1188,5610573,42500589446,7803,7569,7569,-234,-3.0,7575,-228,-2.92,7569,7748,1399-10-1
309,وسديد,گروه ‌صنعتي‌سديد,1170,6207917,170705301666,26698,27498,27498,800,3.0,27498,800,3.0,27498,27498,1399-10-1
310,قجام,فرآوردههاي غذايي وقندتربت‌جام‌,1169,7548497,92600295056,12327,12600,12289,-38,-0.31,12267,-60,-0.49,11992,12600,1399-10-1
311,خكرمان,گروه اقتصادي كرمان خودرو,1149,13649447,79690644570,5707,5828,5878,171,3.0,5838,131,2.3,5536,5878,1399-10-1
312,سپح,ح . پرداخت الكترونيك سامان كيش,1149,1957292,39349935070,19880,20200,20210,330,1.66,20100,220,1.11,19400,20250,1399-10-1
313,وسكاب,س.ص.بازنشستگي كاركنان بانكها,1143,10816628,72864273090,6640,6590,6840,200,3.01,6740,100,1.51,6590,6900,1399-10-1
314,پرديس,سرمايه گذاري پرديس,1138,7302614,53003958400,7310,7310,7160,-150,-2.05,7260,-50,-0.68,7040,7550,1399-10-1
315,پخش,پخش البرز,1137,3181518,142996732770,43415,45300,45585,2170,5.0,44946,1531,3.53,42580,45585,1399-10-1
316,وخاور,بانك خاورميانه,1132,4784062,48549957930,10090,10500,9920,-170,-1.68,10140,50,0.5,9910,10500,1399-10-1
317,واتي,سرمايه‌ گذاري‌ آتيه‌ دماوند,1125,4600107,69285735830,14920,15000,15000,80,0.54,15060,140,0.94,14320,15400,1399-10-1
318,سبهان,سيمان‌ بهبهان‌,1117,546483,38888078260,70080,71100,72350,2270,3.24,70870,790,1.13,68000,72960,1399-10-1
319,سمازن,سيمان‌مازندران‌,1106,5144512,54367407280,10430,10210,10650,220,2.11,10570,140,1.34,10210,10800,1399-10-1
320,دفارا,داروسازي‌ فارابي‌,1103,1890505,128739530990,65830,67100,69120,3290,5.0,68100,2270,3.45,65880,69120,1399-10-1
321,بخاور,بيمه زندگي خاورميانه,1100,5700321,54599163798,9590,9690,9410,-180,-1.88,9578,-12,-0.13,9200,9843,1399-10-1
322,مبين,مبين انرژي خليج فارس,1096,5173285,82965446690,16550,17100,16230,-320,-1.93,16040,-510,-3.08,15730,17100,1399-10-1
323,فايرا,آلومينيوم‌ايران‌,1094,3009020,79589894690,27190,25840,25870,-1320,-4.85,26450,-740,-2.72,25840,27500,1399-10-1
324,دلقما,دارويي‌ لقمان‌,1089,2135612,62776807190,28170,28960,29570,1400,4.97,29400,1230,4.37,28170,29570,1399-10-1
325,ختراكح,ح . ريخته‌گري‌ تراكتورسازي‌,1085,3145299,49098351850,14380,15200,15820,1440,10.01,15610,1230,8.55,14770,15820,1399-10-1
326,ولصنم,ليزينگ‌صنعت‌ومعدن‌,1076,11015815,119887482190,10400,10540,10920,520,5.0,10880,480,4.62,10500,10920,1399-10-1
327,فلوله,لوله‌وماشين‌سازي‌ايران‌,1075,4649520,111997047220,23120,22850,24270,1150,4.97,24090,970,4.2,22510,24270,1399-10-1
328,شكربن,كربن‌ ايران‌,1071,943361,77624776850,81340,82590,80800,-540,-0.66,82290,950,1.17,79200,84400,1399-10-1
329,دكوثر,داروسازي‌ كوثر,1071,2540265,64593740650,24410,24220,25630,1220,5.0,25430,1020,4.18,24220,25630,1399-10-1
330,شپديس,پتروشيمي پرديس,1071,1432409,147261562680,102810,101120,101810,-1000,-0.97,102810,0,0.0,101120,103970,1399-10-1
331,داسوه,داروسازي‌ اسوه‌,1070,2661989,79608316510,28810,30190,30250,1440,5.0,29910,1100,3.82,29200,30250,1399-10-1
332,دسبحان,سبحان دارو,1067,4095455,103923374160,24350,25560,25560,1210,4.97,25380,1030,4.23,24600,25560,1399-10-1
333,نمرينو,ايران‌ مرينوس‌,1061,908373,53645137790,60410,57390,57500,-2910,-4.82,59060,-1350,-2.23,57390,62900,1399-10-1
334,سخوز,سيمان خوزستان,1058,2219313,53465222110,24110,23150,24250,140,0.58,24090,-20,-0.08,22910,25200,1399-10-1
335,خفولا,خدمات فني فولاد يزد,1053,1911699,86364491055,44136,45460,44000,-136,-0.31,45177,1041,2.36,43200,45460,1399-10-1
336,شاراك,پتروشيمي شازند,1028,3249259,87128593490,26860,26300,26500,-360,-1.34,26810,-50,-0.19,26300,27380,1399-10-1
337,دالبر,البرزدارو,1025,3053911,73268665930,23170,24130,24320,1150,4.96,23990,820,3.54,22910,24320,1399-10-1
338,مارون,پتروشيمي مارون,1023,616883,98045995569,151533,159109,159109,7576,5.0,158018,6485,4.28,152670,159109,1399-10-1
339,دارا,صندوق س. دارا الگوريتم-د,1022,42812828,427375670121,10090,9980,9977,-113,-1.12,9982,-108,-1.07,9950,9996,1399-10-1
340,كسرام,پارس‌ سرام‌,1014,9855919,108809345760,10520,11040,11040,520,4.94,11040,520,4.94,11040,11040,1399-10-1
341,دسبحا,گروه دارويي سبحان,1007,2606326,63075380960,23520,22500,24680,1160,4.93,24200,680,2.89,22500,24690,1399-10-1
342,بپاس,بيمه پاسارگاد,996,1971179,199861552564,96572,101400,101400,4828,5.0,101392,4820,4.99,97000,101400,1399-10-1
343,سيدكو,سرمايه گذاري توسعه صنايع سيمان,987,8282062,69188209740,7980,8330,8370,390,4.89,8350,370,4.64,8010,8370,1399-10-1
344,سكرد,سيمان كردستان,975,6990648,58869768040,8390,8390,8600,210,2.5,8420,30,0.36,8020,8640,1399-10-1
345,شپاس,نفت پاسارگاد,973,2425330,57001767292,24451,23300,23229,-1222,-5.0,23503,-948,-3.88,23229,24430,1399-10-1
346,طلا,صندوق س.پشتوانه طلاي لوتوس,971,388983,33098946983,84357,85190,84300,-57,-0.07,85091,734,0.87,84210,86222,1399-10-1
347,شپاكسا,پاكسان‌,970,2848907,94355721520,32210,31200,33820,1610,5.0,33120,910,2.83,31200,33820,1399-10-1
348,فبيرا,بسته‌ بندي‌ ايران‌,961,11852207,55943553479,4584,4721,4721,137,2.99,4720,136,2.97,4650,4721,1399-10-1
349,دپارس,پارس‌ دارو,959,565593,61661551950,107190,109110,110900,3710,3.46,109020,1830,1.71,105500,112140,1399-10-1
350,دمعيار,صندوق س. توازن معيار-د,956,50422266,504476143574,10154,10010,10011,-143,-1.41,10005,-149,-1.47,10003,10011,1399-10-1
351,دسانكو,داروسازي سبحان انكولوژي,955,4605309,85015980386,17605,18485,18485,880,5.0,18460,855,4.86,18051,18485,1399-10-1
352,شفارا,پتروشيمي فارابي,953,16209985,78955526984,4826,4682,4970,144,2.98,4871,45,0.93,4682,4970,1399-10-1
353,سيمرغ,سيمرغ,951,3949248,83233895270,20300,20690,21310,1010,4.98,21080,780,3.84,19750,21310,1399-10-1
354,خديزل,بهمن  ديزل,945,1667856,88403909053,53731,51400,52000,-1731,-3.22,53005,-726,-1.35,51400,56240,1399-10-1
355,اوان,مبين وان كيش,940,1246122,67691277951,52466,53000,55089,2623,5.0,54322,1856,3.54,52120,55089,1399-10-1
356,پاسا,ايران‌ياساتايرورابر,940,5129111,146831352230,27410,27500,28780,1370,5.0,28630,1220,4.45,27500,28780,1399-10-1
357,دتماد,توليدمواداوليه‌داروپخش‌,939,2439698,128775273210,50280,52790,52790,2510,4.99,52780,2500,4.97,51510,52790,1399-10-1
358,سامان,بانك سامان,934,17819503,241685734710,12918,13563,13563,645,4.99,13563,645,4.99,13536,13563,1399-10-1
359,كهمداح,ح . شيشه‌ همدان‌,929,3792870,39632306270,10600,10300,10200,-400,-3.77,10450,-150,-1.42,9920,10900,1399-10-1
360,كمنگنز,معادن‌منگنزايران‌,927,831948,89683665640,103360,108000,108520,5160,4.99,107800,4440,4.3,104230,108520,1399-10-1
361,خودكفا,اقتصادي و خودكفايي آزادگان,925,8112330,319885396560,38284,39432,39432,1148,3.0,39432,1148,3.0,39432,39432,1399-10-1
362,زنگان,صنعت روي زنگان,920,515076,52155801887,99390,103500,102700,3310,3.33,101258,1868,1.88,98900,104000,1399-10-1
363,كاردان,صندوق س تجارت شاخصي كاردان,914,430001,78608972990,183250,183120,182440,-810,-0.44,182810,-440,-0.24,179500,185500,1399-10-1
364,خزر,فنرسازي‌زر,908,3421451,104012110400,28960,30400,30400,1440,4.97,30400,1440,4.97,30400,30400,1399-10-1
365,دكيمي,كيميدارو,892,2521514,69204014590,26430,25720,27750,1320,4.99,27450,1020,3.86,25400,27750,1399-10-1
366,شاوان,پالايش نفت لاوان,891,523557,54558568956,103910,106875,101980,-1930,-1.86,104208,298,0.29,101010,108000,1399-10-1
367,سرود,سيمان‌شاهرود,880,6545943,118196945890,17400,16910,18270,870,5.0,18060,660,3.79,16540,18270,1399-10-1
368,ثشرق,سرمايه گذاري مسكن شمال شرق,876,11336333,71944934520,6070,6260,6370,300,4.94,6350,280,4.61,6100,6370,1399-10-1
369,غگلپا,شير پاستوريزه پگاه گلپايگان,875,680784,49618436795,70050,72080,73552,3502,5.0,72773,2723,3.89,68000,73552,1399-10-1
370,فلات,گروه صنايع معادن فلات ايرانيان,870,3504829,55246711311,15339,15699,15799,460,3.0,15763,424,2.76,15220,15799,1399-10-1
371,شساخت,مهندسي و ساختمان صنايع نفت,857,3083331,150765596740,50157,48653,48653,-1504,-3.0,48897,-1260,-2.51,48653,51190,1399-10-1
372,ولشرق,ليزينگ ايران و شرق,856,7430865,59922376924,7721,7890,8107,386,5.0,8064,343,4.44,7750,8107,1399-10-1
373,بزاگرس,نيروگاه زاگرس كوثر,851,5059325,62397216360,12787,12800,12160,-627,-4.9,12333,-454,-3.55,12160,12800,1399-10-1
374,لخزر,پارس‌ خزر,851,587910,124997622290,207630,202030,218010,10380,5.0,212610,4980,2.4,197260,218010,1399-10-1
375,شبصير,توليدات پتروشيمي قائد بصير,850,1010832,130168132283,129095,126000,128550,-545,-0.42,128773,-322,-0.25,126000,131689,1399-10-1
376,پارس,پتروشيمي پارس,849,571260,92568132190,161030,161040,162350,1320,0.82,161910,880,0.55,156800,164980,1399-10-1
377,فافزا,فولاد افزا سپاهان,848,1400036,64732021539,44092,45990,46296,2204,5.0,46236,2144,4.86,44210,46296,1399-10-1
378,غشوكو,شوكو پارس,844,832748,38923872195,47246,48300,45829,-1417,-3.0,46741,-505,-1.07,45829,48300,1399-10-1
379,ثالوند,سرمايه گذاري مسكن الوند,839,3372045,50569587847,15308,15000,14970,-338,-2.21,14997,-311,-2.03,14710,15450,1399-10-1
380,درازك,دارويي‌ رازك‌,835,1592824,71877182420,43370,43900,45530,2160,4.98,45130,1760,4.06,42000,45530,1399-10-1
381,زمگسا,كشاورزي‌ ودامپروي‌ مگسال‌,834,1644124,99847650520,63920,60730,60730,-3190,-4.99,60730,-3190,-4.99,60730,60730,1399-10-1
382,كساوه,صنايع‌ كاشي‌ و سراميك‌ سينا,826,1747771,152734605580,91900,87310,87310,-4590,-4.99,87390,-4510,-4.91,87310,89890,1399-10-1
383,غشاذر,پگاه‌آذربايجان‌غربي‌,817,2563016,50538915380,18900,19000,19840,940,4.97,19710,810,4.29,18500,19840,1399-10-1
384,سكرما,سيمان‌ كرمان‌,801,2821361,51272570080,17460,18190,18330,870,4.98,18120,660,3.78,17490,18330,1399-10-1
385,سمگا,گروه سرمايه گذاري ميراث فرهنگي,799,4078651,134008157256,31292,32856,32856,1564,5.0,32856,1564,5.0,32856,32856,1399-10-1
386,سشمال,سيمان‌ شمال‌,798,5233090,54419311110,9910,10400,10400,490,4.94,10380,470,4.74,10300,10400,1399-10-1
387,غديس,پاكديس,797,6020433,81354111129,12870,13513,13513,643,5.0,13513,643,5.0,13513,13513,1399-10-1
388,دانا,بيمه دانا,781,12688897,138816533180,10420,10940,10940,520,4.99,10940,520,4.99,10940,10940,1399-10-1
389,كمينا,شيشه سازي مينا,772,1274933,41406177750,32395,31424,32010,-385,-1.19,32477,82,0.25,31130,33480,1399-10-1
390,فخاس,فولاد خراسان,767,1184336,38090464020,32040,33630,31580,-460,-1.44,32090,50,0.16,30600,33630,1399-10-1
391,شدوص,دوده‌ صنعتي‌ پارس‌,766,1494514,34253158050,22340,21650,22600,260,1.16,22710,370,1.66,21650,23350,1399-10-1
392,سيستم,همكاران سيستم,758,1284789,44077756000,34340,35900,34720,380,1.11,34310,-30,-0.09,33360,35900,1399-10-1
393,وسنا,سرمايه گذاري نيروگاهي ايران,754,3052613,49233941787,16758,15999,15921,-837,-4.99,16128,-630,-3.76,15921,16700,1399-10-1
394,حپترو,حمل و نقل پتروشيمي( سهامي عام,750,1425462,46110393570,30960,31370,32500,1540,4.97,32130,1170,3.78,31360,32500,1399-10-1
395,سهگمت,سيمان‌هگمتان‌,744,2201644,54265055610,25080,25270,24190,-890,-3.55,24650,-430,-1.71,23830,25270,1399-10-1
396,غالبر,لبنيات‌ كالبر,741,5327688,70697682700,12750,12370,13380,630,4.94,13270,520,4.08,12370,13380,1399-10-1
397,سفانو,سيمان فارس نو,737,1372996,46325484260,32630,31900,34220,1590,4.87,33650,1020,3.13,31730,34260,1399-10-1
398,وصندوق,سرمايه‌گذاري‌صندوق‌بازنشستگي‌,732,4363921,68033016340,15610,15000,15400,-210,-1.35,15600,-10,-0.06,15000,15880,1399-10-1
399,قصفها,قنداصفهان‌,725,397649,94366084190,249800,237310,237310,-12490,-5.0,237310,-12490,-5.0,237310,237310,1399-10-1
400,غمهراح,ح . توليدي‌مهرام‌,724,712657,48471914380,66500,69000,67400,900,1.35,68020,1520,2.29,66530,69000,1399-10-1
401,واميد,گروه مديريت سرمايه گذاري اميد,720,3683928,137190203420,37900,37970,37220,-680,-1.79,37240,-660,-1.74,36020,38480,1399-10-1
402,غبشهر,صنعتي‌ بهشهر,720,3081381,85728925350,26740,27750,28070,1330,4.97,27820,1080,4.04,26820,28070,1399-10-1
403,شرانل,نفت ايرانول,719,1034958,35272437048,34163,34650,34200,37,0.11,34107,-56,-0.16,33060,35270,1399-10-1
404,مداران,داده‌پردازي‌ايران‌,719,1865222,47199279090,24250,25250,25460,1210,4.99,25240,990,4.08,23400,25460,1399-10-1
405,وحافظ,بيمه حافظ,718,1743043,132029840174,72140,75747,75747,3607,5.0,75747,3607,5.0,75333,75747,1399-10-1
406,شجم,صنايع پتروشيمي تخت جمشيد,717,43301347,484801881012,10870,11196,11196,326,3.0,11196,326,3.0,11196,11196,1399-10-1
407,وصنا,گروه‌صنايع‌بهشهرايران‌,715,3336161,30944237050,9230,9390,9680,450,4.88,9270,40,0.43,8930,9840,1399-10-1
408,بسويچ,پارس‌سويچ‌,710,1063477,51924592830,47470,45150,49840,2370,4.99,48830,1360,2.86,45150,49840,1399-10-1
409,وشمال,س. چشم انداز توسعه شمال,710,670256,64555022953,93570,96377,96377,2807,3.0,96314,2744,2.93,94150,96377,1399-10-1
410,مفاخر,توسعه فناوري اطلاعات خوارزمي,708,1347989,56801107868,41353,40020,43420,2067,5.0,42138,785,1.9,39287,43420,1399-10-1
411,دامين,داروسازي‌ امين‌,701,2942258,47391722620,15360,16120,16120,760,4.95,16010,650,4.23,15660,16120,1399-10-1
412,بهپاك,صنعتي بهپاك,699,2351320,107830685602,44294,45790,46508,2214,5.0,45860,1566,3.54,42300,46508,1399-10-1
413,جم پيلن,پلي پروپيلن جم - جم پيلن,699,877317,76882532470,86170,85400,86900,730,0.85,87630,1460,1.69,85400,89300,1399-10-1
414,ميهن,بيمه ميهن,697,17429672,119532228172,6538,6864,6864,326,4.99,6858,320,4.89,6540,6864,1399-10-1
415,فنورد,نوردوقطعات‌ فولادي‌,696,499185,107813809210,205820,216110,216110,10290,5.0,215980,10160,4.94,210000,216110,1399-10-1
416,اپرداز,آتيه داده پرداز,696,3519244,105735925746,28748,28330,30185,1437,5.0,30045,1297,4.51,28330,30185,1399-10-1
417,فن آوا,گروه فن آوا,693,2410945,30680458762,13049,12658,12658,-391,-3.0,12725,-324,-2.48,12658,13010,1399-10-1
418,وتوسم,سرمايه‌گذاري‌توسعه‌ملي‌,690,3761503,47833278530,12740,12930,12760,20,0.16,12720,-20,-0.16,12430,13040,1399-10-1
419,ساراب,سيمان‌ داراب‌,675,1962931,26256543000,13380,13450,13170,-210,-1.57,13380,0,0.0,13030,13880,1399-10-1
420,زر,صندوق س.پشتوانه سكه طلاي زر,672,962587,46976780845,48698,50000,48500,-198,-0.41,48803,105,0.22,48200,50000,1399-10-1
421,زپارس,ملي كشت و صنعت و دامپروري پارس,670,556007,53530272190,95610,99500,96200,590,0.62,96260,650,0.68,94000,99500,1399-10-1
422,كقزوي,شيشه‌ قزوين‌,670,6843616,59203880300,8667,8407,8927,260,3.0,8651,-16,-0.18,8407,8927,1399-10-1
423,خچرخش,چرخشگر,666,3298055,53180869680,15410,15050,16180,770,5.0,16120,710,4.61,15050,16180,1399-10-1
424,غپآذر,شير پگاه آذربايجان شرقي,665,1019881,61049858308,59643,61990,60250,607,1.02,59860,217,0.36,57920,61990,1399-10-1
425,فسپا,گروه‌صنعتي‌سپاهان‌,664,4023595,210634810960,49860,52350,52350,2490,4.99,52350,2490,4.99,51630,52350,1399-10-1
426,وزمين,بانك ايران زمين,663,5303661,68692204351,13205,13000,13000,-205,-1.55,12952,-253,-1.92,12941,13200,1399-10-1
427,وثنو,سرمايه گذاري ساختماني نوين,656,3600281,71473181235,18908,19853,19853,945,5.0,19852,944,4.99,19500,19853,1399-10-1
428,اطلس,صندوق س.توسعه اندوخته آينده-س,654,188102,40322516898,211721,210000,214150,2429,1.15,214365,2644,1.25,209000,217000,1399-10-1
429,غگرجي,بيسكويت‌  گرجي‌,630,4381680,77562196970,16190,17390,18250,2060,12.72,17700,1510,9.33,17390,18250,1399-10-1
430,زماهان,مجتمع توليد گوشت مرغ ماهان,625,1701862,46445856660,26357,25500,27674,1317,5.0,27260,903,3.43,25500,27674,1399-10-1
431,كلر,كلر پارس,623,1022539,77779429035,72443,76065,76065,3622,5.0,76065,3622,5.0,76065,76065,1399-10-1
432,ولملت,واسپاري ملت,620,2442883,24014075700,10010,10140,9750,-260,-2.6,9920,-90,-0.9,9600,10140,1399-10-1
433,كيان,صندوق س. با درآمد ثابت كيان,619,10902007,287822605330,26385,26401,26399,14,0.05,26401,16,0.06,26399,26410,1399-10-1
434,زشريف,كشت وصنعت شريف آباد,612,1601341,45137066557,26861,28070,28204,1343,5.0,27949,1088,4.05,27800,28204,1399-10-1
435,خرينگ,رينگ‌سازي‌مشهد,610,1357075,89173398250,62590,65710,65710,3120,4.98,65710,3120,4.98,65710,65710,1399-10-1
436,دسينا,داروسازي‌ سينا,608,1111093,34003319670,29510,30850,30800,1290,4.37,30250,740,2.51,30030,30900,1399-10-1
437,وتوشه,سرمايه‌ گذاري‌ پارس‌ توشه‌,606,2075650,45272286270,22080,22080,21790,-290,-1.31,21830,-250,-1.13,21010,22860,1399-10-1
438,دفرا,فرآورده‌هاي‌ تزريقي‌ ايران‌,605,1868396,49893030850,26280,25150,27590,1310,4.98,26700,420,1.6,25150,27590,1399-10-1
439,آوا,صندوق س.سهام آواي معيار-س,604,2556019,23719930100,9300,9360,9205,-95,-1.02,9280,-20,-0.22,9100,9498,1399-10-1
440,شلعاب,لعابيران‌,600,3117672,36204346640,11090,11590,11640,550,4.96,11430,340,3.07,11300,11640,1399-10-1
441,وثخوز,سرمايه گذاري و توسعه خوزستان,594,905771,62162157959,65361,68629,68629,3268,5.0,68629,3268,5.0,68629,68629,1399-10-1
442,قرن,پديده شيمي قرن,592,685525,40576224750,56380,59190,59190,2810,4.98,58430,2050,3.64,59190,59190,1399-10-1
443,عيار,صندوق س. پشتوانه طلاي مفيد,587,943730,27335062164,28811,28988,28771,-40,-0.14,28965,154,0.53,28750,29300,1399-10-1
444,غگلستا,شير پاستوريزه پگاه گلستان,582,2646067,60917754474,21926,23022,23022,1096,5.0,23022,1096,5.0,23022,23022,1399-10-1
445,سقاين,سيمان‌ قائن‌,573,787288,37538305070,47060,44790,48290,1230,2.61,47530,470,1.0,44790,49290,1399-10-1
446,فيروزه,صندوق شاخص30 شركت فيروزه- سهام,572,292820,52217195210,178630,179980,176600,-2030,-1.14,178330,-300,-0.17,174090,181000,1399-10-1
447,حپارسا,توسعه حمل و نقل ريلي پارسيان,569,2027891,70233949438,33189,34298,34848,1659,5.0,34634,1445,4.35,33550,34848,1399-10-1
448,قهكمت,قندهكمتان‌,565,449561,22968912420,50720,52000,50880,160,0.32,50880,160,0.32,49590,52480,1399-10-1
449,شراز,پالايش نفت شيراز,565,270821,30105640895,114778,109060,109980,-4798,-4.18,112540,-2238,-1.95,109040,118000,1399-10-1
450,سخزر,سيمان‌ خزر,565,1768566,54778365040,29510,30980,30980,1470,4.98,30900,1390,4.71,30530,30980,1399-10-1
451,دابور,داروسازي‌ ابوريحان‌,565,1086597,52542186210,46150,48390,48450,2300,4.98,48320,2170,4.7,47500,48450,1399-10-1
452,حخزر,كشتيراني درياي خزر,564,1721843,39707089481,24192,24189,23286,-906,-3.75,23221,-971,-4.01,22983,24189,1399-10-1
453,ثنظام,س. ساختماني نظام مهندسي ايران,550,768270,34259013280,43340,44640,44640,1300,3.0,44592,1252,2.89,43150,44640,1399-10-1
454,ساروم,سيمان‌اروميه‌,549,874579,23771717520,26970,27400,26810,-160,-0.59,27060,90,0.33,26810,27870,1399-10-1
455,كشرق,صنعتي و معدني شمال شرق شاهرود,546,383981,28988396436,76833,76848,76690,-143,-0.19,76068,-765,-1.0,74000,76950,1399-10-1
456,بالبر,كابل‌ البرز,544,1440105,39474540630,26380,25510,27690,1310,4.97,27190,810,3.07,25510,27690,1399-10-1
457,حاريا,كشتيراني آريا,542,2568822,67772979000,26198,25413,26983,785,3.0,26383,185,0.71,25413,26983,1399-10-1
458,دكپسول,توليد ژلاتين كپسول ايران,539,1254082,53943841684,41014,42290,43064,2050,5.0,43015,2001,4.88,41110,43064,1399-10-1
459,پسهند,صنايع‌ لاستيكي‌  سهند,539,1252614,55500806480,42580,43310,44700,2120,4.98,44310,1730,4.06,41420,44700,1399-10-1
460,آبين,كشت و صنعت آبشيرين,535,6808610,34689967869,4973,5122,5122,149,3.0,5095,122,2.45,4973,5122,1399-10-1
461,رانفور,خدمات‌انفورماتيك‌,532,2174881,73293489700,32100,33700,33700,1600,4.98,33150,1050,3.27,33700,33700,1399-10-1
462,بفجر,فجر انرژي خليج فارس,528,1158056,32122190650,27900,27660,27520,-380,-1.36,27830,-70,-0.25,27330,28450,1399-10-1
463,وايرا,سرمايه گذاري صنايع ايران,525,3642407,40397127264,10785,11108,11108,323,2.99,11091,306,2.84,10800,11108,1399-10-1
464,غبهار,كشت وصنعت بهاران گلبهار خراسان,525,2149290,99924790680,45138,46492,46492,1354,3.0,46492,1354,3.0,46492,46492,1399-10-1
465,خپويش,سازه‌ پويش‌,521,672202,26870536790,38100,40000,40000,1900,4.99,39050,950,2.49,39550,40000,1399-10-1
466,پرداخت,به پرداخت ملت,520,1356775,35385618320,24860,26090,26100,1240,4.99,25690,830,3.34,25490,26100,1399-10-1
467,خكمك,كمك‌فنرايندامين‌,517,794505,33925363500,44940,42700,42700,-2240,-4.98,43200,-1740,-3.87,42700,42700,1399-10-1
468,وپخش,داروپخش‌ (هلدينگ‌,504,372761,49090609590,126320,129990,132630,6310,5.0,131590,5270,4.17,126500,132630,1399-10-1
469,وآيند,بانك  آينده,503,4928770,114130598120,23628,23156,23156,-472,-2.0,23156,-472,-2.0,23156,23156,1399-10-1
470,پارند,صندوق س. پارند پايدار سپهر,500,15094072,171714810642,11344,11370,11438,94,0.83,11376,32,0.28,11316,11450,1399-10-1
471,سخاش,سيمان‌خاش‌,498,310048,35462631460,108990,114430,114430,5440,4.99,112430,3440,3.16,110000,114430,1399-10-1
472,شيراز,پتروشيمي‌شيراز,498,965629,54826123920,55500,54150,56000,500,0.9,56170,670,1.21,54150,58130,1399-10-1
473,گوهران,سرمايه گذاري توسعه گوهران اميد,489,2290828,20254663950,8920,8978,8889,-31,-0.35,8888,-32,-0.36,8533,9080,1399-10-1
474,سغرب,سيمان‌غرب‌,485,1731318,35871932300,19830,20600,20820,990,4.99,20440,610,3.08,20000,20820,1399-10-1
475,وتعاون,بيمه  تعاون,469,3171137,22734712672,7355,7450,7190,-165,-2.24,7169,-186,-2.53,7135,7450,1399-10-1
476,توريل,توکاريل,468,2421459,65260741509,25668,26951,26951,1283,5.0,26951,1283,5.0,26951,26951,1399-10-1
477,گكيش,توريستي ورفاهي آبادگران كيش,451,323949,19503602186,61928,62200,60071,-1857,-3.0,60206,-1722,-2.78,60071,62200,1399-10-1
478,ضخود1042,اختيارخ خودرو-3000-1399/10/07,447,17484,5648206000,522,401,300,-222,-42.53,323,-199,-38.12,250,540,1399-10-1
479,ساينا,صنايع بهداشتي ساينا,443,174543,34229269659,205372,197000,195104,-10268,-5.0,198666,-6706,-3.27,195104,204698,1399-10-1
480,ثزاگرس,سرمايه گذاري توسعه عمران زاگرس,442,745977,35478193624,45352,47600,47619,2267,5.0,47559,2207,4.87,45807,47619,1399-10-1
481,سبجنو,سيمان‌ بجنورد,439,547140,20758805200,36740,37490,38570,1830,4.98,37220,480,1.31,36800,38570,1399-10-1
482,كاسپين,داروسازي كاسپين تامين,438,1500107,43752979566,27881,27223,29275,1394,5.0,28970,1089,3.91,27223,29275,1399-10-1
483,غشصفا,شيرپاستوريزه‌پگاه‌اصفهان‌,431,1528969,45325703560,28560,27730,29980,1420,4.97,29540,980,3.43,27730,29980,1399-10-1
484,قلرست,قند لرستان‌,429,604649,14742933350,24730,24000,24010,-720,-2.91,24620,-110,-0.44,24000,24840,1399-10-1
485,ولبهمن,شركت بهمن ليزينگ,422,18016272,189747376704,10031,10532,10532,501,4.99,10532,501,4.99,10532,10532,1399-10-1
486,وساغربي,شركت س استان آذربايجان غربي,415,17063512,12800924080,780,750,750,-30,-3.85,770,-10,-1.28,750,760,1399-10-1
487,شنفت,نفت‌ پارس‌,404,390999,22502758000,57910,56950,56900,-1010,-1.74,57770,-140,-0.24,56900,58640,1399-10-1
488,ولتجار,واسپاري تجارت وسرمايه ايرانيان,398,3877663,29387682779,7364,7560,7584,220,2.99,7579,215,2.92,7410,7584,1399-10-1
489,خراسان,پتروشيمي خراسان,396,310212,21760167830,71460,72000,70000,-1460,-2.04,70910,-550,-0.77,69000,72000,1399-10-1
490,سفاسي,شركت فارسيت اهواز,395,1255774,20417629466,15485,16259,16259,774,5.0,16195,710,4.59,16259,16259,1399-10-1
491,شفا,سرمايه گذاري شفادارو,395,1155769,72605408580,59830,62820,62820,2990,5.0,62820,2990,5.0,62820,62820,1399-10-1
492,كوثر,بيمه كوثر,388,5789031,151881017316,24987,26236,26236,1249,5.0,26236,1249,5.0,26236,26236,1399-10-1
493,ضخود2009,اختيارخ خودرو-4000-1400/02/08,385,8060,7055970000,882,909,780,-102,-11.56,875,-7,-0.79,751,1040,1399-10-1
494,ضخود1045,اختيارخ خودرو-4500-1399/10/07,381,20696,69145000,11,10,2,-9,-81.82,3,-8,-72.73,2,10,1399-10-1
495,آتيمس,صندوق س.آرمان آتيه درخشان مس-س,378,107887,23791448513,220442,220000,220698,256,0.12,220522,80,0.04,211500,225500,1399-10-1
496,كتوكاح,ح.توليدي وخدمات صنايع نسوزتوكا,368,1076169,29558763330,28700,28700,27265,-1435,-5.0,27467,-1233,-4.3,27265,28700,1399-10-1
497,تكمبا,كمباين‌ سازي‌ ايران‌,362,5776077,71796637110,11840,12430,12430,590,4.98,12430,590,4.98,12430,12430,1399-10-1
498,شفارس,صنايع‌ شيميايي‌ فارس‌,360,525730,34382742000,62290,65400,65400,3110,4.99,64140,1850,2.97,65400,65400,1399-10-1
499,قمرو,قند مرودشت‌,357,376866,10152200000,26680,27800,27000,320,1.2,26730,50,0.19,26700,27800,1399-10-1
500,سهرمز,سيمان‌هرمزگان‌,352,492329,9804494560,20640,20000,20000,-640,-3.1,20490,-150,-0.73,19610,20590,1399-10-1
501,غدشت,دشت‌ مرغاب‌,338,175819,44522645370,241180,253230,253230,12050,5.0,250990,9810,4.07,253230,253230,1399-10-1
502,واعتبار,سرمايه گذاري اعتبار ايران,336,7041753,54010180510,7310,7670,7670,360,4.92,7650,340,4.65,7660,7670,1399-10-1
503,وسرمد,بيمه  سرمد,333,5497495,45663882311,8075,8317,8317,242,3.0,8306,231,2.86,8200,8317,1399-10-1
504,ثاختح,ح . بين‌المللي‌توسعه‌ساختمان,331,9624311,29992870640,3250,3200,3000,-250,-7.69,3120,-130,-4.0,3000,3200,1399-10-1
505,ثقزوي,شركت عمران و سازندگي قزوين,319,1414440,44445948120,29927,31423,31423,1496,5.0,31423,1496,5.0,31423,31423,1399-10-1
506,قشهد,شهد,311,333587,10230594370,30930,30000,30170,-760,-2.46,30880,-50,-0.16,30000,31500,1399-10-1
507,بنو,بيمه تجارت نو,309,1568334,53166522600,30518,33900,33900,3382,11.08,33755,3237,10.61,33900,33900,1399-10-1
508,ياقوت,صندوق س ياقوت آگاه-ثابت,308,6710363,78046749158,11622,11620,11631,9,0.08,11631,9,0.08,11616,11631,1399-10-1
509,تسه9907,امتياز تسهيلات مسكن مهر99,307,5843,3476078529,594716,624451,594915,199,0.03,594913,197,0.03,583300,624451,1399-10-1
510,افق ملت,صندوق س در سهام افق ملت,306,105684,15203734710,143110,142110,143880,770,0.54,143860,750,0.52,142000,147200,1399-10-1
511,آساس,صندوق س.آسمان آرماني سهام-س,305,97723,17216940926,175525,178450,175989,464,0.26,176181,656,0.37,173101,178450,1399-10-1
512,تكشا,گسترش‌صنايع‌وخدمات‌كشاورزي‌,302,814565,50340117000,58860,61800,61800,2940,4.99,61570,2710,4.6,61800,61800,1399-10-1
513,كخاك,صنايع‌خاك‌چيني‌ايران‌,299,573187,32770437370,54570,56790,57290,2720,4.98,56060,1490,2.73,56000,57290,1399-10-1
514,ساروج,بين المللي ساروج بوشهر,299,1429252,33931456805,23256,23952,23948,692,2.98,23741,485,2.09,22900,23953,1399-10-1
515,كاريس,صندوق س.سپهر كاريزما-س,292,362169,76132477557,209802,205862,208500,-1302,-0.62,210213,411,0.2,205862,212000,1399-10-1
516,خموتور,موتورسازان‌تراكتورسازي‌ايران‌,289,3049793,44039010920,13760,14440,14440,680,4.94,14280,520,3.78,14440,14440,1399-10-1
517,وگردش,بانك گردشگري,276,2602942,48656794806,19271,18693,18693,-578,-3.0,18976,-295,-1.53,18693,18693,1399-10-1
518,كماسه,تامين‌ ماسه‌ ريخته‌گري‌,268,499852,31650628640,60310,63320,63320,3010,4.99,62000,1690,2.8,63320,63320,1399-10-1
519,ضسپا1102,اختيارخ خساپا-2000-1399/11/26,266,11391,6849653000,815,750,600,-215,-26.38,601,-214,-26.26,581,750,1399-10-1
520,آكورد,صندوق س. آرمان آتي كوثر-د,264,8034944,239889914438,29837,29855,29857,20,0.07,29856,19,0.06,29853,29864,1399-10-1
521,خكار,ايركا پارت صنعت,264,1662017,48048911470,27540,28910,28910,1370,4.97,28690,1150,4.18,28910,28910,1399-10-1
522,لبوتان,گروه‌صنعتي‌بوتان‌,262,450279,46666915560,98710,103640,103640,4930,4.99,102690,3980,4.03,103640,103640,1399-10-1
523,ولراز,ليزينگ رازي,262,218495,11321318425,50306,51815,51815,1509,3.0,51106,800,1.59,51815,51815,1399-10-1
524,ثشرقح,ح. سرمايه گذاري مسكن شمال شرق,258,7651810,33922839600,4180,4500,4400,220,5.26,4430,250,5.98,4400,4600,1399-10-1
525,پلاست,كارخانجات توليدي پلاستيران,241,275675,11987972766,42371,42371,43642,1271,3.0,43044,673,1.59,42371,43642,1399-10-1
526,خلنت,لنت‌ ترمزايران‌,238,126276,11226609460,88510,86100,89930,1420,1.6,88600,90,0.1,84620,90900,1399-10-1
527,تپولا,مهندسي مرآت پولاد,238,771640,24703790901,31127,32050,32060,933,3.0,32015,888,2.85,31510,32060,1399-10-1
528,وسصفا,شركت س استان اصفهان,235,9077265,9984991500,1050,1100,1100,50,4.76,1050,0,0.0,1100,1100,1399-10-1
529,ثامان,سامان‌ گستراصفهان‌,234,1149510,26703117300,22130,23230,23230,1100,4.97,22660,530,2.39,23230,23230,1399-10-1
530,تشتاد,صنايع توليدي اشتاد ايران‌,232,1315748,20411170650,15989,15510,15510,-479,-3.0,15513,-476,-2.98,15510,15800,1399-10-1
531,دشيري,شيرين دارو,231,153017,24773665433,158012,162000,162752,4740,3.0,161901,3889,2.46,156039,162752,1399-10-1
532,افرا,افرانت,231,469151,22385539965,45443,47715,47715,2272,5.0,46401,958,2.11,47715,47715,1399-10-1
533,رتكو,كنترل‌خوردگي‌تكين‌كو,223,3579551,76244436300,20290,21300,21300,1010,4.98,21300,1010,4.98,21300,21300,1399-10-1
534,درهآور,دارويي ره آورد تامين,220,1127715,54567873420,46084,48388,48388,2304,5.0,48314,2230,4.84,48388,48388,1399-10-1
535,نيرو,نيرو سرمايه,215,452627,25544599080,54800,56444,56444,1644,3.0,56436,1636,2.99,55200,56444,1399-10-1
536,غپونه,نوش پونه مشهد,213,849459,16004789400,18398,17850,18949,551,2.99,18767,369,2.01,17850,18949,1399-10-1
537,غفارس,شير پاستوريزه پگاه فارس,212,3772067,49263195020,12439,13060,13060,621,4.99,12971,532,4.28,13060,13060,1399-10-1
538,پارتا,مجتمع‌صنعتي‌آرتاويل‌تاير,212,896645,58620679108,60914,65053,65990,5076,8.33,65378,4464,7.33,63500,67004,1399-10-1
539,كاذر,فرآورده‌هاي‌نسوزآذر,211,1553400,37638882000,23080,24230,24230,1150,4.98,23850,770,3.34,24230,24230,1399-10-1
540,بكاب,صنايع‌جوشكاب‌يزد,208,203835,66749847450,311880,327470,327470,15590,5.0,327470,15590,5.0,327470,327470,1399-10-1
541,خنصير,مهندسي‌نصيرماشين‌,207,768125,44958356250,55750,58530,58530,2780,4.99,58130,2380,4.27,58530,58530,1399-10-1
542,ثنور,سرمايه گذاري كوه نور,204,2268246,21237587298,8918,9363,9363,445,4.99,9343,425,4.77,9363,9363,1399-10-1
543,سمتاز,سيمان ممتازان كرمان,198,439610,11581868917,25687,25000,26457,770,3.0,26044,357,1.39,25000,26457,1399-10-1
544,تسه9902,امتياز تسهيلات مسكن ارديبهشت99,197,2751,1623542053,600062,600000,590000,-10062,-1.68,590164,-9898,-1.65,572258,600000,1399-10-1
545,ضخود1043,اختيارخ خودرو-3500-1399/10/07,197,7686,938054000,181,112,101,-80,-44.2,122,-59,-32.6,70,210,1399-10-1
546,وكادو,تكادو,192,890118,18888303960,20602,21220,21220,618,3.0,21188,586,2.84,21220,21220,1399-10-1
547,سكه0012پ01,سكه تمام بهارتحويلي 1روزه رفاه,190,50900,59760933900,1168936,1182999,1172480,3544,0.3,1174085,5149,0.44,1169999,1182999,1399-10-1
548,تسه9904,امتياز تسهيلات مسكن تير99,189,1621,959198822,590414,575000,619934,29520,5.0,591733,1319,0.22,575000,619934,1399-10-1
549,تصميم,صندوق س با درآمد ثابت تصميم,187,8615542,131339143414,15224,15222,15268,44,0.29,15244,20,0.13,15172,15270,1399-10-1
550,سپاس,صندوق س. پاداش سهامداري توسعه1,182,5696292,57468067616,10078,10087,10090,12,0.12,10089,11,0.11,10080,10095,1399-10-1
551,وملت,سرمايه گذاري ملت,182,2468010,10765459620,4451,4362,4362,-89,-2.0,4362,-89,-2.0,4362,4362,1399-10-1
552,زعف0008پ10,زعفران0008نگين طلاي سرخ(پ),181,78199,10053171939,130262,129979,128999,-1263,-0.97,128559,-1703,-1.31,127200,129979,1399-10-1
553,فروس,فروسيليس‌ ايران‌,180,2283525,14157855000,5910,6200,6200,290,4.91,5990,80,1.35,6200,6200,1399-10-1
554,وثوق,سرمايه گذاري وثوق امين,171,803543,11387007853,13759,14171,14171,412,2.99,13977,218,1.58,14171,14171,1399-10-1
555,ثاژن,سخت آژند,171,3810235,31110568775,8005,8165,8165,160,2.0,8165,160,2.0,8165,8165,1399-10-1
556,فيروزا,صندوق بادرآمد ثابت فيروزه آسيا,167,5245531,112704474029,21468,21453,21528,60,0.28,21486,18,0.08,21402,21529,1399-10-1
557,تكنو,تكنوتار,167,1612097,24890777680,14710,15440,15440,730,4.96,15040,330,2.24,15440,15440,1399-10-1
558,كفرآور,فرآورده هاي سيمان شرق,167,1475771,32604208703,21041,22093,22093,1052,5.0,22093,1052,5.0,22093,22093,1399-10-1
559,ثاصفا,شركت‌ ساختمان‌ اصفهان‌,164,1020810,37954736610,36099,37181,37181,1082,3.0,37181,1082,3.0,37181,37181,1399-10-1
560,گپارس,امور رفاهي كارگزاران پارس,163,61426,8199010194,136703,132633,136999,296,0.22,135365,-1338,-0.98,132630,138699,1399-10-1
561,بشهاب,لامپ‌  پارس‌ شهاب‌,163,312901,23564574310,71730,75310,75310,3580,4.99,73280,1550,2.16,75310,75310,1399-10-1
562,دبالك,مواد اوليه دارويي البرز بالك,162,554912,13108686176,22499,23623,23623,1124,5.0,22764,265,1.18,23623,23623,1399-10-1
563,قپيرا,فرآورده‌هاي‌غدايي‌وقندپيرانشهر,162,68428,5899796320,87880,85100,85200,-2680,-3.05,87680,-200,-0.23,85100,87480,1399-10-1
564,ثاباد,توريستي ورفاهي آبادگران ايران,155,369642,13876360680,35760,37540,37540,1780,4.98,36220,460,1.29,37540,37540,1399-10-1
565,بمپنا,توليد برق عسلويه  مپنا,155,131292,12828696020,97513,96500,97000,-513,-0.53,97564,51,0.05,92640,99740,1399-10-1
566,تسه9906,امتياز تسهيلات مسكن شهريور99,153,1028,608375537,592105,566681,586000,-6105,-1.03,591805,-300,-0.05,566681,619990,1399-10-1
567,تسه9711,امتياز تسهيلات مسكن بهمن 97,150,3216,1850332103,559490,584000,568155,8665,1.55,575352,15862,2.84,548011,584986,1399-10-1
568,معيار,سرمايه گذاري معيار صنعت پارس,145,208481,7040194889,33107,33769,33769,662,2.0,33545,438,1.32,33769,33769,1399-10-1
569,واحصا,احياء صنايع خراسان,142,581834,18721090784,31239,32176,32176,937,3.0,32130,891,2.85,32176,32176,1399-10-1
570,تسه9810,امتياز تسهيلات مسكن دي98,139,2144,1259874111,575080,547877,551112,-23968,-4.17,587628,12548,2.18,547877,603834,1399-10-1
571,زكشت,كشاورزي مكانيزه اصفهان كشت,139,317745,11203370955,33580,35259,35259,1679,5.0,33944,364,1.08,35259,35259,1399-10-1
572,تسه9710,امتياز تسهيلات مسكن دي 97,139,3350,1697206281,521687,500077,495603,-26084,-5.0,506629,-15058,-2.89,495603,515000,1399-10-1
573,تسه9903,امتياز تسهيلات مسكن خرداد99,138,1392,828822996,585355,575533,614622,29267,5.0,595419,10064,1.72,575200,614622,1399-10-1
574,گشان,توسعه بين المللي پديده شانديز,137,50603,3335800363,67266,65921,65921,-1345,-2.0,67151,-115,-0.17,65921,65921,1399-10-1
575,آساميد,صندوق س.مشترك آسمان اميد -د,135,4848883,54501556375,11233,11240,11247,14,0.12,11240,7,0.06,11238,11247,1399-10-1
576,كپرور,فرآوري زغال سنگ پروده طبس,133,369176,17360132224,44785,47024,47024,2239,5.0,45493,708,1.58,47024,47024,1399-10-1
577,ضصاد1102,اختيارخ وبصادر-3500-1399/11/12,129,3914,1607613000,441,489,390,-51,-11.56,411,-30,-6.8,352,489,1399-10-1
578,تسه9905,امتياز تسهيلات مسكن مرداد99,127,873,517601834,589750,614000,590000,250,0.04,592900,3150,0.53,567811,619237,1399-10-1
579,كي بي سي,شركت كي بي سي,125,1500200,51197325400,32502,34127,34127,1625,5.0,34068,1566,4.82,34127,34127,1399-10-1
580,ختراك,ريخته‌گري‌ تراكتورسازي‌ ايران‌,120,1449306,21333784320,14020,14720,14720,700,4.99,14290,270,1.93,14720,14720,1399-10-1
581,كهرام,توليدي گرانيت بهسرام,118,85103,6048346233,69001,71071,71071,2070,3.0,69597,596,0.86,71020,71071,1399-10-1
582,ضجار1016,اختيارخ وتجارت-4000-1399/10/21,118,4039,657832000,177,161,143,-34,-19.21,163,-14,-7.91,132,190,1399-10-1
583,سلار,شركت سيمان لارستان,115,743619,32548195080,41686,43770,43770,2084,5.0,43770,2084,5.0,43760,43770,1399-10-1
584,گوهر,صندوق سكه طلاي كيان,115,46454,2752134241,58600,58849,58700,100,0.17,59244,644,1.1,58700,59998,1399-10-1
585,هجرت,پخش هجرت,111,279067,10291990960,35124,36880,36880,1756,5.0,35436,312,0.89,36880,36880,1399-10-1
586,زعف0008پ11,زعفران0008نگين سحرخيز(پ),110,96450,12376278510,128505,128300,128800,295,0.23,128318,-187,-0.15,127200,128999,1399-10-1
587,حتوكا,حمل‌ونقل‌توكا,109,788526,23703091560,28630,30060,30060,1430,4.99,29240,610,2.13,30060,30060,1399-10-1
588,داوه,داروسازي آوه سينا,104,320315,6415589135,19076,20029,20029,953,5.0,19191,115,0.6,20029,20029,1399-10-1
589,فپنتا,سپنتا,102,14120,6411186000,432430,454050,454050,21620,5.0,434910,2480,0.57,454050,454050,1399-10-1
590,ولانا,شركت ليزينگ آريا دانا,99,392053,9491211077,23504,24209,24209,705,3.0,23812,308,1.31,24209,24209,1399-10-1
591,ثتوسا,س.توسعه و عمران استان اردبيل,99,306253,15554589870,52360,50790,50790,-1570,-3.0,51012,-1348,-2.57,50790,50790,1399-10-1
592,فنفت,صنايع تجهيزات نفت,96,602145,10144336815,16357,16847,16847,490,3.0,16586,229,1.4,16847,16847,1399-10-1
593,غمهرا,توليدي‌مهرام‌,96,220134,16254694560,70330,73840,73840,3510,4.99,71360,1030,1.46,73840,73840,1399-10-1
594,ضچاد1017,اختيارخ كچاد-20000-1399/10/02,96,1050,375736000,796,1185,200,-596,-74.87,358,-438,-55.03,165,1185,1399-10-1
595,صنوين,صندوق سرمايه‌گذاري صنوين-مختلط,93,28537,3012906060,105040,106000,105300,260,0.25,105580,540,0.51,105000,106500,1399-10-1
596,تسه9712,امتياز تسهيلات مسكن اسفند97,92,1460,859365663,584215,561113,580020,-4195,-0.72,588607,4392,0.75,561105,610000,1399-10-1
597,كپشير,پشم‌شيشه‌ايران‌,92,429136,10329303520,22930,24070,24070,1140,4.97,23150,220,0.96,24070,24070,1399-10-1
598,كگهر,سنگ آهن گهرزمين,90,104074,5210360736,47680,50064,50064,2384,5.0,47777,97,0.2,50064,50064,1399-10-1
599,فوكا,فولاد كاويان,88,255176,3873316504,15977,15179,15179,-798,-4.99,15892,-85,-0.53,15179,15179,1399-10-1
600,ضصاد1104,اختيارخ وبصادر-4500-1399/11/12,87,3604,590488000,188,160,159,-29,-15.43,164,-24,-12.77,130,190,1399-10-1
601,ضجار1017,اختيارخ وتجارت-4500-1399/10/21,87,4443,200244000,81,70,40,-41,-50.62,45,-36,-44.44,40,120,1399-10-1
602,تسه9801,امتياز تسهيلات مسكن فروردين98,87,826,489350772,584533,575966,578031,-6502,-1.11,592434,7901,1.35,575111,613759,1399-10-1
603,ضپاس1005,اختيارخ وپارس-4500-1399/10/30,83,3126,1034884000,326,390,310,-16,-4.91,331,5,1.53,290,400,1399-10-1
604,سفارود,كارخانه فارسيت درود,82,509535,5981940900,11510,11740,11740,230,2.0,11644,134,1.16,11740,11740,1399-10-1
605,سدشت,صنايع سيمان دشتستان,82,119545,4509408580,37430,38800,37400,-30,-0.08,37460,30,0.08,37400,38800,1399-10-1
606,نتوس,پشم‌ بافي‌ توس,81,378829,5022136053,12871,13257,13257,386,3.0,12960,89,0.69,13257,13257,1399-10-1
607,بموتو,موتوژن‌,80,91859,4965897540,51490,54060,54060,2570,4.99,51720,230,0.45,54060,54060,1399-10-1
608,ضخود2013,اختيارخ خودرو-7000-1400/02/08,80,4060,814176000,246,250,170,-76,-30.89,201,-45,-18.29,170,300,1399-10-1
609,تسه9901,امتياز تسهيلات مسكن فروردين99,80,590,350258971,590957,563550,600000,9043,1.53,593659,2702,0.46,563550,601000,1399-10-1
610,سپر,صندوق س سپر سرمايه بيدار- ثابت,79,489693,5288851182,10635,10799,10868,233,2.19,10800,165,1.55,10700,10940,1399-10-1
611,دارو,كارخانجات‌داروپخش‌,76,371918,11592684060,29690,31170,31170,1480,4.98,30330,640,2.16,31170,31170,1399-10-1
612,تسه9802,امتياز تسهيلات مسكن ارديبهشت98,75,1097,644728275,575560,556669,575666,106,0.02,587719,12159,2.11,556669,600000,1399-10-1
613,دروز,داروسازي‌ روزدارو,75,1133496,21219045120,17830,18720,18720,890,4.99,18180,350,1.96,18720,18720,1399-10-1
614,زعف0008پ05,زعفران0008نگين زرين(پ),73,59127,7598879256,128427,128151,129102,675,0.53,128518,91,0.07,127002,129102,1399-10-1
615,تسه9812,امتياز تسهيلات مسكن اسفند98,71,241,141243298,593616,563996,581000,-12616,-2.13,586072,-7544,-1.27,563996,600000,1399-10-1
616,اوصتا,صندوق انديشه ورزان صباتامين -د,71,3177399,55325334086,17400,17420,17412,12,0.07,17412,12,0.07,17410,17430,1399-10-1
617,تسه9811,امتياز تسهيلات مسكن بهمن98,70,529,304880801,579817,557099,561000,-18817,-3.25,576334,-3483,-0.6,557099,600000,1399-10-1
618,وآتوس,س.آرين توسكا قيمت اسمي 350ريال,70,435087,16724744280,36610,38440,38440,1830,5.0,38022,1412,3.86,38440,38440,1399-10-1
619,صايند,صندوق س. گنجينه آينده روشن-د,68,342660,3436785510,10004,10030,10044,40,0.4,10030,26,0.26,10000,10044,1399-10-1
620,اخزا903,اسنادخزانه-م3بودجه99-011110,68,65794,43837153639,669601,666711,666312,-3289,-0.49,666279,-3322,-0.5,664296,672998,1399-10-1
621,جهرم,پتروشيمي جهرم,66,398678,1094371110,2829,2745,2745,-84,-2.97,2824,-5,-0.18,2745,2745,1399-10-1
622,كتوكا,توليدي و خدمات صنايع نسوز توكا,65,1383617,34659605850,23858,25050,25050,1192,5.0,24642,784,3.29,25050,25050,1399-10-1
623,ضفلا1156,اختيارخ فولاد-16000-1399/11/28,65,1438,1809418000,1395,1430,1299,-96,-6.88,1258,-137,-9.82,1127,1460,1399-10-1
624,تسه9803,امتياز تسهيلات مسكن خرداد98,64,544,314514012,576836,560000,594999,18163,3.15,578151,1315,0.23,547995,594999,1399-10-1
625,ثعتما,س. ساختماني اعتماد گستر,64,190025,8181526375,41801,43055,43055,1254,3.0,42282,481,1.15,43055,43055,1399-10-1
626,ضخود2008,اختيارخ خودرو-3500-1400/02/08,63,1413,1453005000,953,980,1000,47,4.93,1028,75,7.87,960,1180,1399-10-1
627,الماس,صندوق س.امين تدبيرگران فردا-س,62,45600,5965984752,131115,131000,130995,-120,-0.09,130833,-282,-0.22,129410,132500,1399-10-1
628,بذر,صندوق س بذر اميد آفرين-سهام,61,21084,2376063650,112600,111310,111700,-900,-0.8,112700,100,0.09,111310,113980,1399-10-1
629,شزنگ,تجهيزنيروي‌زنگان‌,61,59713,13612414332,221325,227964,227964,6639,3.0,225502,4177,1.89,227964,227964,1399-10-1
630,سنوين,سرمايه گذاري اقتصاد نوين,60,1212751,12031353164,9900,9901,10087,187,1.89,9921,21,0.21,9702,10087,1399-10-1
631,شرنگي,شيميايي رنگين,60,19854,2535772734,124001,127721,127721,3720,3.0,124455,454,0.37,127721,127721,1399-10-1
632,وسكرد,شركت س استان كردستان,59,1573654,1180240500,780,750,750,-30,-3.85,780,0,0.0,750,750,1399-10-1
633,شصفها,پتروشيمي‌ اصفهان‌,59,120049,14416204214,117732,120086,120086,2354,2.0,120086,2354,2.0,120086,120086,1399-10-1
634,تسه9809,امتياز تسهيلات مسكن آذر98,58,393,228864214,576745,550009,561340,-15405,-2.67,582352,5607,0.97,550009,605000,1399-10-1
635,وجامي,سرمايه گذاري جامي,56,179323,2021149533,10943,11271,11271,328,3.0,10974,31,0.28,11271,11271,1399-10-1
636,سكه9912پ04,سكه تمام بهارتحويل1روزه صادرات,56,8100,9510082000,1168056,1185000,1170000,1944,0.17,1174084,6028,0.52,1170000,1185000,1399-10-1
637,ضپاس1003,اختيارخ وپارس-3500-1399/10/30,55,1269,1021271000,765,750,740,-25,-3.27,805,40,5.23,710,890,1399-10-1
638,وبرق,س.کارکنان صنعت برق زنجان وقزوي,54,50680,10120846680,193885,199701,199701,5816,3.0,196742,2857,1.47,199701,199701,1399-10-1
639,داراب,پتروشيمي داراب,53,414008,1154668312,2875,2789,2789,-86,-2.99,2870,-5,-0.17,2789,2789,1399-10-1
640,اخزا815,اسنادخزانه-م15بودجه98-010406,53,147037,112040232988,761220,758101,762000,780,0.1,761987,767,0.1,758101,762998,1399-10-1
641,جوين,كشت و صنعت جوين,52,364927,9499049810,25272,26030,26030,758,3.0,25618,346,1.37,26030,26030,1399-10-1
642,اخزا817,اسنادخزانه-م17بودجه98-010512,52,216408,162319794729,761368,750000,750100,-11268,-1.48,750064,-11304,-1.48,749801,754999,1399-10-1
643,فنرژي,گسترش صنايع انرژي آذرآب,51,238516,2862669032,11767,12002,12002,235,2.0,11830,63,0.54,12002,12002,1399-10-1
644,ضصاد1100,اختيارخ وبصادر-2500-1399/11/12,50,1277,1048558000,894,893,800,-94,-10.51,821,-73,-8.17,750,900,1399-10-1
645,تسه9808,امتياز تسهيلات مسكن آبان98,50,504,292253193,587099,560900,571000,-16099,-2.74,579867,-7232,-1.23,558100,599000,1399-10-1
646,ضجار1015,اختيارخ وتجارت-3500-1399/10/21,50,1826,580018000,359,300,300,-59,-16.43,318,-41,-11.42,292,380,1399-10-1
647,آسام,صندوق س.آرمان سپهر آشنا-م,47,13590,1487984590,108391,107500,109400,1009,0.93,109491,1100,1.01,107007,110990,1399-10-1
648,سكه0011پ02,سكه تمام بهارتحويلي 1روزه ملت,46,9400,11027056800,1168425,1183000,1172007,3582,0.31,1173091,4666,0.4,1170000,1183000,1399-10-1
649,وسلرستا,شركت س استان لرستان,44,901562,775343320,900,860,860,-40,-4.44,900,0,0.0,860,860,1399-10-1
650,ضسپا1103,اختيارخ خساپا-2500-1399/11/26,44,753,440618000,642,451,550,-92,-14.33,585,-57,-8.88,400,650,1399-10-1
651,ضخود1040,اختيارخ خودرو-2000-1399/10/07,44,1784,2405885000,1539,1350,1290,-249,-16.18,1349,-190,-12.35,1270,1500,1399-10-1
652,اخزا820,اسنادخزانه-م20بودجه98-020806,44,71887,41663526810,578189,578000,578450,261,0.05,579570,1381,0.24,578000,582000,1399-10-1
653,سكارون,سيمان كارون,44,158532,24986069988,153019,157609,157609,4590,3.0,157609,4590,3.0,157609,157609,1399-10-1
654,ضجار1014,اختيارخ وتجارت-3000-1399/10/21,43,942,539134000,633,409,520,-113,-17.85,572,-61,-9.64,409,700,1399-10-1
655,ضملت1128,اختيارخ وبملت-6000-1399/11/28,43,878,442013000,544,530,434,-110,-20.22,503,-41,-7.54,410,582,1399-10-1
656,تكنار,مجتمع معادن مس تكنار,43,130346,19601170788,145999,150378,150378,4379,3.0,149855,3856,2.64,150378,150378,1399-10-1
657,ضخود2005,اختيارخ خودرو-2000-1400/02/08,43,1088,2125427000,2071,2000,1800,-271,-13.09,1954,-117,-5.65,1777,2150,1399-10-1
658,تسه9909,امتياز تسهيلات مسكن آذر99,42,913,541814818,597030,597030,597030,0,0.0,593444,-3586,-0.6,567800,597030,1399-10-1
659,وسيستا,شركت س استان سيستان وبلوچستان,41,1988574,1511316240,790,760,760,-30,-3.8,790,0,0.0,760,760,1399-10-1
660,ضخود1041,اختيارخ خودرو-2500-1399/10/07,41,1574,1226841000,947,910,700,-247,-26.08,779,-168,-17.74,700,910,1399-10-1
661,اخزا902,اسنادخزانه-م2بودجه99-011019,41,91087,61440601284,676813,674000,673680,-3133,-0.46,674527,-2286,-0.34,672510,676400,1399-10-1
662,پلوله,گازلوله‌,41,66654,1163645532,17634,17458,17458,-176,-1.0,17592,-42,-0.24,17458,17458,1399-10-1
663,ثروتم,صندوق س. ثروت آفرين پارسيان-س,41,10340,997430860,96612,96000,96549,-63,-0.07,96463,-149,-0.15,95500,97990,1399-10-1
664,سكه0112پ03,سكه تمام بهارتحويلي1روزه سامان,40,14100,16514273500,1167533,1178999,1170000,2467,0.21,1171225,3692,0.32,1168600,1178999,1399-10-1
665,ارمغان,ص سرمايه گذاري ارمغان ايرانيان,40,342110,3452658906,10090,10100,10111,21,0.21,10092,2,0.02,10088,10111,1399-10-1
666,ضخود1048,اختيارخ خودرو-7000-1399/10/07,40,2993,4911000,3,3,2,-1,-33.33,2,-1,-33.33,1,3,1399-10-1
667,وسكرمان,س.سهام عدالت استان كرمان,39,2082005,2040364900,1030,980,980,-50,-4.85,1030,0,0.0,980,980,1399-10-1
668,تسه9806,امتياز تسهيلات مسكن شهريور98,38,479,270156042,544629,560001,550000,5371,0.99,564000,19371,3.56,550000,571860,1399-10-1
669,ضملي1152,اختيارخ فملي-18252-1399/11/05,37,500,590704712,752,870,523,-229,-30.45,599,-153,-20.35,522,870,1399-10-1
670,اخزا808,اسنادخزانه-م8بودجه98-000817,37,42629,36503615871,854530,854594,856073,1543,0.18,856309,1779,0.21,854594,859996,1399-10-1
671,سدبير,س. تدبيرگران فارس وخوزستان,36,90476,4630471204,48742,51179,51179,2437,5.0,48948,206,0.42,51179,51179,1399-10-1
672,شكف,كف,36,110155,9004510320,80142,81744,81744,1602,2.0,81506,1364,1.7,81744,81744,1399-10-1
673,آكورد2,صندوق س. آرمان آتي كوثر-د,35,3500000,3500000,29837,1,1,-29836,-100.0,1,-29836,-100.0,1,1,1399-10-1
674,ضچاد1014,اختيارخ كچاد-14000-1399/10/02,35,1277,7945654000,6703,6300,5900,-803,-11.98,6222,-481,-7.18,5700,6700,1399-10-1
675,شتولي,تولي‌پرس‌,33,116735,3431191855,28817,29393,29393,576,2.0,29008,191,0.66,29393,29393,1399-10-1
676,اخزا812,اسنادخزانه-م12بودجه98-001111,33,109463,90099353337,822509,820271,823121,612,0.07,823103,594,0.07,820271,824000,1399-10-1
677,زعف0008پ18,زعفران0008نگين بهرامن(پ),32,50049,6407392028,127827,128000,128000,173,0.14,128022,195,0.15,126901,129000,1399-10-1
678,تسه9805,امتياز تسهيلات مسكن مرداد98,31,537,312546555,568239,580000,570000,1761,0.31,582023,13784,2.43,539998,596650,1399-10-1
679,ضچاد1015,اختيارخ كچاد-16000-1399/10/02,31,581,2582255000,4709,4250,3655,-1054,-22.38,4445,-264,-5.61,3500,4601,1399-10-1
680,اخزا814,اسنادخزانه-م14بودجه98-010318,31,106681,82207115186,792199,769511,771501,-20698,-2.61,770588,-21611,-2.73,769511,784500,1399-10-1
681,ضپاس1002,اختيارخ وپارس-3000-1399/10/30,30,744,813939000,1203,1200,1100,-103,-8.56,1094,-109,-9.06,1000,1200,1399-10-1
682,اخزا809,اسنادخزانه-م9بودجه98-000923,30,44832,37808858242,858895,845087,840200,-18695,-2.18,843345,-15550,-1.81,840115,845110,1399-10-1
683,ضچاد1016,اختيارخ كچاد-18000-1399/10/02,30,366,856629000,2611,2250,2000,-611,-23.4,2341,-270,-10.34,1940,2994,1399-10-1
684,ضشنا1036,اختيارخ شپنا-16000-1399/10/23,30,209,303318000,1756,1800,1100,-656,-37.36,1451,-305,-17.37,1014,1800,1399-10-1
685,ضفلا1155,اختيارخ فولاد-14000-1399/11/28,29,609,1289464000,2387,2300,2350,-37,-1.55,2117,-270,-11.31,1960,2350,1399-10-1
686,فماك,ماداكتو استيل كرد,29,970000,25061800000,26000,25990,25000,-1000,-3.85,25837,-163,-0.63,25000,25990,1399-10-1
687,تسه9807,امتياز تسهيلات مسكن مهر98,29,200,117092831,572314,570010,590000,17686,3.09,585464,13150,2.3,545009,600000,1399-10-1
688,ضسپا1106,اختيارخ خساپا-4000-1399/11/26,29,1002,121410000,185,56,130,-55,-29.73,121,-64,-34.59,56,150,1399-10-1
689,آينده,بازرگاني آينده سازان بهشت پارس,29,47137,952403085,21268,20205,20205,-1063,-5.0,21215,-53,-0.25,20205,20205,1399-10-1
690,لپيام,گسترش صنايع پيام,29,35573,1133071196,32837,31852,31852,-985,-3.0,32779,-58,-0.18,31852,31852,1399-10-1
691,ضملت1129,اختيارخ وبملت-7000-1399/11/28,29,816,189073000,215,249,257,42,19.53,232,17,7.91,190,269,1399-10-1
692,وسگيلا,شركت س استان گيلان,28,529287,418136730,830,790,790,-40,-4.82,830,0,0.0,790,790,1399-10-1
693,ضصاد1101,اختيارخ وبصادر-3000-1399/11/12,26,563,344518000,585,699,555,-30,-5.13,612,27,4.62,555,699,1399-10-1
694,هترول911,اختيارف ت پترول-14730-99/11/15,25,73863,169367859,2036,2293,2293,257,12.62,2293,257,12.62,2293,2293,1399-10-1
695,اخزا811,اسنادخزانه-م11بودجه98-001013,24,107481,89931756061,834674,834000,837500,2826,0.34,836722,2048,0.25,834000,837500,1399-10-1
696,پست0008پ08,پسته فندقي32-30مه ولات0008(پ),24,2564,3748474062,1522429,1480000,1510000,-12429,-0.82,1461963,-60466,-3.97,1448534,1510000,1399-10-1
697,اخزا821,اسنادخزانه-م21بودجه98-020906,24,141112,80772269140,574514,570002,573000,-1514,-0.26,572398,-2116,-0.37,570000,573000,1399-10-1
698,ضخود2007,اختيارخ خودرو-3000-1400/02/08,24,924,1095863000,1222,1390,1130,-92,-7.53,1186,-36,-2.95,1100,1390,1399-10-1
699,افران,صندوق س افرا نماد پايدار-ثابت,23,119219,1468307879,12308,12310,12317,9,0.07,12316,8,0.06,12310,12330,1399-10-1
700,تسه9804,امتياز تسهيلات مسكن تير98,23,264,152707516,578815,580000,561110,-17705,-3.06,578438,-377,-0.07,561000,599970,1399-10-1
701,كيان2,صندوق س. با درآمد ثابت كيان,21,2100000,2100000,26385,1,1,-26384,-100.0,1,-26384,-100.0,1,1,1399-10-1
702,ضخود2010,اختيارخ خودرو-4500-1400/02/08,21,131,62877000,673,550,499,-174,-25.85,480,-193,-28.68,450,550,1399-10-1
703,ضصاد1107,اختيارخ وبصادر-7000-1399/11/12,20,1710,26540000,21,14,29,8,38.1,16,-5,-23.81,11,30,1399-10-1
704,زعف0008پ16,زعفران0008نگين بيرجند(پ),20,18000,2308305000,127750,127501,128900,1150,0.9,128239,489,0.38,127501,128900,1399-10-1
705,ضخود1046,اختيارخ خودرو-5000-1399/10/07,20,1210,2510000,3,2,1,-2,-66.67,2,-1,-33.33,1,3,1399-10-1
706,ضترا1118,اختيارخ شتران-12000-1399/11/14,20,310,582582000,2016,2300,1500,-516,-25.6,1879,-137,-6.8,1500,2300,1399-10-1
707,فيروزه2,صندوق شاخص30 شركت فيروزه- سهام,20,200000,200000,178630,1,1,-178629,-100.0,1,-178629,-100.0,1,1,1399-10-1
708,اخزا806,اسنادخزانه-م6بودجه98-000519,20,76356,68188537854,894774,893001,893152,-1622,-0.18,893034,-1740,-0.19,892960,896400,1399-10-1
709,سخند,صندوق س.سپهرخبرگان نفت-د,19,194570,1961727000,10075,10079,10079,4,0.04,10082,7,0.07,10079,10100,1399-10-1
710,سايرا,ايرانيت‌,18,46867,1600761110,34046,34722,33366,-680,-2.0,34063,17,0.05,33366,34722,1399-10-1
711,اخزا901,اسنادخزانه-م1بودجه99-010621,18,21437,15659617339,728784,730000,730510,1726,0.24,730495,1711,0.23,730000,732000,1399-10-1
712,وسخوز,شركت س استان خوزستان,18,233772,217407960,970,930,930,-40,-4.12,970,0,0.0,930,930,1399-10-1
713,ضفلا1154,اختيارخ فولاد-12000-1399/11/28,17,171,614659000,3958,4000,3690,-268,-6.77,3594,-364,-9.2,3300,4000,1399-10-1
714,فاهواز,نورد و لوله اهواز,17,112611,2076884673,18819,18443,18443,-376,-2.0,18800,-19,-0.1,18443,18443,1399-10-1
715,اخزا816,اسنادخزانه-م16بودجه98-010503,16,140251,105415393458,749790,750102,752000,2210,0.29,751620,1830,0.24,750102,752001,1399-10-1
716,پدرخش,درخشان‌ تهران‌,16,1315,253492550,202910,192770,192770,-10140,-5.0,202860,-50,-0.02,192770,192770,1399-10-1
717,ضجار1018,اختيارخ وتجارت-5000-1399/10/21,16,835,13030000,28,14,20,-8,-28.57,16,-12,-42.86,13,20,1399-10-1
718,ثپرديسح,ح.سرمايه گذاري مسكن پرديس,15,38419,349283008,9538,9400,9062,-476,-4.99,9091,-447,-4.69,9062,9400,1399-10-1
719,اخزا813,اسنادخزانه-م13بودجه98-010219,14,69104,54037415140,782017,781971,781980,-37,0.0,781972,-45,-0.01,781971,781980,1399-10-1
720,اخزا904,اسنادخزانه-م4بودجه99-011215,14,36018,23540669593,657131,656807,659971,2840,0.43,653581,-3550,-0.54,653001,659971,1399-10-1
721,غنيلي,مجتمع توليدي نيلي صنعت كرمان,14,330000,5604450000,17000,17000,16630,-370,-2.18,16983,-17,-0.1,16630,17000,1399-10-1
722,زير0003پ04,زيره سبز0003شركت مينوبذر(پ),13,356,163599110,482106,458001,458001,-24105,-5.0,459548,-22558,-4.68,458001,480799,1399-10-1
723,ضصاد1103,اختيارخ وبصادر-4000-1399/11/12,13,199,49522000,276,210,249,-27,-9.78,249,-27,-9.78,210,300,1399-10-1
724,گنجين,صندوق س. گنجينه يكم آويد-د,13,9617,114153162,11860,11875,11876,16,0.13,11870,10,0.08,11863,11877,1399-10-1
725,اخزا713,اسنادخزانه-م13بودجه97-000518,13,1162,1039991503,892961,893400,893555,594,0.07,895001,2040,0.23,893400,896499,1399-10-1
726,ضملي1148,اختيارخ فملي-10140-1399/11/05,12,66,817196800,6027,6300,6000,-27,-0.45,6279,252,4.18,6000,6500,1399-10-1
727,كصدف,كاشي صدف سرام استقلال آباده,12,53127,1219211523,22281,22949,22949,668,3.0,22320,39,0.18,22949,22949,1399-10-1
728,گواهي ظرفيت,گواهي ظرفيت نقدي,12,60000000,638340000000,10639,10639,10639,0,0.0,10639,0,0.0,10639,10639,1399-10-1
729,نگين,ص.س. زمين و ساختمان نگين شهرري,12,7389,351292660,47630,47540,47530,-100,-0.21,47540,-90,-0.19,47530,47860,1399-10-1
730,ضفار1125,اختيارخ فارس-17826-1399/11/07,11,257,177356000,481,310,380,-101,-21.0,345,-136,-28.27,250,564,1399-10-1
731,ضشنا1035,اختيارخ شپنا-14000-1399/10/23,11,41,91715000,2431,2599,2000,-431,-17.73,2237,-194,-7.98,2000,2599,1399-10-1
732,ضملت1125,اختيارخ وبملت-4000-1399/11/28,11,219,302525000,1336,1000,1325,-11,-0.82,1381,45,3.37,1000,1500,1399-10-1
733,ضفلا1157,اختيارخ فولاد-18000-1399/11/28,11,266,133531000,805,601,501,-304,-37.76,502,-303,-37.64,456,601,1399-10-1
734,ضسپا1104,اختيارخ خساپا-3000-1399/11/26,11,160,63860000,463,401,400,-63,-13.61,399,-64,-13.82,390,401,1399-10-1
735,كباده,توليد خاك نسوزاستقلال آباده,11,500000,12540000000,23886,25080,25080,1194,5.0,24560,674,2.82,25080,25080,1399-10-1
736,اخزا810,اسنادخزانه-م10بودجه98-001006,11,45468,38049580273,837302,837302,836843,-459,-0.05,836843,-459,-0.05,836203,837302,1399-10-1
737,اخزا818,اسنادخزانه-م18بودجه98-010614,10,16323,11958844642,732383,732068,732867,484,0.07,732638,255,0.03,732068,732867,1399-10-1
738,داريك,صندوق س.اعتماد داريك-د,10,69150,720961980,10425,10426,10427,2,0.02,10426,1,0.01,10426,10430,1399-10-1
739,عيار2,صندوق س. پشتوانه طلاي مفيد,10,100000,100000,28811,1,1,-28810,-100.0,1,-28810,-100.0,1,1,1399-10-1
740,ضترا1117,اختيارخ شتران-10000-1399/11/14,10,141,371505000,3005,3000,2700,-305,-10.15,2635,-370,-12.31,2300,3000,1399-10-1
741,اخزا905,اسنادخزانه-م5بودجه99-020218,10,43765,27746402152,630301,633900,634000,3699,0.59,633986,3685,0.58,633900,634000,1399-10-1
742,ضچاد1013,اختيارخ كچاد-12000-1399/10/02,9,252,2110499000,8573,8500,7900,-673,-7.85,8375,-198,-2.31,7900,8700,1399-10-1
743,ضپيك1019,اختيارخ تاپيكو-12000-99/10/16,9,126,374054000,3557,3800,2700,-857,-24.09,2969,-588,-16.53,2700,3800,1399-10-1
744,ضسپا1105,اختيارخ خساپا-3500-1399/11/26,9,102,26457000,229,370,221,-8,-3.49,259,30,13.1,200,370,1399-10-1
745,ضملت1124,اختيارخ وبملت-3500-1399/11/28,9,165,295635000,1900,1900,1750,-150,-7.89,1792,-108,-5.68,1701,1900,1399-10-1
746,زعف0008پ08,زعفران0008نگين روستا(پ),8,4483,577324000,127824,128500,129000,1176,0.92,128781,957,0.75,128000,129000,1399-10-1
747,ضخوز1014,اختيارخ فخوز-12191-1399/10/16,8,16,182970375,9477,4501,4200,-5277,-55.68,4356,-5121,-54.04,3501,4501,1399-10-1
748,اخزا721,اسنادخزانه-م21بودجه97-000728,8,2710,2339914227,862131,862551,862553,422,0.05,863437,1306,0.15,862551,865000,1399-10-1
749,ضملي1149,اختيارخ فملي-12168-1399/11/05,8,56,438629988,4331,3900,4000,-331,-7.64,3972,-359,-8.29,3900,4331,1399-10-1
750,ضملي1153,اختيارخ فملي-20280-1399/11/05,8,107,76758128,383,400,251,-132,-34.46,364,-19,-4.96,251,400,1399-10-1
751,ضصاد1106,اختيارخ وبصادر-6000-1399/11/12,7,405,20739000,34,40,35,1,2.94,51,17,50.0,35,69,1399-10-1
752,ضپاس1006,اختيارخ وپارس-5000-1399/10/30,7,87,9105000,200,280,100,-100,-50.0,105,-95,-47.5,100,280,1399-10-1
753,اخزا720,اسنادخزانه-م20بودجه97-000324,7,22694,20832447000,911982,915000,918000,6018,0.66,917972,5990,0.66,915000,918000,1399-10-1
754,ومشان,س. فني و مهندسي مشانير,7,1611,91878552,58795,57032,57032,-1763,-3.0,58787,-8,-0.01,57032,57032,1399-10-1
755,ضخود1047,اختيارخ خودرو-6000-1399/10/07,7,540,1080000,4,2,2,-2,-50.0,2,-2,-50.0,2,2,1399-10-1
756,شستا991,اجاره تامين اجتماعي-امين991226,7,113,111442724,1002573,1009996,982041,-20532,-2.05,986219,-16354,-1.63,980010,1009996,1399-10-1
757,كرونا2,تامين مالي جمعي صرفا اهداي سود,7,394,3940000,10000,10000,10000,0,0.0,10000,0,0.0,10000,10000,1399-10-1
758,وسفارس,شركت س استان فارس,7,42870,42012600,1030,980,980,-50,-4.85,1030,0,0.0,980,980,1399-10-1
759,هفارس912,اختيارف ت فارس-14576-99/12/13,6,31276,24176348,965,773,773,-192,-19.9,773,-192,-19.9,773,773,1399-10-1
760,وسرضوي,س.سهام عدالت استان خراسان رضوي,6,68175,66811500,1030,980,980,-50,-4.85,1030,0,0.0,980,980,1399-10-1
761,ضملت1123,اختيارخ وبملت-3000-1399/11/28,6,49,110007000,2202,2300,2300,98,4.45,2245,43,1.95,2001,2450,1399-10-1
762,هاباد912,اختيارف ت آبادا-30100-99/12/12,6,22218,229534158,10112,10331,10331,219,2.17,10331,219,2.17,10331,10331,1399-10-1
763,سرو2,صندوق س سروسودمند مدبران-سهام,6,600000,600000,73350,1,1,-73349,-100.0,1,-73349,-100.0,1,1,1399-10-1
764,ياقوت2,صندوق س ياقوت آگاه-ثابت,6,7326880,7326880,11622,1,1,-11621,-99.99,1,-11621,-99.99,1,1,1399-10-1
765,ضپيك1020,اختيارخ تاپيكو-14000-99/10/16,6,29,37250000,1415,1350,1250,-165,-11.66,1284,-131,-9.26,1200,1350,1399-10-1
766,خعمرا,توسعه و عمران شهرستان نائين,6,9278,204784016,21430,22072,22072,642,3.0,21436,6,0.03,22072,22072,1399-10-1
767,تصميم2,صندوق س با درآمد ثابت تصميم,6,6000000,6000000,15224,1,1,-15223,-99.99,1,-15223,-99.99,1,1,1399-10-1
768,دمعيار2,صندوق س. توازن معيار-د,6,50500000,50500000,10154,1,1,-10153,-99.99,1,-10153,-99.99,1,1,1399-10-1
769,ضپاس1001,اختيارخ وپارس-2500-1399/10/30,5,30,40302000,1642,1343,1350,-292,-17.78,1343,-299,-18.21,1250,1350,1399-10-1
770,ضملت1126,اختيارخ وبملت-4500-1399/11/28,5,126,121264000,1053,957,980,-73,-6.93,962,-91,-8.64,957,1001,1399-10-1
771,كشم0001پ01,كشمش سبز0001خليل آباد(پ),5,173,57639100,341152,347000,330000,-11152,-3.27,333174,-7978,-2.34,330000,347000,1399-10-1
772,اخزا807,اسنادخزانه-م7بودجه98-000719,5,3338,2891877757,865932,866351,866350,418,0.05,866350,418,0.05,866350,866351,1399-10-1
773,هبركت912,اختيارف ت بركت-22100-99/12/17,5,128000,128000,1,1,1,0,0.0,1,0,0.0,1,1,1399-10-1
774,شتهران,داروسازي تهران شيمي,5,16467,129117747,7688,7841,7841,153,1.99,7690,2,0.03,7841,7841,1399-10-1
775,ضپار1117,اختيارخ خپارس-7000-1399/11/19,5,109,180146000,1622,1765,1600,-22,-1.36,1653,31,1.91,1600,1765,1399-10-1
776,ضمخا1025,اختيارخ اخابر-16000-1399/10/30,5,45,36000000,534,800,800,266,49.81,800,266,49.81,800,800,1399-10-1
777,ضخوز1013,اختيارخ فخوز-10667-1399/10/16,5,6,106575000,12880,7500,6600,-6280,-48.76,6767,-6113,-47.46,6500,7500,1399-10-1
778,ضجار1010,اختيارخ وتجارت-1600-1399/10/21,5,25,43815000,2500,2000,1485,-1015,-40.6,1753,-747,-29.88,1485,2000,1399-10-1
779,ضخوز1015,اختيارخ فخوز-13715-1399/10/16,5,16,152147625,7000,3800,3161,-3839,-54.84,3623,-3377,-48.24,3161,3999,1399-10-1
780,افران2,صندوق س افرا نماد پايدار-ثابت,5,500000,500000,12308,1,1,-12307,-99.99,1,-12307,-99.99,1,1,1399-10-1
781,اخزا704,اسنادخزانه-م4بودجه97-991022,5,2412,2387880000,989998,990000,990000,2,0.0,990000,2,0.0,990000,990000,1399-10-1
782,ضملي1154,اختيارخ فملي-24336-1399/11/05,5,401,95547344,137,120,452,315,229.93,121,-16,-11.68,120,452,1399-10-1
783,تسه99072,امتياز تسهيلات مسكن مهر99,5,242,2420,594716,10,10,-594706,-100.0,10,-594706,-100.0,10,10,1399-10-1
784,ضشنا1037,اختيارخ شپنا-18000-1399/10/23,4,27,23000000,814,1000,800,-14,-1.72,852,38,4.67,800,1000,1399-10-1
785,پست0008پ09,پسته بادامي30-28مه ولات0008(پ),4,48,65559810,1435081,1370000,1370000,-65081,-4.54,1365829,-69252,-4.83,1363327,1370000,1399-10-1
786,اخزا723,اسنادخزانه-م23بودجه97-000824,4,69,58766294,851272,851681,851686,414,0.05,851685,413,0.05,851681,851686,1399-10-1
787,ضخود2011,اختيارخ خودرو-5000-1400/02/08,4,36,12066000,599,337,334,-265,-44.24,335,-264,-44.07,334,337,1399-10-1
788,ضپار1116,اختيارخ خپارس-6000-1399/11/19,4,26,55634000,2420,2200,2100,-320,-13.22,2140,-280,-11.57,2100,2200,1399-10-1
789,ضپاس1004,اختيارخ وپارس-4000-1399/10/30,4,15,7913000,505,848,500,-5,-0.99,528,23,4.55,500,848,1399-10-1
790,ضخود2006,اختيارخ خودرو-2500-1400/02/08,4,65,91560000,1636,1500,1401,-235,-14.36,1409,-227,-13.88,1401,1500,1399-10-1
791,ضپنا1022,اختيارخ رمپنا-18806-1399/10/09,4,16,39972190,2022,1500,1500,-522,-25.82,1687,-335,-16.57,1500,2000,1399-10-1
792,ضشنا1045,اختيارخ شپنا-12000-1399/10/23,4,20,53026000,3594,2900,2900,-694,-19.31,2651,-943,-26.24,1542,2900,1399-10-1
793,شرق1400,مشاركت ليزينگ ايران وشرق140010,4,72,72000000,998248,1000000,1000000,1752,0.18,1000000,1752,0.18,1000000,1000000,1399-10-1
794,شستا992,اجاره تامين اجتماعي-سپهر991226,3,25,25124975,1000000,1004999,1004999,4999,0.5,1004999,4999,0.5,1004999,1004999,1399-10-1
795,ضغدر1118,اختيارخ وغدير-9000-1399/11/26,3,5,18246000,3667,4000,3200,-467,-12.74,3649,-18,-0.49,3200,4000,1399-10-1
796,ضمخا1023,اختيارخ اخابر-12000-1399/10/30,3,17,35079000,6005,2003,2210,-3795,-63.2,2063,-3942,-65.65,2002,2210,1399-10-1
797,تملي803,تسهيلات مسكن ب. ملي-خرداد98,3,23,18112523,750001,787501,787501,37500,5.0,787501,37500,5.0,787501,787501,1399-10-1
798,وسگلستا,شركت س استان گلستان,3,25700,30326000,1240,1180,1180,-60,-4.84,1240,0,0.0,1180,1180,1399-10-1
799,ضفار1120,اختيارخ فارس-8826-1399/11/07,3,6,60400000,5455,5200,5000,-455,-8.34,5033,-422,-7.74,5000,5200,1399-10-1
800,اخزا716,اسنادخزانه-م16بودجه97-000407,3,29796,27264826152,911450,915050,915042,3592,0.39,915050,3600,0.39,915042,915050,1399-10-1
801,ضصاد1105,اختيارخ وبصادر-5000-1399/11/12,3,112,10052000,101,101,100,-1,-0.99,90,-11,-10.89,80,101,1399-10-1
802,ضغدر1121,اختيارخ وغدير-14000-1399/11/26,3,144,272000000,2080,1980,900,-1180,-56.73,1889,-191,-9.18,900,2000,1399-10-1
803,ضملت1127,اختيارخ وبملت-5000-1399/11/28,3,91,63807000,729,700,726,-3,-0.41,701,-28,-3.84,700,729,1399-10-1
804,اخزا805,اسنادخزانه-م5بودجه98-000422,3,18654,16956830570,907234,913000,909001,1767,0.19,909018,1784,0.2,909000,913000,1399-10-1
805,ضملي1150,اختيارخ فملي-14196-1399/11/05,3,90,532440000,3333,3000,3000,-333,-9.99,3000,-333,-9.99,3000,3000,1399-10-1
806,ضپيك1021,اختيارخ تاپيكو-16000-99/10/16,3,12,3598000,233,499,260,27,11.59,300,67,28.76,260,499,1399-10-1
807,پست0008پ04,پسته فندقي32-30سبزدانه0008(پ),3,33,48925370,1543336,1580000,1480000,-63336,-4.1,1482587,-60749,-3.94,1448537,1580000,1399-10-1
808,اخزا804,اسنادخزانه-م4بودجه98-000421,3,8301,7523411594,926154,906204,907001,-19153,-2.07,906326,-19828,-2.14,906204,907001,1399-10-1
809,ضشنا1044,اختيارخ شپنا-10000-1399/10/23,3,23,108500000,6100,5000,4500,-1600,-26.23,4717,-1383,-22.67,4500,5000,1399-10-1
810,ونچر,ص.ج.فيروزه10%تاديه,3,2700,340230000,125464,126020,126000,536,0.43,126011,547,0.44,126000,126020,1399-10-1
811,ضترا1127,اختيارخ شتران-8000-1399/11/14,3,6,26010000,5883,4800,4101,-1782,-30.29,4335,-1548,-26.31,4101,4800,1399-10-1
812,وسكرشا,س.سهام عدالت استان كرمانشاه,3,15000,18000000,1260,1200,1200,-60,-4.76,1260,0,0.0,1200,1200,1399-10-1
813,وسيزد,شركت س استان يزد,3,66653,81316660,1280,1220,1220,-60,-4.69,1280,0,0.0,1220,1220,1399-10-1
814,شسم,توليد سموم‌ علف‌ كش,3,911,80853072,87012,88752,88752,1740,2.0,87026,14,0.02,88752,88752,1399-10-1
815,ضپنا1023,اختيارخ رمپنا-21506-1399/10/09,2,2,2665800,1600,1000,800,-800,-50.0,900,-700,-43.75,800,1000,1399-10-1
816,تملي701,تسهيلات مسكن ب. ملي-فروردين97,2,36,32362488,946271,898958,898958,-47313,-5.0,898958,-47313,-5.0,898958,898958,1399-10-1
817,صفارس037,صكوك اجاره فارس037- 3ماهه18%,2,20,19550000,1000000,950000,1005000,5000,0.5,977500,-22500,-2.25,950000,1005000,1399-10-1
818,سميعا002,سلف موازي استاندارد سميعا002,2,211620,258370243920,1200549,1220916,1220916,20367,1.7,1220916,20367,1.7,1220916,1220916,1399-10-1
819,صايپا203,صكوك مرابحه سايپا203-3ماهه 16%,2,3006,2870712786,952131,952131,955000,2869,0.3,954994,2863,0.3,952131,955000,1399-10-1
820,اخزا718,اسنادخزانه-م18بودجه97-000525,2,2405,2141298833,888289,890350,890353,2064,0.23,890353,2064,0.23,890350,890353,1399-10-1
821,ضگل1141,اختيارخ كگل-14000-1399/11/21,2,10,41750000,5900,4200,4150,-1750,-29.66,4175,-1725,-29.24,4150,4200,1399-10-1
822,سپرمي,پرميت‌,2,23292,196514604,8354,8437,8437,83,0.99,8357,3,0.04,8437,8437,1399-10-1
823,زير0003پ01,زيره سبز0003كيميابذر(پ),2,20,9999800,482106,499990,499990,17884,3.71,499990,17884,3.71,499990,499990,1399-10-1
824,وسزنجان,شركت س استان زنجان,2,8061,10882350,1420,1350,1350,-70,-4.93,1420,0,0.0,1350,1350,1399-10-1
825,ضفار1123,اختيارخ فارس-13826-1399/11/07,2,18,54000000,2450,1500,1500,-950,-38.78,1500,-950,-38.78,1500,1500,1399-10-1
826,ضپار1115,اختيارخ خپارس-5000-1399/11/19,2,49,151504000,2040,3100,3001,961,47.11,3092,1052,51.57,3001,3100,1399-10-1
827,تهران012,مشاركت ش تهران012-3ماهه18%,2,701,680180300,970300,970300,970300,0,0.0,970300,0,0.0,970300,970300,1399-10-1
828,ضپيك1023,اختيارخ تاپيكو-20000-99/10/16,2,11,1061000,102,101,51,-51,-50.0,96,-6,-5.88,51,101,1399-10-1
829,ضسپا1100,اختيارخ خساپا-1600-1399/11/26,2,6,6700000,1196,1200,1100,-96,-8.03,1117,-79,-6.61,1100,1200,1399-10-1
830,وسهمدا,شركت س استان همدان,2,17328,14728800,890,850,850,-40,-4.49,890,0,0.0,850,850,1399-10-1
831,اخزا722,اسنادخزانه-م22بودجه97-000428,2,7129,6437772285,900431,904001,903000,2569,0.29,903040,2609,0.29,903000,904001,1399-10-1
832,ضبدر1150,اختيارخ شبندر-32000-1399/11/19,2,89,240300000,2979,2700,2700,-279,-9.37,2700,-279,-9.37,2700,2700,1399-10-1
833,شگامرن,مجتمع پترو صنعت گامرون,2,16000,4235200000,259600,264700,264700,5100,1.96,264700,5100,1.96,264700,264700,1399-10-1
834,وساربيل,شركت س استان اردبيل,2,20000,24400000,1280,1220,1220,-60,-4.69,1280,0,0.0,1220,1220,1399-10-1
835,زعف0008پ09,زعفران0008نگين نوين(پ),2,999,128871000,128943,129000,129000,57,0.04,129000,57,0.04,129000,129000,1399-10-1
836,وسخراج,شركت س استان خراسان جنوبي,2,16383,34568130,2220,2110,2110,-110,-4.95,2220,0,0.0,2110,2110,1399-10-1
837,زير0003پ02,زيره سبز0003 دانش(پ),2,30,13740030,482106,458001,458001,-24105,-5.0,458001,-24105,-5.0,458001,458001,1399-10-1
838,كابگن,توليدي و صنعتي آبگينه‌,2,6000,30312000,5002,5052,5052,50,1.0,5002,0,0.0,5052,5052,1399-10-1
839,اتكاي2,بيمه اتكايي ايرانيان,1,39900000,695616600000,17434,17434,17434,0,0.0,17434,0,0.0,17434,17434,1399-10-1
840,وكار2,بانك‌ كارآفرين‌,1,268000000,1211360000000,4550,4520,4520,-30,-0.66,4520,-30,-0.66,4520,4520,1399-10-1
841,اراد62,مرابحه عام دولت62-ش.خ0309,1,20000,20000000000,1000000,1000000,1000000,0,0.0,1000000,0,0.0,1000000,1000000,1399-10-1
842,فملي2,ملي‌ صنايع‌ مس‌ ايران‌,1,75000000,1207500000000,15900,16100,16100,200,1.26,16100,200,1.26,16100,16100,1399-10-1
843,ضخوز1017,اختيارخ فخوز-18286-1399/10/16,1,5,13125000,1800,1000,1000,-800,-44.44,1000,-800,-44.44,1000,1000,1399-10-1
844,مكرج112,مشاركت شهرداري كرج-3ماهه18%,1,100,94800000,973000,948000,948000,-25000,-2.57,948000,-25000,-2.57,948000,948000,1399-10-1
845,واتي2,سرمايه‌ گذاري‌ آتيه‌ دماوند,1,3900000,58812000000,14920,15080,15080,160,1.07,15080,160,1.07,15080,15080,1399-10-1
846,ونيكي4,سرمايه‌گذاري‌ ملي‌ايران‌,1,5000000,104050000000,20700,20810,20810,110,0.53,20810,110,0.53,20810,20810,1399-10-1
847,ضمخا1024,اختيارخ اخابر-14000-1399/10/30,1,3,6000000,2034,2000,2000,-34,-1.67,2000,-34,-1.67,2000,2000,1399-10-1
848,ضمخا1026,اختيارخ اخابر-18000-1399/10/30,1,5,55000,1600,11,11,-1589,-99.31,11,-1589,-99.31,11,11,1399-10-1
849,شيراز2,پتروشيمي‌شيراز,1,1000000,56160000000,55500,56160,56160,660,1.19,56160,660,1.19,56160,56160,1399-10-1
850,زعف0008پ12,زعفران0008پوشالمعمول سحرخيز(پ),1,1500,132750000,88038,88500,88500,462,0.52,88500,462,0.52,88500,88500,1399-10-1
851,شغدير4,پتروشيمي غدير,1,6500000,463268000000,71951,71272,71272,-679,-0.94,71272,-679,-0.94,71272,71272,1399-10-1
852,عفولاد2,اوراق سلف ورق گرم فولاد مباركه,1,4,2332388,580823,583097,583097,2274,0.39,583097,2274,0.39,583097,583097,1399-10-1
853,مبين015,اجاره اعتماد مبين تمدن011019,1,100,93210000,941500,932100,932100,-9400,-1.0,932100,-9400,-1.0,932100,932100,1399-10-1
854,هجرت4,پخش هجرت,1,2250000,79731000000,35124,35436,35436,312,0.89,35436,312,0.89,35436,35436,1399-10-1
855,ضغدر1119,اختيارخ وغدير-10000-1399/11/26,1,5,18000000,3729,3600,3600,-129,-3.46,3600,-129,-3.46,3600,3600,1399-10-1
856,صخابر102,صكوك اجاره مخابرات-3 ماهه 16%,1,3000,2850000000,959980,950000,950000,-9980,-1.04,950000,-9980,-1.04,950000,950000,1399-10-1
857,گندم24,مرابحه گندم2-واجدشرايط خاص1400,1,1259000,1233820000000,967335,980000,980000,12665,1.31,980000,12665,1.31,980000,980000,1399-10-1
858,ضفلا1158,اختيارخ فولاد-20000-1399/11/28,1,2,600000,550,300,300,-250,-45.45,300,-250,-45.45,300,300,1399-10-1
859,تسه98112,امتياز تسهيلات مسكن بهمن98,1,14,140,579817,10,10,-579807,-100.0,10,-579807,-100.0,10,10,1399-10-1
860,حرهشا,رهشاد سپاهان (سهامي عام,1,90,5343030,61203,59367,59367,-1836,-3.0,61202,-1,0.0,59367,59367,1399-10-1
861,ضترا1128,اختيارخ شتران-9000-1399/11/14,1,3,10953000,4940,3651,3651,-1289,-26.09,3651,-1289,-26.09,3651,3651,1399-10-1
862,تسه98102,امتياز تسهيلات مسكن دي98,1,26,260,575080,10,10,-575070,-100.0,10,-575070,-100.0,10,10,1399-10-1
863,اشاد10,مشاركت دولتي10-شرايط خاص001226,1,200,190000000,950000,950000,950000,0,0.0,950000,0,0.0,950000,950000,1399-10-1
864,شستا993,اجاره ت.اجتماعي-كاردان991226,1,8,8000000,1000313,1000000,1000000,-313,-0.03,1000000,-313,-0.03,1000000,1000000,1399-10-1
865,ضسان1046,اختيارخ پارسان-14000-99/10/14,1,1,7323000,4469,7323,7323,2854,63.86,7323,2854,63.86,7323,7323,1399-10-1
866,ضفار1126,اختيارخ فارس-19826-1399/11/07,1,10,4000000,212,200,200,-12,-5.66,200,-12,-5.66,200,200,1399-10-1
867,ضجار1012,اختيارخ وتجارت-2000-1399/10/21,1,1,1380000,1743,1380,1380,-363,-20.83,1380,-363,-20.83,1380,1380,1399-10-1
868,هغدير912,اختيارف ت غدير-17380-99/12/16,1,631,2349844,3775,3724,3724,-51,-1.35,3724,-51,-1.35,3724,3724,1399-10-1
869,صايپا012,صكوك مرابحه سايپا012-3ماهه 16%,1,15,15000015,1000001,1000001,1000001,0,0.0,1000001,0,0.0,1000001,1000001,1399-10-1
870,كگل2,معدني و صنعتي گل گهر,1,2200000,39600000000,18540,18000,18000,-540,-2.91,18000,-540,-2.91,18000,18000,1399-10-1
871,ضملي1151,اختيارخ فملي-16224-1399/11/05,1,5,19720000,1950,2000,2000,50,2.56,2000,50,2.56,2000,2000,1399-10-1
872,پسهند4,صنايع‌ لاستيكي‌  سهند,1,1750000,77542500000,42580,44310,44310,1730,4.06,44310,1730,4.06,44310,44310,1399-10-1
873,ضگل1144,اختيارخ كگل-20000-1399/11/21,1,43,86000000,1787,2000,2000,213,11.92,2000,213,11.92,2000,2000,1399-10-1
874,اراد624,مرابحه عام دولت62-ش.خ0309,1,500000,500000000000,1000000,1000000,1000000,0,0.0,1000000,0,0.0,1000000,1000000,1399-10-1
875,ضچاد2004,اختيارخ كچاد-20000-1400/02/05,1,1,6100000,4643,6100,6100,1457,31.38,6100,1457,31.38,6100,6100,1399-10-1
876,صمسكن912,ص دين مسكن جنوب-ماهانه16درصد,1,180,9830700,57489,54615,54615,-2874,-5.0,54615,-2874,-5.0,54615,54615,1399-10-1
877,ضسپا1101,اختيارخ خساپا-1800-1399/11/26,1,6,5400000,1000,900,900,-100,-10.0,900,-100,-10.0,900,900,1399-10-1
878,اطلس2,صندوق س.توسعه اندوخته آينده-س,1,10000,10000,211721,1,1,-211720,-100.0,1,-211720,-100.0,1,1,1399-10-1
879,تملي705,تسهيلات مسكن ب. ملي-مرداد97,1,6,5455854,957167,909309,909309,-47858,-5.0,909309,-47858,-5.0,909309,909309,1399-10-1
880,واعتبار2,سرمايه گذاري اعتبار ايران,1,7000000,53690000000,7310,7670,7670,360,4.92,7670,360,4.92,7670,7670,1399-10-1
881,ضمخا7069,اختيارخ اخابر-18000-1400/07/28,1,2,10000000,5000,5000,5000,0,0.0,5000,0,0.0,5000,5000,1399-10-1
882,وسيلام,شركت س استان ايلام,1,4300,5074000,1240,1180,1180,-60,-4.84,1240,0,0.0,1180,1180,1399-10-1
883,ضپنا1021,اختيارخ رمپنا-16106-1399/10/09,1,20,118480000,3665,4000,4000,335,9.14,4000,335,9.14,4000,4000,1399-10-1
884,گندم2,مرابحه گندم2-واجدشرايط خاص1400,1,1000,990000000,967335,990000,990000,22665,2.34,990000,22665,2.34,990000,990000,1399-10-1
885,ضبدر1149,اختيارخ شبندر-28000-1399/11/19,1,10,40000000,4713,4000,4000,-713,-15.13,4000,-713,-15.13,4000,4000,1399-10-1
886,ضمخا7066,اختيارخ اخابر-12000-1400/07/28,1,1,6000000,7523,6000,6000,-1523,-20.24,6000,-1523,-20.24,6000,6000,1399-10-1
