,نماد,نام,تعداد,حجم,ارزش,دیروز,اولین,آخرین معامله - مقدار,آخرین معامله - تغییر,آخرین معامله - درصد,قیمت پایانی - مقدار,قیمت پایانی - تغییر,قیمت پایانی - درصد,کمترین,بیشترین,تاریخ
0,شپنا,پالايش نفت اصفهان,81945,409433946,5791953720890,14310,13990,14430,120,0.84,14150,-160,-1.12,13660,14740,1399-10-2
1,شستا,سرمايه گذاري تامين اجتماعي,73947,189573781,4571129123590,24460,24000,24190,-270,-1.1,24110,-350,-1.43,23650,24810,1399-10-2
2,بوعلي,پتروشيمي بوعلي سينا,70051,13068350,799783020000,58290,61200,61200,2910,4.99,61200,2910,4.99,61200,61200,1399-10-2
3,پالايش,صندوق پالايشي يکم-سهام,59822,33578022,2991453930920,89510,88100,90460,950,1.06,89090,-420,-0.47,86660,91300,1399-10-2
4,خودرو,ايران‌ خودرو,48488,1207705349,4224372943870,3380,3330,3540,160,4.73,3500,120,3.55,3280,3540,1399-10-2
5,وتجارت,بانك تجارت,43785,964724451,3281340021930,3320,3260,3480,160,4.82,3400,80,2.41,3210,3480,1399-10-2
6,وسپهر,سرمايه گذاري مالي سپهرصادرات,42882,91847163,1022471634504,11240,11150,11130,-110,-0.98,11132,-108,-0.96,11004,11340,1399-10-2
7,خساپا,سايپا,41311,1384573289,3552749607370,2480,2420,2600,120,4.84,2570,90,3.63,2380,2600,1399-10-2
8,بپيوند,برق و انرژي پيوندگستر پارس,37900,36157959,1167199644113,32873,32010,31845,-1028,-3.13,32281,-592,-1.8,31000,33650,1399-10-2
9,دارا يكم,صندوق واسطه گري مالي يكم-سهام,36622,14850949,2617227577860,174820,174110,178450,3630,2.08,176230,1410,0.81,173000,178950,1399-10-2
10,دي,بانك دي,32759,65104979,2845821204791,43862,42510,43940,78,0.18,43711,-151,-0.34,42510,45000,1399-10-2
11,سيتا,سرمايه گذاري سيمان تامين,29915,41103684,691579212770,16840,16650,16850,10,0.06,16830,-10,-0.06,16600,17090,1399-10-2
12,فملي,ملي‌ صنايع‌ مس‌ ايران‌,29889,95482367,1498188147560,15910,15990,15770,-140,-0.88,15690,-220,-1.38,15400,16000,1399-10-2
13,ثاميد,توسعه و عمران اميد,28773,293648422,659207057020,2270,2280,2260,-10,-0.44,2240,-30,-1.32,2210,2330,1399-10-2
14,وكبهمن,مديريت سرمايه گذاري كوثربهمن,26391,1413006,26735486526,18020,18921,18921,901,5.0,18442,422,2.34,18921,18921,1399-10-2
15,شتران,پالايش نفت تهران,26282,115706289,1348301724940,11640,11340,11900,260,2.23,11650,10,0.09,11240,12050,1399-10-2
16,فولاد,فولاد مباركه اصفهان,26208,154424442,2201296468330,14330,14100,14240,-90,-0.63,14250,-80,-0.56,14070,14450,1399-10-2
17,زملارد,كشاورزي و دامپروري ملارد شير,25367,7036281,299931747736,44103,43270,42510,-1593,-3.61,42626,-1477,-3.35,41898,44890,1399-10-2
18,شبندر,پالايش نفت بندرعباس,25321,89536260,2613146072630,28350,28000,29760,1410,4.97,29190,840,2.96,27600,29760,1399-10-2
19,چخزر,صنايع چوب خزر كاسپين,25131,169896,4829463696,27073,28426,28426,1353,5.0,27196,123,0.45,28426,28426,1399-10-2
20,آبادا,توليد نيروي برق آبادان,25082,20825957,369146737780,18010,17700,17820,-190,-1.05,17730,-280,-1.55,17110,18200,1399-10-2
21,بگيلان,توسعه مسير برق گيلان,24588,10554112,277331935661,26545,26982,25964,-581,-2.19,26277,-268,-1.01,25700,26982,1399-10-2
22,امين,تامين سرمايه امين,22507,23169451,263364615360,11650,11570,11370,-280,-2.4,11370,-280,-2.4,11280,11600,1399-10-2
23,وآيند,بانك  آينده,22040,145897501,3256696165107,23156,22230,22400,-756,-3.26,22322,-834,-3.6,22230,22879,1399-10-2
24,ثبهساز,بهساز كاشانه تهران,21911,102945736,287460554880,2780,2740,2800,20,0.72,2790,10,0.36,2730,2850,1399-10-2
25,غزر,صنعتي زر ماكارون,20949,3349450,197519032120,58900,60000,57700,-1200,-2.04,58970,70,0.12,56890,60500,1399-10-2
26,حكشتي,كشتيراني جمهوري اسلامي ايران,20134,48235069,1241872045290,25410,25000,26350,940,3.7,25750,340,1.34,24700,26480,1399-10-2
27,شاروم,پتروشيمي اروميه,19863,12992471,425431304765,31229,32790,32790,1561,5.0,32744,1515,4.85,32000,32790,1399-10-2
28,پتاير,ايران‌ تاير,19338,13848082,2567501342770,193660,183980,183980,-9680,-5.0,185400,-8260,-4.27,183980,193700,1399-10-2
29,وبصادر,بانك صادرات ايران,19127,413042691,1292044290180,3040,3010,3190,150,4.93,3130,90,2.96,2970,3190,1399-10-2
30,خگستر,گسترش‌سرمايه‌گذاري‌ايران‌خودرو,19058,369924049,1588621401090,4180,4100,4380,200,4.78,4290,110,2.63,4040,4380,1399-10-2
31,زدشت,كشت و صنعت دشت خرم دره,18633,22097998,1457744671510,67443,66500,64340,-3103,-4.6,65967,-1476,-2.19,63810,69300,1399-10-2
32,دانا,بيمه دانا,17475,180333113,2029743492690,10940,11480,11020,80,0.73,11260,320,2.93,10600,11480,1399-10-2
33,پيزد,مجتمع صنايع لاستيك يزد,16891,2496678,228579036188,88536,91000,91330,2794,3.16,91553,3017,3.41,89000,92960,1399-10-2
34,وبملت,بانك ملت,16522,243220607,1210869795880,4880,4770,5090,210,4.3,4980,100,2.05,4770,5090,1399-10-2
35,پترول,گروه پتروشيمي س. ايرانيان,16429,73624386,895242963570,12170,12400,12210,40,0.33,12160,-10,-0.08,11840,12460,1399-10-2
36,انرژي3,سايراشخاص بورس انرژي,16312,3137838,1190755665020,380320,386000,370000,-10320,-2.71,379480,-840,-0.22,365000,396000,1399-10-2
37,آريا,پليمر آريا ساسول,16268,2546947,470012142423,187748,184000,186000,-1748,-0.93,184539,-3209,-1.71,182011,189900,1399-10-2
38,گدنا,تهيه توزيع غذاي دنا آفرين فدك,15324,509112,22587772104,42255,44367,44367,2112,5.0,43082,827,1.96,44367,44367,1399-10-2
39,كرمان,س. توسعه و عمران استان كرمان,15267,16313319,1469048196159,89258,92500,89300,42,0.05,90052,794,0.89,87110,92500,1399-10-2
40,ذوب,سهامي ذوب آهن  اصفهان,14764,167206505,927440420035,5582,5450,5601,19,0.34,5547,-35,-0.63,5403,5749,1399-10-2
41,وپويا,سرمايه گذاري پويا,14411,25308445,208966222749,8309,8251,8230,-79,-0.95,8257,-52,-0.63,8102,8500,1399-10-2
42,فروي,ذوب روي اصفهان,13548,11772051,853228426936,69561,72780,73039,3478,5.0,72479,2918,4.19,70841,73039,1399-10-2
43,شگويا,پتروشيمي تندگويان,13521,61521803,705972627814,11505,11650,11600,95,0.83,11475,-30,-0.26,11200,11750,1399-10-2
44,ونيكي,سرمايه‌گذاري‌ ملي‌ايران‌,13366,52866373,1154144777040,20810,21850,21850,1040,5.0,21830,1020,4.9,21300,21850,1399-10-2
45,ثنوسا,نوسازي‌وساختمان‌تهران‌,12802,114457719,1823325438890,15630,14850,16410,780,4.99,15930,300,1.92,14850,16410,1399-10-2
46,وپارس,بانك‌پارسيان‌,12200,448449160,1877299310160,4010,4000,4210,200,4.99,4190,180,4.49,3940,4210,1399-10-2
47,ختوقا,قطعات‌ اتومبيل‌ ايران‌,12018,209109756,928204381920,4280,4150,4490,210,4.91,4440,160,3.74,4150,4490,1399-10-2
48,ونوين,بانك‌اقتصادنوين‌,11134,197574294,1133947797650,5550,5650,5820,270,4.86,5740,190,3.42,5570,5820,1399-10-2
49,وحكمت,بيمه حكمت صبا,11052,83932662,523366065520,6247,6434,6320,73,1.17,6236,-11,-0.18,6060,6434,1399-10-2
50,وغدير,سرمايه‌گذاري‌غدير(هلدينگ‌,10921,47403640,598327246810,12840,12460,12640,-200,-1.56,12620,-220,-1.71,12420,12900,1399-10-2
51,ديران,ايران‌دارو,10857,29752813,830432985160,28860,27420,28250,-610,-2.11,27910,-950,-3.29,27420,28900,1399-10-2
52,فخوز,فولاد  خوزستان,10767,35771988,605401075340,17090,17220,16770,-320,-1.87,16920,-170,-0.99,16420,17490,1399-10-2
53,رافزا,رايان هم افزا,10730,72559,2819425063,37007,38857,38857,1850,5.0,37106,99,0.27,38857,38857,1399-10-2
54,چكاپا,گروه صنايع كاغذ پارس,10492,86785552,645335061850,7570,7360,7500,-70,-0.92,7440,-130,-1.72,7230,7680,1399-10-2
55,حسينا,توسعه خدمات دريايي وبندري سينا,9792,8149989,788879098706,98012,94600,95800,-2212,-2.26,96795,-1217,-1.24,93001,101000,1399-10-2
56,وخارزم,سرمايه گذاري خوارزمي,9520,59542034,614231993410,10260,10300,10480,220,2.14,10320,60,0.58,10100,10500,1399-10-2
57,شبريز,پالايش نفت تبريز,9386,32826000,1061928465490,30980,31000,32520,1540,4.97,32350,1370,4.42,30500,32520,1399-10-2
58,وملي,گروه‌ صنعتي‌ ملي‌ (هلدينگ‌,9282,2447279,746821522110,310590,305000,305500,-5090,-1.64,305160,-5430,-1.75,299100,317000,1399-10-2
59,تكمبا,كمباين‌ سازي‌ ايران‌,9160,68817479,862339295900,12430,13050,12050,-380,-3.06,12530,100,0.8,11820,13050,1399-10-2
60,تملت,تامين سرمايه بانك ملت,8985,47613087,489072431640,10690,10690,10170,-520,-4.86,10270,-420,-3.93,10160,10740,1399-10-2
61,خكمك,كمك‌فنرايندامين‌,8826,16779989,732969510830,43200,41040,45270,2070,4.79,43680,480,1.11,41040,45360,1399-10-2
62,داراب,پتروشيمي داراب,8742,144353618,420951581144,2870,2727,3013,143,4.98,2916,46,1.6,2727,3013,1399-10-2
63,خصدرا,صنعتي‌ دريايي‌ ايران‌,8502,79592804,401117847252,5080,4981,5070,-10,-0.2,5040,-40,-0.79,4960,5150,1399-10-2
64,فرابورس,فرابورس ايران,8344,12072514,713532423774,59844,57550,57999,-1845,-3.08,59104,-740,-1.24,57382,61000,1399-10-2
65,فاذر,صنايع‌ آذرآب‌,8334,13614386,525451234880,39360,39500,38510,-850,-2.16,38600,-760,-1.93,37510,40000,1399-10-2
66,ثاخت,بين‌المللي‌توسعه‌ساختمان,8215,214366527,1003332176450,4510,4500,4730,220,4.88,4680,170,3.77,4350,4730,1399-10-2
67,بزاگرس,نيروگاه زاگرس كوثر,8130,48641940,580238648428,12333,11717,12140,-193,-1.56,11929,-404,-3.28,11717,12288,1399-10-2
68,تبرك,گروه كارخانجات صنعتي تبرك,8060,16129790,412892557389,25974,26470,25140,-834,-3.21,25598,-376,-1.45,25000,26950,1399-10-2
69,بپاس,بيمه پاسارگاد,8019,6669406,705210470283,101392,106461,105000,3608,3.56,105738,4346,4.29,102600,106461,1399-10-2
70,هاي وب,داده گسترعصرنوين-هاي وب,7992,22324845,663262045830,30010,29970,29710,-300,-1.0,29710,-300,-1.0,29090,30610,1399-10-2
71,بكهنوج,توليد برق ماهتاب كهنوج,7928,136067405,377829348144,2784,2720,2800,16,0.57,2777,-7,-0.25,2701,2860,1399-10-2
72,غمينو,شركت صنايع غذايي مينو شرق,7853,24176812,388187464091,16545,15718,16450,-95,-0.57,16056,-489,-2.96,15718,16840,1399-10-2
73,ماديرا,صنايع ماشين هاي اداري ايران,7777,15480696,478926696632,31922,31400,30800,-1122,-3.51,30937,-985,-3.09,30326,32290,1399-10-2
74,سيمرغ,سيمرغ,7769,22312488,490127218350,21080,22130,21500,420,1.99,21970,890,4.22,21310,22130,1399-10-2
75,قثابت,قند ثابت‌ خراسان‌,7754,9546101,841897024410,86930,90780,86250,-680,-0.78,88190,1260,1.45,86250,91000,1399-10-2
76,لكما,كارخانجات‌مخابراتي‌ايران‌,7730,69187104,528553308672,7575,7348,7800,225,2.97,7639,64,0.84,7348,7802,1399-10-2
77,فارس,صنايع پتروشيمي خليج فارس,7581,23304963,301030664410,13270,12810,12870,-400,-3.01,12920,-350,-2.64,12720,13210,1399-10-2
78,دشيمي,شيمي‌ داروئي‌ داروپخش‌,7442,10345891,854918449050,81720,77640,85800,4080,4.99,82630,910,1.11,77640,85800,1399-10-2
79,صبا,سرمايه گذاري صبا تامين,7417,21435852,184346074337,8606,8540,8610,4,0.05,8600,-6,-0.07,8444,8790,1399-10-2
80,وساپا,سرمايه‌گذاري‌ سايپا,7392,67999626,582921249630,8270,8280,8680,410,4.96,8570,300,3.63,8150,8680,1399-10-2
81,لپارس,پارس‌ الكتريك‌,7389,2720951,394266850250,144890,144880,146960,2070,1.43,144900,10,0.01,138000,149450,1399-10-2
82,فاراك,ماشين‌ سازي‌ اراك‌,7364,64845760,516999158290,8010,8040,8000,-10,-0.12,7970,-40,-0.5,7770,8140,1399-10-2
83,ولبهمن,شركت بهمن ليزينگ,7359,93449640,1000331477294,10532,11058,10549,17,0.16,10704,172,1.63,10174,11058,1399-10-2
84,غشهداب,كشت و صنعت شهداب ناب خراسان,7288,68364444,366947325438,5347,5549,5200,-147,-2.75,5368,21,0.39,5170,5599,1399-10-2
85,شلرد,كود شيميايي اوره لردگان,7108,40771476,403156577540,10116,9814,9820,-296,-2.93,9888,-228,-2.25,9813,10247,1399-10-2
86,البرز,بيمه البرز,7085,103645195,590785196050,5550,5600,5810,260,4.68,5700,150,2.7,5450,5820,1399-10-2
87,غنوش,نوش‌ مازندران‌,7084,11635044,733147583900,60400,63420,63420,3020,5.0,63010,2610,4.32,60710,63420,1399-10-2
88,نوري,پتروشيمي نوري,6793,5866657,408537657530,69900,68700,68870,-1030,-1.47,69640,-260,-0.37,68300,71140,1399-10-2
89,شيران,س. صنايع‌شيميايي‌ايران,6776,13424401,535297342240,40980,40000,39410,-1570,-3.83,39870,-1110,-2.71,39080,41000,1399-10-2
90,دماوند,توليد نيروي برق دماوند,6770,8974964,586395018780,66547,66000,65400,-1147,-1.72,65337,-1210,-1.82,64151,68750,1399-10-2
91,تاپكيش,تجارت الكترونيك پارسيان كيش,6662,16328367,454457257257,28393,29800,26974,-1419,-5.0,27832,-561,-1.98,26974,29812,1399-10-2
92,زاگرس,پتروشيمي زاگرس,6544,5085475,1125255419225,215170,210000,222000,6830,3.17,221268,6098,2.83,210000,225928,1399-10-2
93,وثخوز,سرمايه گذاري و توسعه خوزستان,6526,8804041,588762217099,68629,72060,65198,-3431,-5.0,66874,-1755,-2.56,65198,72060,1399-10-2
94,بجهرم,توسعه مولد نيروگاهي جهرم,6395,55550336,217860772976,3836,3848,3998,162,4.22,3922,86,2.24,3765,4000,1399-10-2
95,قاسم,قاسم ايران,6352,33107289,565794529779,17415,17700,17200,-215,-1.23,17090,-325,-1.87,16545,17800,1399-10-2
96,فاسمين,كالسيمين‌,6345,23710464,502354295440,20940,21420,20700,-240,-1.15,21190,250,1.19,20490,21950,1399-10-2
97,تاپيكو,س. نفت و گاز و پتروشيمي تأمين,6287,29959492,432358414550,14470,14200,14450,-20,-0.14,14430,-40,-0.28,14120,14750,1399-10-2
98,بنو,بيمه تجارت نو,6281,14462465,477231219410,33755,33920,32850,-905,-2.68,32998,-757,-2.24,32068,35000,1399-10-2
99,غصينو,صنعتي مينو,6255,9813872,849196702968,85316,82300,89581,4265,5.0,86530,1214,1.42,82000,89581,1399-10-2
100,شپترو,پتروشيمي آبادان,6226,67642495,440904315992,6537,6341,6640,103,1.58,6518,-19,-0.29,6341,6729,1399-10-2
101,سبزوا,سيمان لار سبزوار,6030,48532465,258525198515,5177,5240,5435,258,4.98,5327,150,2.9,5100,5435,1399-10-2
102,وايران,ليزينگ ايرانيان,5974,40067801,534776105550,13970,13280,13410,-560,-4.01,13350,-620,-4.44,13280,13780,1399-10-2
103,ريشمك,توليد و صادرات ريشمك,5972,6660213,426560694064,65472,67000,64600,-872,-1.33,64046,-1426,-2.18,62199,67000,1399-10-2
104,وسينا,بانك سينا,5948,36964463,443423562560,11510,12000,12000,490,4.26,12000,490,4.26,11610,12080,1399-10-2
105,غويتا,ويتانا,5735,7487010,401285176079,51220,53781,53781,2561,5.0,53598,2378,4.64,52000,53781,1399-10-2
106,هرمز,فولاد هرمزگان جنوب,5599,27422653,441464844795,15997,15600,15711,-286,-1.79,16099,102,0.64,15600,16667,1399-10-2
107,قنيشا,قند  نيشابور,5464,6472956,453856684250,68030,67010,71430,3400,5.0,70120,2090,3.07,65130,71430,1399-10-2
108,ساوه,سيمان ساوه,5347,2265713,128980317833,55082,54990,57836,2754,5.0,56927,1845,3.35,53700,57836,1399-10-2
109,ثشاهد,سرمايه‌ گذاري‌ شاهد,5333,26641750,679577823230,24350,24890,25560,1210,4.97,25510,1160,4.76,24500,25560,1399-10-2
110,وپست,پست بانك ايران,5289,25219901,503228336080,19050,19490,20000,950,4.99,19950,900,4.72,19480,20000,1399-10-2
111,ملت,بيمه ملت,5284,31653483,700047416420,21330,21290,22360,1030,4.83,22120,790,3.7,20400,22390,1399-10-2
112,خمحركه,نيرو محركه‌,5168,48086295,346424627790,6990,6720,7330,340,4.86,7200,210,3.0,6710,7330,1399-10-2
113,ومعادن,توسعه‌معادن‌وفلزات‌,5145,28277740,403294935440,14330,14010,14390,60,0.42,14260,-70,-0.49,13950,14520,1399-10-2
114,شفارس,صنايع‌ شيميايي‌ فارس‌,5141,10249868,681513633840,64140,67340,67340,3200,4.99,66490,2350,3.66,64300,67340,1399-10-2
115,تكشا,گسترش‌صنايع‌وخدمات‌كشاورزي‌,5138,8128494,504013515100,61570,64640,59990,-1580,-2.57,62010,440,0.71,58920,64640,1399-10-2
116,شجم,صنايع پتروشيمي تخت جمشيد,5088,69578808,786133897036,11196,11531,11531,335,2.99,11298,102,0.91,10861,11531,1399-10-2
117,رنيك,جنرال مكانيك,5082,23130564,673932408131,27772,29140,29160,1388,5.0,29136,1364,4.91,28300,29160,1399-10-2
118,كحافظ,كاشي‌ وسراميك‌ حافظ‌,4931,20605768,359524047260,17060,17060,17910,850,4.98,17450,390,2.29,16450,17910,1399-10-2
119,چدن,توليدي چدن سازان,4931,17870623,741371093960,39640,40900,41300,1660,4.19,41490,1850,4.67,39640,41620,1399-10-2
120,اخابر,مخابرات ايران,4908,34749754,522017819680,14490,14630,15210,720,4.97,15020,530,3.66,14180,15210,1399-10-2
121,كچاد,معدني‌وصنعتي‌چادرملو,4802,15611631,321523876570,20630,20650,20900,270,1.31,20600,-30,-0.15,20010,21040,1399-10-2
122,ومشان,س. فني و مهندسي مشانير,4783,7963728,470699644354,58787,57024,60550,1763,3.0,59105,318,0.54,57024,60550,1399-10-2
123,ميهن,بيمه ميهن,4748,44360509,314706776871,6858,7150,6999,141,2.06,7094,236,3.44,6900,7200,1399-10-2
124,شسپا,نفت سپاهان,4712,11935998,353755113420,29520,29000,29510,-10,-0.03,29640,120,0.41,28450,30400,1399-10-2
125,سامان,بانك سامان,4705,37412162,516202589682,13563,13969,13567,4,0.03,13798,235,1.73,13500,13969,1399-10-2
126,غديس,پاكديس,4556,16848311,220566893360,13513,13700,12899,-614,-4.54,13091,-422,-3.12,12838,13700,1399-10-2
127,نوين,بيمه نوين,4531,36347850,316732324956,8508,8300,8933,425,5.0,8714,206,2.42,8300,8933,1399-10-2
128,كترام,توليدي‌ كاشي‌ تكسرام‌,4528,10761028,424548754480,38460,40380,40380,1920,4.99,39450,990,2.57,37830,40380,1399-10-2
129,كپارس,كاشي‌ پارس‌,4477,8159847,1321031780730,155690,163400,163470,7780,5.0,161890,6200,3.98,149000,163470,1399-10-2
130,وتوكا,سرمايه‌گذاري‌توكافولاد(هلدينگ,4446,22591196,319565385710,14080,14400,13910,-170,-1.21,14150,70,0.5,13400,14650,1399-10-2
131,ختور,رادياتور ايران‌,4420,7450988,280976443160,37020,36830,38870,1850,5.0,37710,690,1.86,35600,38870,1399-10-2
132,كتوكاح,ح.توليدي وخدمات صنايع نسوزتوكا,4358,15251969,415681238271,27467,26094,27300,-167,-0.61,27254,-213,-0.78,26094,28840,1399-10-2
133,كگل,معدني و صنعتي گل گهر,4354,25103756,468182955020,18140,18490,19040,900,4.96,18650,510,2.81,18170,19040,1399-10-2
134,ودي,بيمه  دي,4284,16835515,488368356102,28156,28000,29563,1407,5.0,29008,852,3.03,27900,29563,1399-10-2
135,زكوثر,سرمايه گذاري كشاورزي كوثر,4267,10172232,273584745770,25730,27010,27010,1280,4.97,26900,1170,4.55,25600,27010,1399-10-2
136,ولغدر,ليزينگ‌خودروغدير,4199,17540183,482746491080,26480,26500,27800,1320,4.98,27520,1040,3.93,26500,27800,1399-10-2
137,وسبحان,سرمايه گذاري سبحان,4180,28665497,279894544006,9460,9600,9933,473,5.0,9764,304,3.21,9400,9933,1399-10-2
138,خزاميا,زامياد,4135,26571142,352098691760,12760,13090,13390,630,4.94,13250,490,3.84,12760,13390,1399-10-2
139,خاذين,سايپاآذين‌,4120,30804683,201435569700,6420,6360,6540,120,1.87,6540,120,1.87,6100,6710,1399-10-2
140,وپاسار,بانك  پاسارگاد,4110,35743692,429003538520,11950,11960,12220,270,2.26,12000,50,0.42,11940,12220,1399-10-2
141,كمند,صندوق س. با درآمد ثابت كمند,4075,182579596,1842819707413,10089,10095,10093,4,0.04,10093,4,0.04,10092,10099,1399-10-2
142,غگيلا,شيرپاستوريزه پگاه گيلان,4047,563612,11165153720,18867,19810,19810,943,5.0,19060,193,1.02,19810,19810,1399-10-2
143,زقيام,كشت و دام قيام اصفهان,4044,5861226,237576330679,41084,42000,39810,-1274,-3.1,40534,-550,-1.34,39787,42000,1399-10-2
144,كالا,بورس كالاي ايران,4022,8560680,460594118990,52000,51390,54600,2600,5.0,53800,1800,3.46,49600,54600,1399-10-2
145,وملل,اعتباري ملل,4014,28263603,476505991898,16259,16250,16900,641,3.94,16859,600,3.69,15920,17049,1399-10-2
146,لوتوس,تامين سرمايه لوتوس پارسيان,3990,11793965,197425723500,16680,17300,16210,-470,-2.82,16740,60,0.36,16210,17300,1399-10-2
147,وصنعت,سرمايه گذاري توسعه صنعت وتجارت,3975,27144077,208598625970,7650,7530,7760,110,1.44,7680,30,0.39,7440,7890,1399-10-2
148,فسرب,ملي‌ سرب‌وروي‌ ايران‌,3957,1809592,257344937340,144590,140050,142000,-2590,-1.79,142210,-2380,-1.65,137700,149000,1399-10-2
149,شگل,گلتاش‌,3955,10708904,320192119350,30020,30000,30640,620,2.07,29900,-120,-0.4,28520,31000,1399-10-2
150,كفپارس,فرآورده‌هاي‌ نسوز پارس‌,3904,29781585,231691100380,7480,7220,7850,370,4.95,7780,300,4.01,7220,7850,1399-10-2
151,وسين,بيمه سينا,3822,16566170,433521320214,26556,25900,26140,-416,-1.57,26169,-387,-1.46,25229,27065,1399-10-2
152,شكلر,نيروكلر,3739,10967407,701987407880,63010,61010,66110,3100,4.92,64010,1000,1.59,61010,66160,1399-10-2
153,فسازان,غلتك سازان سپاهان,3738,9464440,373152950810,39930,38390,39090,-840,-2.1,39430,-500,-1.25,38000,40900,1399-10-2
154,كاوه,فولاد كاوه جنوب كيش,3694,16830546,384317985620,22880,23100,22670,-210,-0.92,22830,-50,-0.22,22410,23500,1399-10-2
155,خپارس,پارس‌ خودرو,3612,38782868,300773430800,7460,7520,7830,370,4.96,7760,300,4.02,7520,7830,1399-10-2
156,كساوه,صنايع‌ كاشي‌ و سراميك‌ سينا,3586,5537275,484411065160,87390,83700,86100,-1290,-1.48,87480,90,0.1,83700,91600,1399-10-2
157,شسينا,صنايع‌شيميايي‌سينا,3562,1385547,255709719640,192130,187260,182530,-9600,-5.0,184560,-7570,-3.94,182530,192000,1399-10-2
158,وشهر,بانك شهر,3553,32201817,232965655938,6995,7080,7274,279,3.99,7235,240,3.43,7080,7274,1399-10-2
159,تپمپي,پمپ‌ سازي‌ ايران‌,3538,6195267,221218629630,34990,36660,35310,320,0.91,35710,720,2.06,35000,36680,1399-10-2
160,ولصنم,ليزينگ‌صنعت‌ومعدن‌,3534,15271416,168265459510,10880,11400,10860,-20,-0.18,11020,140,1.29,10550,11400,1399-10-2
161,ثنام,س ساختماني ب نام آوران مهندسي,3511,8315275,176490475286,21629,21900,21304,-325,-1.5,21225,-404,-1.87,20981,22000,1399-10-2
162,ميدكو,هلدينگ صنايع  معدني خاورميانه,3415,5511475,171660703654,30941,31500,30970,29,0.09,31146,205,0.66,30900,31800,1399-10-2
163,وهور,مديريت انرژي اميد  تابان هور,3379,5190593,224151437110,43875,44430,43200,-675,-1.54,43184,-691,-1.57,42130,44430,1399-10-2
164,تنوين,تامين سرمايه نوين,3315,25951739,185339017540,7050,7160,7220,170,2.41,7140,90,1.28,7060,7350,1399-10-2
165,كيسون,شركت كيسون,3281,21824233,344745836084,15434,15010,15897,463,3.0,15796,362,2.35,15010,15897,1399-10-2
166,بركت,گروه دارويي بركت,3247,20657897,558176376940,25740,27020,27020,1280,4.97,27020,1280,4.97,27020,27020,1399-10-2
167,وليز,ليزينگ‌ايران‌,3213,20467138,175163939740,8930,8490,8490,-440,-4.93,8560,-370,-4.14,8490,8850,1399-10-2
168,ورنا,سرمايه‌گذاري‌ رنا(هلدينگ‌,3168,25617894,220109018760,8240,8390,8650,410,4.98,8590,350,4.25,8250,8650,1399-10-2
169,سفارس,سيمان فارس و خوزستان,3127,16473117,306216660220,17920,17920,18810,890,4.97,18590,670,3.74,17520,18810,1399-10-2
170,فباهنر,مس‌ شهيدباهنر,3101,3628928,202707468840,56800,57500,54900,-1900,-3.35,55860,-940,-1.65,53960,59000,1399-10-2
171,رمپنا,گروه مپنا (سهامي عام),3090,11139495,231999744510,20330,20570,20590,260,1.28,20830,500,2.46,20410,21330,1399-10-2
172,جهرم,پتروشيمي جهرم,3037,55008747,158780187345,2824,2710,2965,141,4.99,2886,62,2.2,2710,2965,1399-10-2
173,پكوير,كوير تاير,3033,8506360,191282830660,22430,21900,22710,280,1.25,22490,60,0.27,21500,23350,1399-10-2
174,ما,بيمه  ما,3028,24741350,232239654100,9530,9770,9250,-280,-2.94,9390,-140,-1.47,9060,9900,1399-10-2
175,غچين,كشت‌ و صنعت‌ چين‌ چين,2984,4708252,322416160250,68310,66990,71720,3410,4.99,68480,170,0.25,64900,71720,1399-10-2
176,ارفع,شركت آهن و فولاد ارفع,2970,9747140,160826200226,16413,16201,16413,0,0.0,16500,87,0.53,16201,16850,1399-10-2
177,كمنگنز,معادن‌منگنزايران‌,2952,2341126,263328728870,107800,113190,113190,5390,5.0,112480,4680,4.34,108600,113190,1399-10-2
178,غشهد,شهد ايران ‌,2952,19394694,173581884070,8930,9240,8840,-90,-1.01,8950,20,0.22,8650,9300,1399-10-2
179,فبيرا,بسته‌ بندي‌ ايران‌,2946,31306695,143824258613,4720,4830,4579,-141,-2.99,4594,-126,-2.67,4579,4830,1399-10-2
180,چفيبر,فيبر ايران‌,2946,20022773,184728665510,8530,8950,9390,860,10.08,9230,700,8.21,8620,9390,1399-10-2
181,لسرما,سرما آفرين‌,2896,4800081,154148003690,30900,30130,32280,1380,4.47,32110,1210,3.92,30130,32440,1399-10-2
182,دفارا,داروسازي‌ فارابي‌,2850,8206760,586533430330,68100,71500,71500,3400,4.99,71470,3370,4.95,69250,71500,1399-10-2
183,وبانك,سرمايه گذاري گروه توسعه ملي,2846,14097046,144811456210,10140,10140,10400,260,2.56,10270,130,1.28,9890,10500,1399-10-2
184,حفاري,حفاري شمال,2825,39606560,520631513260,12530,13120,13150,620,4.95,13150,620,4.95,12880,13150,1399-10-2
185,وپترو,سرمايه‌گذاري صنايع پتروشيمي‌,2818,10898424,221362594450,19760,19780,20430,670,3.39,20310,550,2.78,19500,20740,1399-10-2
186,شغدير,پتروشيمي غدير,2791,4559631,330270168309,71272,71090,72090,818,1.15,72434,1162,1.63,71000,74499,1399-10-2
187,خنصير,مهندسي‌نصيرماشين‌,2785,12331441,747305912420,58130,61030,61030,2900,4.99,60600,2470,4.25,55230,61030,1399-10-2
188,ومهان,گروه توسعه مالي مهر آيندگان,2772,7238415,119985962909,16386,16590,16557,171,1.04,16576,190,1.16,16100,16853,1399-10-2
189,كنور,توسعه معدني و صنعتي صبانور,2763,4602665,226953879800,50510,51000,49500,-1010,-2.0,49310,-1200,-2.38,48100,51480,1399-10-2
190,خبهمن,گروه‌بهمن‌,2730,14078627,438345823650,29730,31000,31210,1480,4.98,31140,1410,4.74,30030,31210,1399-10-2
191,مدير,ص.س.مديريت ثروت ص.بازنشستگي-س,2730,17526890,197826587747,11362,11200,11300,-62,-0.55,11287,-75,-0.66,11101,11479,1399-10-2
192,كمرجان,بازرگاني و توليدي مرجان كار,2710,1933847,155346013959,76958,80804,80805,3847,5.0,80330,3372,4.38,76268,80805,1399-10-2
193,سرو,صندوق س سروسودمند مدبران-سهام,2709,3654641,271355852600,73640,74500,74500,860,1.17,74250,610,0.83,73640,74520,1399-10-2
194,ثامان,سامان‌ گستراصفهان‌,2709,10406457,242787660120,22660,23790,22920,260,1.15,23330,670,2.96,22010,23790,1399-10-2
195,ثمسكن,سرمايه‌گذاري‌ مسكن‌,2688,23705934,148928970830,6080,6100,6380,300,4.93,6280,200,3.29,6080,6380,1399-10-2
196,ومعلم,بيمه معلم,2683,52285225,386164063372,7062,7120,7415,353,5.0,7386,324,4.59,7120,7415,1399-10-2
197,وآذر,سرمايه‌گذاري‌توسعه‌آذربايجان‌,2673,3520270,360094553420,100270,97000,105280,5010,5.0,102290,2020,2.01,95510,105280,1399-10-2
198,ختراكح,ح . ريخته‌گري‌ تراكتورسازي‌,2649,7777580,131482146350,15610,16700,17170,1560,9.99,16910,1300,8.33,16100,17170,1399-10-2
199,پاسا,ايران‌ياساتايرورابر,2630,7059002,208670641010,28630,29210,29300,670,2.34,29560,930,3.25,28300,30060,1399-10-2
200,غبشهر,صنعتي‌ بهشهر,2603,6970455,199158197670,27820,29210,27830,10,0.04,28570,750,2.7,27500,29210,1399-10-2
201,ولساپا,ليزينگ رايان‌ سايپا,2594,55971469,260775754380,4460,4400,4680,220,4.93,4660,200,4.48,4400,4680,1399-10-2
202,همراه,شركت ارتباطات سيار ايران,2557,5904790,207178955230,33700,34330,35380,1680,4.99,35090,1390,4.12,33000,35380,1399-10-2
203,زشريف,كشت وصنعت شريف آباد,2537,5399961,156350552639,27949,29346,29346,1397,5.0,28954,1005,3.6,28313,29346,1399-10-2
204,تنوينح,ح . تامين سرمايه نوين,2534,12226127,64909696161,5184,5260,5200,16,0.31,5309,125,2.41,5180,5500,1399-10-2
205,شفن,پتروشيمي فناوران,2525,744674,227938685530,316440,310000,307000,-9440,-2.98,306090,-10350,-3.27,300620,316400,1399-10-2
206,حآسا,آسيا سير ارس,2489,10496826,415177781170,38327,38327,40243,1916,5.0,39553,1226,3.2,36500,40243,1399-10-2
207,اپرداز,آتيه داده پرداز,2488,6793474,213952745863,30045,31500,31547,1502,5.0,31494,1449,4.82,30700,31547,1399-10-2
208,حفارس,حمل و نقل بين المللي خليج فارس,2459,27462336,119612722580,4340,4370,4410,70,1.61,4360,20,0.46,4250,4440,1399-10-2
209,حسير,ريل سير كوثر,2436,9824518,178620493243,17524,17030,18400,876,5.0,18181,657,3.75,17030,18400,1399-10-2
210,آگاس,صندوق س.هستي بخش آگاه-س,2416,2123406,162279640022,75952,75751,76640,688,0.91,76424,472,0.62,75150,76950,1399-10-2
211,چافست,افست‌,2408,4764210,102560769350,21340,20900,22400,1060,4.97,21530,190,0.89,20700,22400,1399-10-2
212,پكرمان,گروه‌ صنعتي‌ بارز,2399,5307417,185534202870,35780,35690,35730,-50,-0.14,34960,-820,-2.29,34140,36000,1399-10-2
213,قجام,فرآوردههاي غذايي وقندتربت‌جام‌,2392,35192721,444489731774,12267,12000,12635,368,3.0,12630,363,2.96,12000,12635,1399-10-2
214,وبوعلي,سرمايه‌گذاري‌بوعلي‌,2387,14312116,103419209900,7160,7300,7250,90,1.26,7230,70,0.98,7070,7400,1399-10-2
215,وملت,سرمايه گذاري ملت,2361,20511675,89184704778,4362,4188,4370,8,0.18,4348,-14,-0.32,4188,4485,1399-10-2
216,فمراد,آلومراد,2360,1854866,292556638950,150590,158110,158110,7520,4.99,157720,7130,4.73,150590,158110,1399-10-2
217,ونيرو,سرمايه‌گذاري‌نيرو,2351,37726645,160525564920,4080,4060,4280,200,4.9,4250,170,4.17,4060,4280,1399-10-2
218,خاهن,آهنگري‌ تراكتورسازي‌ ايران‌,2315,3846649,156757936950,40090,41500,40560,470,1.17,40750,660,1.65,40100,41740,1399-10-2
219,دابور,داروسازي‌ ابوريحان‌,2313,2951255,148327494900,48320,50730,49600,1280,2.65,50260,1940,4.01,48900,50730,1399-10-2
220,بورس,بورس اوراق بهادار تهران,2305,3044414,192505689540,64200,63900,62760,-1440,-2.24,63230,-970,-1.51,61340,64990,1399-10-2
221,وثنو,سرمايه گذاري ساختماني نوين,2288,5943610,121359395649,19852,20843,20844,992,5.0,20418,566,2.85,19900,20844,1399-10-2
222,كرازي,كارخانجات‌توليدي‌شيشه‌رازي‌,2240,6405189,173364862640,25840,26580,27130,1290,4.99,27070,1230,4.76,26200,27130,1399-10-2
223,پارسان,گسترش نفت و گاز پارسيان,2230,15601334,377405327980,23790,24150,24360,570,2.4,24190,400,1.68,23260,24700,1399-10-2
224,زگلدشت,كشت و دام گلدشت نمونه اصفهان,2210,2884903,142299659105,47173,49320,49531,2358,5.0,49326,2153,4.56,48240,49531,1399-10-2
225,فولاي,صنايع فولاد آلياژي يزد,2210,3724983,152911565846,39405,40000,41375,1970,5.0,41050,1645,4.17,39981,41375,1399-10-2
226,ونفت,سرمايه‌گذاري‌ صنعت‌ نفت‌,2202,9142137,160067949900,17280,16830,17600,320,1.85,17510,230,1.33,16830,17950,1399-10-2
227,كروي,توسعه‌ معادن‌ روي‌ ايران‌,2194,7146632,271350753710,36320,36610,38130,1810,4.98,37970,1650,4.54,36610,38130,1399-10-2
228,ستران,سيمان‌ تهران‌,2174,5883442,206786113310,34030,32800,35730,1700,5.0,35150,1120,3.29,32800,35730,1399-10-2
229,وآوا,سرمايه گذاري آوا نوين,2167,9404020,77336641124,8187,7810,8268,81,0.99,8224,37,0.45,7800,8528,1399-10-2
230,غشان,شيرپاستوريزه‌پگاه‌خراسان‌,2147,14051579,118378255840,8390,8500,8250,-140,-1.67,8420,30,0.36,8150,8690,1399-10-2
231,فجر,فولاد اميركبيركاشان,2138,2686312,171655841040,65310,65200,63800,-1510,-2.31,63900,-1410,-2.16,62570,65490,1399-10-2
232,رتاپ,تجارت الكترونيك  پارسيان,2133,8427093,71139786610,8390,8230,8410,20,0.24,8440,50,0.6,8230,8750,1399-10-2
233,كلوند,كاشي‌ الوند,2095,6800166,220592498780,30900,32440,32440,1540,4.98,32440,1540,4.98,32200,32440,1399-10-2
234,سپاها,سيمان‌سپاهان‌,2092,16214658,159025881460,9390,9500,9850,460,4.9,9810,420,4.47,9450,9850,1399-10-2
235,كساپا,سايپاشيشه‌,2081,4894406,185112077310,36040,37840,37830,1790,4.97,37820,1780,4.94,36790,37840,1399-10-2
236,سشرق,سيمان‌ شرق‌,2059,18171188,133605544740,7130,7010,7480,350,4.91,7350,220,3.09,7010,7480,1399-10-2
237,سنير,سيمان‌ سفيد ني‌ريز,2037,1157282,119161728900,98530,102880,103450,4920,4.99,102970,4440,4.51,98880,103450,1399-10-2
238,شكبير,پتروشيمي اميركبير,2034,12595417,1005634950347,64981,78250,79300,14319,22.04,79841,14860,22.87,78250,80597,1399-10-2
239,كگاز,شيشه‌ و گاز,2021,3773809,85513575100,23090,22190,22500,-590,-2.56,22660,-430,-1.86,22190,23500,1399-10-2
240,پارسيان,بيمه پارسيان,2019,8094378,121419017060,14970,15200,14750,-220,-1.47,15000,30,0.2,14510,15500,1399-10-2
241,ددام,داروسازي زاگرس فارمد پارس,2006,5667111,94844970510,16620,17380,16650,30,0.18,16740,120,0.72,16220,17380,1399-10-2
242,كاذر,فرآورده‌هاي‌نسوزآذر,2002,9318810,229117049810,23850,25040,23900,50,0.21,24590,740,3.1,23000,25040,1399-10-2
243,لخانه,لوازم‌ خانگي‌ پارس‌,1971,1275115,67880012702,53300,54898,51710,-1590,-2.98,53234,-66,-0.12,51701,54898,1399-10-2
244,فخاس,فولاد خراسان,1962,3907521,120119608460,32090,31500,30750,-1340,-4.18,30740,-1350,-4.21,30490,32090,1399-10-2
245,شكربن,كربن‌ ايران‌,1954,4497850,386447788970,82290,82000,86400,4110,4.99,85920,3630,4.41,80110,86400,1399-10-2
246,وگستر,گسترش سرمايه گذاري ايرانيان,1941,4972332,124783346613,24993,26150,25200,207,0.83,25096,103,0.41,24210,26150,1399-10-2
247,كهمدا,شيشه‌ همدان‌,1941,7293409,87562635040,12290,11850,11880,-410,-3.34,12010,-280,-2.28,11800,12400,1399-10-2
248,بايكا,كارخانجات كابلسازي ‌ايران‌,1933,2362622,151507464637,62845,64400,64730,1885,3.0,64127,1282,2.04,60960,64730,1399-10-2
249,پاكشو,گروه صنعتي پاكشو,1916,1256623,103572611920,82240,82980,83290,1050,1.28,82420,180,0.22,80590,84400,1399-10-2
250,حبندر,دريايي و کشتيراني خط دريابندر,1916,3346444,111616161312,34249,34790,33222,-1027,-3.0,33354,-895,-2.61,33222,34790,1399-10-2
251,ارزش,صندوق س ارزش آفرين بيدار-سهام,1904,15774089,176552692560,11090,11080,11190,100,0.9,11190,100,0.9,10970,11320,1399-10-2
252,سمازن,سيمان‌مازندران‌,1867,9921342,107390252690,10570,10570,11090,520,4.92,10820,250,2.37,10350,11090,1399-10-2
253,غمينوح,ح . شركت صنايع غذايي مينو شرق,1859,6931761,76441217476,11545,11130,11100,-445,-3.85,11028,-517,-4.48,10968,11500,1399-10-2
254,فلوله,لوله‌وماشين‌سازي‌ايران‌,1842,5141499,129298548070,24090,25290,25290,1200,4.98,25150,1060,4.4,24500,25290,1399-10-2
255,ثتران,سرمايه گذاري مسكن تهران,1837,21712022,112727948115,5005,5050,5255,250,5.0,5192,187,3.74,4841,5255,1399-10-2
256,ضخود1044,اختيارخ خودرو-4000-1399/10/07,1834,96010,374638000,17,8,4,-13,-76.47,4,-13,-76.47,2,11,1399-10-2
257,اتكاي,بيمه اتكايي ايرانيان,1788,5020326,92535232276,17937,18000,18749,812,4.53,18432,495,2.76,18000,18830,1399-10-2
258,وبشهر,توسعه‌ صنايع‌ بهشهر(هلدينگ,1787,8938247,162059147500,17290,18150,18150,860,4.97,18130,840,4.86,17500,18150,1399-10-2
259,وبيمه,سرمايه‌ گذاري‌ صنعت‌ بيمه‌,1784,18871027,64284091450,3420,3320,3480,60,1.75,3410,-10,-0.29,3310,3490,1399-10-2
260,آپ,آسان پرداخت پرشين,1783,5133255,97199737710,18570,18500,19490,920,4.95,18940,370,1.99,18110,19490,1399-10-2
261,كاذرح,ح . فرآورده‌هاي‌نسوزآذر,1764,6106708,124404284320,20830,21180,19700,-1130,-5.42,20370,-460,-2.21,19030,21290,1399-10-2
262,شوينده,مديريت صنعت شوينده ت.ص.بهشهر,1761,3613857,148412401910,39250,40990,41210,1960,4.99,41070,1820,4.64,39450,41210,1399-10-2
263,مرقام,ايران‌ارقام‌,1746,7310101,170358425720,22390,23000,23500,1110,4.96,23300,910,4.06,22500,23500,1399-10-2
264,بساما,بيمه سامان,1737,3004118,100100490523,32819,34459,32760,-59,-0.18,33321,502,1.53,32600,34459,1399-10-2
265,شپديس,پتروشيمي پرديس,1722,2911023,292418632810,102810,101010,99320,-3490,-3.39,100450,-2360,-2.3,99010,102780,1399-10-2
266,تيپيكو,سرمايه گذاري دارويي تامين,1703,2564082,155519613290,59950,60910,61390,1440,2.4,60650,700,1.17,59600,61800,1399-10-2
267,شصدف,صنعتي دوده فام,1678,50694,1331934156,25023,26274,26274,1251,5.0,25055,32,0.13,26274,26274,1399-10-2
268,دالبر,البرزدارو,1673,4439150,110787469740,23990,25000,25180,1190,4.96,24960,970,4.04,24300,25180,1399-10-2
269,دسبحان,سبحان دارو,1666,4109108,109221346760,25380,26620,26640,1260,4.96,26580,1200,4.73,26000,26640,1399-10-2
270,امين يكم,صندوق درآمد ثابت امين يكم فردا,1654,42087818,426463908389,10128,10137,10134,6,0.06,10133,5,0.05,10128,10138,1399-10-2
271,قشرين,قند شيرين خراسان,1636,6922803,153030803132,21466,22109,22109,643,3.0,22105,639,2.98,21532,22109,1399-10-2
272,گوهران,سرمايه گذاري توسعه گوهران اميد,1627,28222460,261277287402,8888,8734,9332,444,5.0,9258,370,4.16,8734,9332,1399-10-2
273,شخارك,پتروشيمي‌ خارك‌,1626,1903230,90974586010,48600,47000,47860,-740,-1.52,47920,-680,-1.4,46600,48810,1399-10-2
274,سرچشمه,سرمايه گذاري مس سرچشمه,1599,10032379,87691880178,8698,8500,8900,202,2.32,8741,43,0.49,8360,8999,1399-10-2
275,غپاك,لبنيات‌ پاك‌,1592,5902531,92026055560,15880,15880,15580,-300,-1.89,15590,-290,-1.83,15370,16000,1399-10-2
276,پرديس,سرمايه گذاري پرديس,1591,12790973,94138689620,7260,7330,7500,240,3.31,7360,100,1.38,7150,7550,1399-10-2
277,وآرين,شركت توسعه اقتصادي آرين,1590,18024842,96655982672,5247,5290,5404,157,2.99,5362,115,2.19,5170,5404,1399-10-2
278,شبصير,توليدات پتروشيمي قائد بصير,1577,1425697,190034079322,128773,131950,130000,1227,0.95,133292,4519,3.51,127130,135211,1399-10-2
279,تليسه,دامداري تليسه نمونه,1575,11969585,88395385225,7034,7385,7385,351,4.99,7385,351,4.99,7385,7385,1399-10-2
280,پخش,پخش البرز,1569,3017115,142315561744,44946,47188,47193,2247,5.0,47169,2223,4.95,45876,47193,1399-10-2
281,پارتا,مجتمع‌صنعتي‌آرتاويل‌تاير,1566,2215852,144532488049,65378,66000,67080,1702,2.6,65227,-151,-0.23,63501,67330,1399-10-2
282,افق,فروشگاههاي زنجيره اي افق كوروش,1566,952470,78154878560,82400,82020,82010,-390,-0.47,82130,-270,-0.33,81500,83800,1399-10-2
283,والبر,سرمايه‌ گذاري‌ البرز(هلدينگ‌,1560,10298970,221219513130,20460,21480,21480,1020,4.99,21480,1020,4.99,21460,21480,1399-10-2
284,وخاور,بانك خاورميانه,1554,23474086,235358644720,10140,10100,10230,90,0.89,10030,-110,-1.08,9900,10250,1399-10-2
285,وسكاب,س.ص.بازنشستگي كاركنان بانكها,1554,22374520,157608580570,6740,6810,7070,330,4.9,7040,300,4.45,6750,7070,1399-10-2
286,لابسا,آبسال‌,1552,2591527,121811915280,44810,46950,47050,2240,5.0,47000,2190,4.89,44850,47050,1399-10-2
287,تاصيكو,سرمايه گذاري صدرتامين,1547,11918671,138080064880,11610,11800,11620,10,0.09,11590,-20,-0.17,11200,11800,1399-10-2
288,شاراك,پتروشيمي شازند,1536,4402431,118089446120,26810,26500,26710,-100,-0.37,26820,10,0.04,26010,27840,1399-10-2
289,ساربيل,سيمان آرتا اردبيل,1535,1313499,66347417450,49690,51000,50740,1050,2.11,50510,820,1.65,48800,51800,1399-10-2
290,آريان,سرمايه گذاري پارس آريان,1523,30354340,503008070580,16193,16200,16678,485,3.0,16571,378,2.33,15910,16678,1399-10-2
291,ضخود1042,اختيارخ خودرو-3000-1399/10/07,1515,69638,28838947000,323,300,440,117,36.22,414,91,28.17,271,470,1399-10-2
292,خديزل,بهمن  ديزل,1511,2634044,144143135459,53005,52210,55655,2650,5.0,54723,1718,3.24,51051,55655,1399-10-2
293,لپيام,گسترش صنايع پيام,1505,3723805,122553461037,32779,31796,33762,983,3.0,32911,132,0.4,31796,33762,1399-10-2
294,دتوليد,داروسازي توليد دارو,1504,3962637,148887803059,35827,37450,37618,1791,5.0,37573,1746,4.87,36900,37618,1399-10-2
295,جم,پتروشيمي جم,1504,2401545,115274457500,48540,47140,47710,-830,-1.71,48000,-540,-1.11,47110,49000,1399-10-2
296,كيان,صندوق س. با درآمد ثابت كيان,1501,55358277,1462186079550,26401,26411,26410,9,0.03,26413,12,0.05,26409,26490,1399-10-2
297,غپينو,پارس‌ مينو,1488,19348199,217280274770,10700,11230,11230,530,4.95,11230,530,4.95,11230,11230,1399-10-2
298,وساخت,سرمايه‌ گذاري‌ ساختمان‌ايران‌,1485,2491060,164610274760,63160,66200,66310,3150,4.99,66080,2920,4.62,63350,66310,1399-10-2
299,بميلا,توسعه بازرگاني آهن وفولادميلاد,1467,3812861,71269385327,19410,18800,18790,-620,-3.19,18692,-718,-3.7,18440,19410,1399-10-2
300,ثالوند,سرمايه گذاري مسكن الوند,1464,6987484,108647432002,14997,14700,15746,749,4.99,15549,552,3.68,14500,15746,1399-10-2
301,شپاكسا,پاكسان‌,1450,4807125,166880983450,33120,34750,34770,1650,4.98,34720,1600,4.83,33910,34770,1399-10-2
302,تسه9909,امتياز تسهيلات مسكن آذر99,1448,20765,11862370852,593444,572222,563772,-29672,-5.0,571268,-22176,-3.74,563772,580000,1399-10-2
303,سكرد,سيمان كردستان,1433,9765337,85311637050,8420,8770,8840,420,4.99,8740,320,3.8,8450,8840,1399-10-2
304,ركيش,كارت اعتباري ايران كيش,1429,5653258,115859273220,20560,20800,20700,140,0.68,20490,-70,-0.34,20230,20800,1399-10-2
305,وسپه,سرمايه‌گذاري‌ سپه‌,1425,5345747,79365040100,14950,15000,14910,-40,-0.27,14850,-100,-0.67,14460,15140,1399-10-2
306,سيدكو,سرمايه گذاري توسعه صنايع سيمان,1423,7353615,62777939270,8350,8400,8750,400,4.79,8540,190,2.28,8250,8760,1399-10-2
307,بهپاك,صنعتي بهپاك,1417,3105768,149078420848,45860,48000,48153,2293,5.0,48000,2140,4.67,47000,48153,1399-10-2
308,كطبس,ذغال‌سنگ‌ نگين‌ ط‌بس‌,1408,1598256,113277290140,68790,70000,70990,2200,3.2,70880,2090,3.04,67150,72220,1399-10-2
309,سيلام,سيمان‌ ايلام‌,1405,13118180,135685875120,9890,10050,10380,490,4.95,10340,450,4.55,10050,10380,1399-10-2
310,شبهرن,نفت‌ بهران‌,1405,2116261,121736443360,57840,58000,58200,360,0.62,57520,-320,-0.55,57000,58600,1399-10-2
311,خمهر,مهركام‌پارس‌,1399,14816625,107153949580,6920,7140,7260,340,4.91,7230,310,4.48,6900,7260,1399-10-2
312,اعتماد,صندوق س.اعتماد آفرين پارسيان-د,1365,34582950,1174027678870,33932,33956,33950,18,0.05,33948,16,0.05,33945,33956,1399-10-2
313,فايرا,آلومينيوم‌ايران‌,1354,4491157,119101318890,26450,25220,26790,340,1.29,26520,70,0.26,25220,27200,1399-10-2
314,واتي,سرمايه‌ گذاري‌ آتيه‌ دماوند,1353,4518819,67654713590,15060,15280,15090,30,0.2,14970,-90,-0.6,14550,15480,1399-10-2
315,سشمال,سيمان‌ شمال‌,1336,8215340,87872507840,10380,9940,10890,510,4.91,10700,320,3.08,9940,10890,1399-10-2
316,كوير,توليدي فولاد سپيد فراب كوير,1335,6045142,140521078350,22190,22850,23290,1100,4.96,23250,1060,4.78,22300,23290,1399-10-2
317,ثباغ,شهر سازي و خانه سازي باغميشه,1334,3192374,73713599233,22135,22130,23241,1106,5.0,23091,956,4.32,21700,23241,1399-10-2
318,خريخت,صنايع‌ريخته‌گري‌ايران‌,1328,18384457,81959177670,4270,4400,4480,210,4.92,4460,190,4.45,4280,4480,1399-10-2
319,قزوين,كارخانجات‌ قند قزوين‌,1327,2215050,100057301720,43660,44300,45840,2180,4.99,45170,1510,3.46,42700,45840,1399-10-2
320,زبينا,كشاورزي و دامپروري بينالود,1319,2104745,113169878766,51371,52535,53939,2568,5.0,53769,2398,4.67,52500,53939,1399-10-2
321,ضخود1043,اختيارخ خودرو-3500-1399/10/07,1314,70867,8091603000,122,79,130,8,6.56,114,-8,-6.56,76,145,1399-10-2
322,خكاوه,سايپا ديزل,1301,16234443,84811226659,5078,5228,5230,152,2.99,5224,146,2.88,5100,5230,1399-10-2
323,دكپسول,توليد ژلاتين كپسول ايران,1289,2356636,106200074123,43015,45165,45165,2150,5.0,45064,2049,4.76,43110,45165,1399-10-2
324,سپ,پرداخت الكترونيك سامان كيش,1288,3133721,64656500820,20830,20490,20690,-140,-0.67,20630,-200,-0.96,20210,20910,1399-10-2
325,فافزا,فولاد افزا سپاهان,1277,1771505,82696324217,46236,47600,47623,1387,3.0,46681,445,0.96,44849,47623,1399-10-2
326,نمرينو,ايران‌ مرينوس‌,1277,1654718,100174747380,59060,60690,62010,2950,4.99,60540,1480,2.51,56200,62010,1399-10-2
327,شپاس,نفت پاسارگاد,1268,4520481,109372157110,23503,23000,24678,1175,5.0,24195,692,2.94,23000,24678,1399-10-2
328,كفرا,فراورده‌ هاي‌ نسوزايران‌,1264,1586221,106997427280,69730,69730,66250,-3480,-4.99,67450,-2280,-3.27,66250,69730,1399-10-2
329,خمحور,توليدمحورخودرو,1262,1240961,102348815770,80590,79000,83600,3010,3.73,82480,1890,2.35,78780,84000,1399-10-2
330,كاسپين,داروسازي كاسپين تامين,1259,2519927,76623570471,28970,30418,30418,1448,5.0,30407,1437,4.96,29325,30418,1399-10-2
331,شدوص,دوده‌ صنعتي‌ پارس‌,1257,2673985,63213400900,22710,23290,23840,1130,4.98,23640,930,4.1,22700,23840,1399-10-2
332,سصوفي,سيمان‌ صوفيان‌,1248,4907065,76735273730,15020,15020,15770,750,4.99,15640,620,4.13,15020,15770,1399-10-2
333,سخوز,سيمان خوزستان,1232,3815827,91491078550,24090,24890,24000,-90,-0.37,23980,-110,-0.46,23370,24890,1399-10-2
334,دپارس,پارس‌ دارو,1224,819954,93632785240,109020,113890,114470,5450,5.0,114190,5170,4.74,112140,114470,1399-10-2
335,بخاور,بيمه زندگي خاورميانه,1219,6583764,62066923717,9578,9500,9390,-188,-1.96,9427,-151,-1.58,9217,9813,1399-10-2
336,خشرق,الكتريك‌ خودرو شرق‌,1208,6251150,141480974260,21730,21320,22810,1080,4.97,22630,900,4.14,21200,22810,1399-10-2
337,سپح,ح . پرداخت الكترونيك سامان كيش,1204,3388838,67609417450,20100,19010,20000,-100,-0.5,19950,-150,-0.75,19010,20050,1399-10-2
338,غگل,گلوكوزان‌,1202,12347282,65193648960,5030,5280,5280,250,4.97,5280,250,4.97,5280,5280,1399-10-2
339,وهنر,گروه توسعه هنر ايران,1196,13597031,71787100942,5152,5290,5306,154,2.99,5280,128,2.48,5020,5306,1399-10-2
340,پلاسك,پلاسكوكار,1152,9804150,83479009340,8200,8200,8610,410,5.0,8510,310,3.78,8040,8610,1399-10-2
341,ساروم,سيمان‌اروميه‌,1146,2846159,79817918980,27060,26810,28410,1350,4.99,28040,980,3.62,26390,28410,1399-10-2
342,زنگان,صنعت روي زنگان,1143,508256,53543060139,101258,104000,105300,4042,3.99,105347,4089,4.04,102120,106320,1399-10-2
343,زر,صندوق س.پشتوانه سكه طلاي زر,1141,2419712,118394501419,48803,48500,48158,-645,-1.32,48929,126,0.26,47511,50500,1399-10-2
344,دزهراوي,داروسازي‌زهراوي‌,1128,6235333,88379721750,13510,14170,14180,670,4.96,14170,660,4.89,14000,14180,1399-10-2
345,ثپرديس,سرمايه گذاري مسكن پرديس,1123,7158359,79540779855,10653,10900,11185,532,4.99,11112,459,4.31,10760,11185,1399-10-2
346,كهمداح,ح . شيشه‌ همدان‌,1111,4588673,46434713450,10450,10010,10030,-420,-4.02,10120,-330,-3.16,9900,10650,1399-10-2
347,فنوال,نورد آلومينيوم‌,1110,3644034,106460432470,27980,28980,29370,1390,4.97,29210,1230,4.4,28010,29370,1399-10-2
348,داسوه,داروسازي‌ اسوه‌,1101,1875994,58278842180,29910,31330,31400,1490,4.98,31070,1160,3.88,30010,31400,1399-10-2
349,غپآذر,شير پگاه آذربايجان شرقي,1097,1753388,109869328157,59860,58000,62853,2993,5.0,62661,2801,4.68,57960,62853,1399-10-2
350,فلات,گروه صنايع معادن فلات ايرانيان,1092,3679049,56770725281,15763,16190,15400,-363,-2.3,15431,-332,-2.11,15291,16190,1399-10-2
351,سهگمت,سيمان‌هگمتان‌,1082,5746584,142635290110,24650,23610,25490,840,3.41,24820,170,0.69,23420,25540,1399-10-2
352,كاما,باما,1080,5672536,127291707840,21380,22440,22440,1060,4.96,22440,1060,4.96,22440,22440,1399-10-2
353,شاوان,پالايش نفت لاوان,1070,967646,100838852269,104208,103980,103000,-1208,-1.16,104210,2,0.0,100140,107000,1399-10-2
354,سبهان,سيمان‌ بهبهان‌,1069,552139,39890613220,70870,72700,72500,1630,2.3,71890,1020,1.44,69000,72960,1399-10-2
355,كويرح,ح. توليدي فولاد سپيد فراب كوير,1067,14103714,254339226900,17570,19330,19330,1760,10.02,18030,460,2.62,17600,19330,1399-10-2
356,كمينا,شيشه سازي مينا,1063,3135323,106387920064,32477,33500,34100,1623,5.0,33932,1455,4.48,31500,34100,1399-10-2
357,دسبحا,گروه دارويي سبحان,1055,2521585,63091662610,24200,24940,25410,1210,5.0,25020,820,3.39,24000,25410,1399-10-2
358,وگردش,بانك گردشگري,1048,16981184,335638433064,18976,18693,19924,948,5.0,19765,789,4.16,18693,19924,1399-10-2
359,سيستم,همكاران سيستم,1036,2284324,78783645540,34310,35000,34990,680,1.98,34490,180,0.52,33110,35820,1399-10-2
360,اميد,تامين سرمايه اميد,1033,5796860,70553218160,11690,11990,12270,580,4.96,12170,480,4.11,11700,12270,1399-10-2
361,تماوند,تامين سرمايه دماوند,1013,7655901,122479241818,15934,15936,16000,66,0.41,15998,64,0.4,15500,16269,1399-10-2
362,ثعمرا,عمران و توسعه شاهد,1010,4897628,73971080398,14424,15129,15145,721,5.0,15103,679,4.71,14700,15145,1399-10-2
363,ولملت,واسپاري ملت,1006,5468821,56664353740,9920,10100,10410,490,4.94,10360,440,4.44,9800,10410,1399-10-2
364,وسديد,گروه ‌صنعتي‌سديد,1006,5610891,161997644952,27498,28872,28872,1374,5.0,28872,1374,5.0,28872,28872,1399-10-2
365,ولشرق,ليزينگ ايران و شرق,1000,6715691,56798345620,8064,8467,8467,403,5.0,8441,377,4.68,8270,8467,1399-10-2
366,زمگسا,كشاورزي‌ ودامپروي‌ مگسال‌,996,1449917,83660210900,60730,57700,57700,-3030,-4.99,57700,-3030,-4.99,57700,57700,1399-10-2
367,واميد,گروه مديريت سرمايه گذاري اميد,968,3260056,124210939530,37240,37980,38200,960,2.58,38100,860,2.31,36180,38550,1399-10-2
368,شتوكا,توكا رنگ فولاد سپاهان,946,1647141,76443825862,44340,46510,46557,2217,5.0,46410,2070,4.67,45134,46557,1399-10-2
369,غسالم,سالمين‌,936,10377658,74200254700,6810,7150,7150,340,4.99,7150,340,4.99,7150,7150,1399-10-2
370,وايرا,سرمايه گذاري صنايع ايران,915,6697613,75271099832,11091,11421,11423,332,2.99,11238,147,1.33,10760,11423,1399-10-2
371,دلقما,دارويي‌ لقمان‌,911,1950857,60145442100,29400,30860,30870,1470,5.0,30830,1430,4.86,29500,30870,1399-10-2
372,سمگا,گروه سرمايه گذاري ميراث فرهنگي,908,7529719,259760246062,32856,34498,34498,1642,5.0,34498,1642,5.0,34498,34498,1399-10-2
373,حپارسا,توسعه حمل و نقل ريلي پارسيان,900,3494008,127041450105,34634,36365,36365,1731,5.0,36360,1726,4.98,35800,36365,1399-10-2
374,ثاصفا,شركت‌ ساختمان‌ اصفهان‌,897,2967166,111192987096,37181,38296,36066,-1115,-3.0,37474,293,0.79,36066,38296,1399-10-2
375,طلا,صندوق س.پشتوانه طلاي لوتوس,896,382342,32084735786,85091,84150,84000,-1091,-1.28,83916,-1175,-1.38,83500,84860,1399-10-2
376,ولانا,شركت ليزينگ آريا دانا,896,5027009,122301332689,23812,24526,24526,714,3.0,24329,517,2.17,23098,24526,1399-10-2
377,قشير,قند شيروان قوچان و بجنورد,889,1844138,61511137128,31777,33365,33365,1588,5.0,33355,1578,4.97,32430,33365,1399-10-2
378,شرانل,نفت ايرانول,886,1076969,36802349256,34107,34890,34540,433,1.27,34154,47,0.14,33600,34900,1399-10-2
379,مبين,مبين انرژي خليج فارس,885,2893109,46955447340,16040,15800,16200,160,1.0,16170,130,0.81,15760,16830,1399-10-2
380,ساراب,سيمان‌ داراب‌,885,5260780,73556748980,13380,13160,14040,660,4.93,13980,600,4.48,13160,14040,1399-10-2
381,درازك,دارويي‌ رازك‌,885,2210833,104641599790,45130,47100,47380,2250,4.99,47330,2200,4.87,46040,47380,1399-10-2
382,گكيش,توريستي ورفاهي آبادگران كيش,881,563014,33067846531,60206,58400,58600,-1606,-2.67,58734,-1472,-2.44,58400,60071,1399-10-2
383,مارون,پتروشيمي مارون,876,294207,45949195697,158018,163000,154080,-3938,-2.49,157250,-768,-0.49,153497,163000,1399-10-2
384,كرماشا,صنايع پتروشيمي كرمانشاه,873,1473572,61492377470,42000,41100,41540,-460,-1.1,41730,-270,-0.64,41000,42090,1399-10-2
385,خوساز,محورسازان‌ايران‌خودرو,868,9006361,81531186620,8660,9030,9090,430,4.97,9050,390,4.5,8890,9090,1399-10-2
386,حتايد,تايدواترخاورميانه,864,4951132,118188822530,22790,23900,23920,1130,4.96,23870,1080,4.74,22910,23920,1399-10-2
387,كاردان,صندوق س تجارت شاخصي كاردان,864,471621,86609964930,182810,182400,184490,1680,0.92,183640,830,0.45,180740,184990,1399-10-2
388,ثرود,سرمايه‌گذاري مسكن زاينده رود,863,5277847,58909244023,10696,11200,11230,534,4.99,11162,466,4.36,10816,11230,1399-10-2
389,فسپا,گروه‌صنعتي‌سپاهان‌,860,3842360,210623994180,52350,53500,54960,2610,4.99,54820,2470,4.72,52610,54960,1399-10-2
390,وگردشح,ح . بانك گردشگري,848,149990000,2153406430000,13545,14357,14357,812,5.99,14357,812,5.99,14357,14357,1399-10-2
391,خودكفا,اقتصادي و خودكفايي آزادگان,848,7598986,308625217404,39432,40614,40614,1182,3.0,40614,1182,3.0,40614,40614,1399-10-2
392,اتكام,شركت بيمه اتكايي امين,838,5087015,38215091508,7440,7750,7598,158,2.12,7492,52,0.7,7251,7750,1399-10-2
393,وتوسم,سرمايه‌گذاري‌توسعه‌ملي‌,837,2995695,38192967470,12720,12780,12920,200,1.57,12740,20,0.16,12510,13170,1399-10-2
394,فلامي,لاميران‌,833,1043224,52050644240,47550,49920,49920,2370,4.98,49670,2120,4.46,48400,49920,1399-10-2
395,اوان,مبين وان كيش,832,745475,40597116929,54322,56777,53890,-432,-0.8,54432,110,0.2,53000,56777,1399-10-2
396,وصندوق,سرمايه‌گذاري‌صندوق‌بازنشستگي‌,830,4071945,63578915960,15600,15600,15790,190,1.22,15610,10,0.06,15210,15980,1399-10-2
397,ثاختح,ح . بين‌المللي‌توسعه‌ساختمان,827,27295013,88094852910,3120,3430,3430,310,9.94,3230,110,3.53,3100,3430,1399-10-2
398,حپترو,حمل و نقل پتروشيمي( سهامي عام,825,1088622,34598772000,32130,33480,31270,-860,-2.68,31910,-220,-0.68,30530,33480,1399-10-2
399,آوا,صندوق س.سهام آواي معيار-س,816,4645246,43248578752,9280,9210,9360,80,0.86,9310,30,0.32,9105,9400,1399-10-2
400,زماهان,مجتمع توليد گوشت مرغ ماهان,808,1844348,52698115435,27260,28623,28623,1363,5.0,28573,1313,4.82,28100,28623,1399-10-2
401,پسهند,صنايع‌ لاستيكي‌  سهند,806,910425,41422651340,44310,45570,44900,590,1.33,45250,940,2.12,44010,46520,1399-10-2
402,تشتاد,صنايع توليدي اشتاد ايران‌,797,3222114,49817988674,15513,15120,15978,465,3.0,15461,-52,-0.34,15048,15978,1399-10-2
403,تسه9908,امتياز تسهيلات مسكن آبان99,789,14466,8276711511,596153,610000,566346,-29807,-5.0,572149,-24004,-4.03,566346,610000,1399-10-2
404,فرآور,فرآوري‌موادمعدني‌ايران‌,783,2027095,65205500040,30650,32180,32180,1530,4.99,32170,1520,4.96,31270,32180,1399-10-2
405,سكرما,سيمان‌ كرمان‌,778,3249138,61591689830,18120,19010,19020,900,4.97,18960,840,4.64,18120,19020,1399-10-2
406,قرن,پديده شيمي قرن,771,780846,47904902100,58430,61350,61350,2920,5.0,60860,2430,4.16,61350,61350,1399-10-2
407,قچار,فراوردههاي غذايي وقند چهارمحال,766,970488,66813246360,72468,68845,68845,-3623,-5.0,68845,-3623,-5.0,68845,68845,1399-10-2
408,دكوثر,داروسازي‌ كوثر,753,1491621,39793974540,25430,26600,26700,1270,4.99,26360,930,3.66,26000,26700,1399-10-2
409,غشاذر,پگاه‌آذربايجان‌غربي‌,751,2397202,49594890310,19710,20690,20690,980,4.97,20610,900,4.57,20460,20690,1399-10-2
410,ساينا,صنايع بهداشتي ساينا,745,577333,109251459212,198666,190100,190000,-8666,-4.36,189235,-9431,-4.75,188733,198538,1399-10-2
411,خرينگ,رينگ‌سازي‌مشهد,745,841742,58071780580,65710,68990,68990,3280,4.99,68850,3140,4.78,68990,68990,1399-10-2
412,شساخت,مهندسي و ساختمان صنايع نفت,743,2321985,110806562417,48897,49740,47431,-1466,-3.0,47721,-1176,-2.41,47431,49830,1399-10-2
413,سصفها,سيمان‌اصفهان‌,742,591194,172230651670,279220,293180,293180,13960,5.0,291330,12110,4.34,280000,293180,1399-10-2
414,فيروزه,صندوق شاخص30 شركت فيروزه- سهام,739,318092,56332540580,178330,175600,176690,-1640,-0.92,177100,-1230,-0.69,174500,180000,1399-10-2
415,ولتجار,واسپاري تجارت وسرمايه ايرانيان,733,8275038,64584670935,7579,7806,7806,227,3.0,7805,226,2.98,7750,7806,1399-10-2
416,سدور,سيمان‌ دورود,733,5734679,64285751590,10680,11210,11210,530,4.96,11210,530,4.96,11210,11210,1399-10-2
417,وحافظ,بيمه حافظ,727,1456886,113655004815,75747,78019,78019,2272,3.0,78012,2265,2.99,77010,78019,1399-10-2
418,شراز,پالايش نفت شيراز,725,527859,58247041904,112540,111400,112400,-140,-0.12,110346,-2194,-1.95,106913,114811,1399-10-2
419,غمهراح,ح . توليدي‌مهرام‌,717,1017909,68964384850,68020,68560,68350,330,0.49,67750,-270,-0.4,65520,69950,1399-10-2
420,غگلپا,شير پاستوريزه پگاه گلپايگان,712,745853,56944668686,72773,76211,76411,3638,5.0,76348,3575,4.91,74000,76411,1399-10-2
421,كلر,كلر پارس,704,728453,58180084204,76065,79868,79868,3803,5.0,79722,3657,4.81,79868,79868,1399-10-2
422,جم پيلن,پلي پروپيلن جم - جم پيلن,691,590045,51479340150,87630,88800,87650,20,0.02,87350,-280,-0.32,86100,88910,1399-10-2
423,تايرا,تراكتورسازي‌ايران‌,689,5622509,180405343790,31070,31700,32620,1550,4.99,32090,1020,3.28,31120,32620,1399-10-2
424,قصفها,قنداصفهان‌,688,230703,52011991350,237310,225450,225450,-11860,-5.0,225450,-11860,-5.0,225450,225450,1399-10-2
425,سخزر,سيمان‌ خزر,684,2107387,68358409090,30900,32440,32440,1540,4.98,32440,1540,4.98,31830,32440,1399-10-2
426,سفانو,سيمان فارس نو,681,1045324,35912695210,33650,35310,34380,730,2.17,34140,490,1.46,33650,35310,1399-10-2
427,وبهمن,سرمايه‌گذاري‌بهمن‌,677,4873203,102567141490,20150,21000,21150,1000,4.96,21050,900,4.47,20180,21150,1399-10-2
428,قشهد,شهد,677,800067,24609788650,30880,31390,30500,-380,-1.23,30820,-60,-0.19,29340,31390,1399-10-2
429,حخزر,كشتيراني درياي خزر,677,2014905,48362814691,23221,23100,24382,1161,5.0,24003,782,3.37,22261,24382,1399-10-2
430,گشان,توسعه بين المللي پديده شانديز,672,292049,18826938785,67151,64465,64465,-2686,-4.0,65831,-1320,-1.97,64465,64465,1399-10-2
431,قهكمت,قندهكمتان‌,659,523284,26129552510,50880,50000,49950,-930,-1.83,50400,-480,-0.94,49080,51990,1399-10-2
432,دعبيد,لابراتوارداروسازي‌  دكترعبيدي‌,655,1987508,67028136790,32140,33740,33740,1600,4.98,33720,1580,4.92,33000,33740,1399-10-2
433,بكام,كارخانجات توليدي شهيد قندي,652,12275602,56345013180,4380,4590,4590,210,4.79,4590,210,4.79,4590,4590,1399-10-2
434,وزمين,بانك ايران زمين,643,3617515,46704894718,12952,12700,12850,-102,-0.79,12911,-41,-0.32,12693,13150,1399-10-2
435,پارس,پتروشيمي پارس,642,510099,82579318910,161910,164000,161000,-910,-0.56,161890,-20,-0.01,157220,165500,1399-10-2
436,قلرست,قند لرستان‌,640,1123904,27842627780,24620,24580,25170,550,2.23,24710,90,0.37,23990,25300,1399-10-2
437,زپارس,ملي كشت و صنعت و دامپروري پارس,632,518579,50679256380,96260,93850,97750,1490,1.55,97600,1340,1.39,93310,98640,1399-10-2
438,دسينا,داروسازي‌ سينا,631,1046311,33226552450,30250,31760,31760,1510,4.99,31200,950,3.14,31690,31760,1399-10-2
439,بفجر,فجر انرژي خليج فارس,628,992656,27539614530,27830,27540,27740,-90,-0.32,27800,-30,-0.11,27100,28490,1399-10-2
440,وتوشه,سرمايه‌ گذاري‌ پارس‌ توشه‌,624,2927022,65973363130,21830,21850,22920,1090,4.99,22540,710,3.25,21340,22920,1399-10-2
441,وتعاون,بيمه  تعاون,612,3570180,25266349414,7169,7260,7000,-169,-2.36,7077,-92,-1.28,6954,7260,1399-10-2
442,مفاخر,توسعه فناوري اطلاعات خوارزمي,612,607271,26427446345,42138,44244,42922,784,1.86,42847,709,1.68,42138,44244,1399-10-2
443,واعتبار,سرمايه گذاري اعتبار ايران,611,5708678,45823578440,7650,8030,8030,380,4.97,7940,290,3.79,7800,8030,1399-10-2
444,مداران,داده‌پردازي‌ايران‌,610,1932012,51101028850,25240,26500,26500,1260,4.99,26410,1170,4.64,25930,26500,1399-10-2
445,حريل,ريل پردازسير,593,6113079,34062076188,5307,5572,5572,265,4.99,5457,150,2.83,5572,5572,1399-10-2
446,كاريس,صندوق س.سپهر كاريزما-س,592,489961,103284754002,210213,208499,211901,1688,0.8,210802,589,0.28,208000,212000,1399-10-2
447,دامين,داروسازي‌ امين‌,591,2169598,36438528840,16010,16810,16810,800,5.0,16510,500,3.12,16330,16810,1399-10-2
448,آتيمس,صندوق س.آرمان آتيه درخشان مس-س,578,181078,40873505594,220522,223000,227720,7198,3.26,225723,5201,2.36,218121,228750,1399-10-2
449,توريل,توکاريل,576,1633327,46219887446,26951,28298,28298,1347,5.0,27977,1026,3.81,28298,28298,1399-10-2
450,ثشرق,سرمايه گذاري مسكن شمال شرق,570,5568824,37010741160,6350,6500,6660,310,4.88,6540,190,2.99,6460,6660,1399-10-2
451,بالاس,مهندسي ساختمان تاسيسات راه آهن,567,903539,46365451245,48998,49000,51447,2449,5.0,51260,2262,4.62,49000,51447,1399-10-2
452,لخزر,پارس‌ خزر,565,178962,38321879590,212610,217900,201980,-10630,-5.0,213750,1140,0.54,201980,223240,1399-10-2
453,وصنا,گروه‌صنايع‌بهشهرايران‌,564,11924438,114335715980,9270,9720,9730,460,4.96,9590,320,3.45,9370,9730,1399-10-2
454,اعتلا,شركت سرمايه گذاري اعتلاء البرز,561,4901263,52809540959,10264,10777,10777,513,5.0,10775,511,4.98,10540,10777,1399-10-2
455,غبهنوش,بهنوش‌ ايران‌,560,454577,70882191610,164130,155930,155930,-8200,-5.0,155930,-8200,-5.0,155930,155930,1399-10-2
456,كسرام,پارس‌ سرام‌,558,5974946,69249624140,11040,11590,11590,550,4.98,11590,550,4.98,11590,11590,1399-10-2
457,شيراز,پتروشيمي‌شيراز,542,708841,40412770210,56170,57500,57620,1450,2.58,56490,320,0.57,55510,57800,1399-10-2
458,اطلس,صندوق س.توسعه اندوخته آينده-س,532,117143,25301156128,214365,214365,216200,1835,0.86,215985,1620,0.76,214365,216500,1399-10-2
459,شنفت,نفت‌ پارس‌,527,1170393,67384530270,57770,57000,57000,-770,-1.33,57570,-200,-0.35,55670,58300,1399-10-2
460,كيميا,معدني كيمياي زنجان گستران,527,1176655,50716183810,41050,43102,43102,2052,5.0,42766,1716,4.18,43102,43102,1399-10-2
461,فن آوا,گروه فن آوا,524,1834474,23532334815,12725,12500,12970,245,1.93,12828,103,0.81,12400,13000,1399-10-2
462,پارند,صندوق س. پارند پايدار سپهر,521,14972074,170534931077,11376,11400,11411,35,0.31,11390,14,0.12,11364,11448,1399-10-2
463,آ س پ,آ.س.پ,518,3842479,45322721247,11302,11509,11867,565,5.0,11731,429,3.8,11500,11867,1399-10-2
464,سقاين,سيمان‌ قائن‌,517,677092,33279984470,47530,48290,49890,2360,4.97,48580,1050,2.21,47090,49900,1399-10-2
465,دارا,صندوق س. دارا الگوريتم-د,513,15424245,153899839811,9982,9985,9971,-11,-0.11,9978,-4,-0.04,9940,9990,1399-10-2
466,آبين,كشت و صنعت آبشيرين,512,3521428,18836118372,5095,5349,5349,254,4.99,5305,210,4.12,5349,5349,1399-10-2
467,دتماد,توليدمواداوليه‌داروپخش‌,504,1586875,87928743750,52780,55410,55410,2630,4.98,55410,2630,4.98,55410,55410,1399-10-2
468,ثنظام,س. ساختماني نظام مهندسي ايران,504,623902,28655181908,44592,45929,45929,1337,3.0,45929,1337,3.0,45920,45929,1399-10-2
469,خزر,فنرسازي‌زر,503,1973375,62990130000,30400,31920,31920,1520,5.0,31920,1520,5.0,31920,31920,1399-10-2
470,قمرو,قند مرودشت‌,500,1016010,28367928540,26730,27750,28060,1330,4.98,27370,640,2.39,26700,28060,1399-10-2
471,دتوزيعح,ح . توزيع دارو پخش,500,307303,8053182418,24959,26206,26206,1247,5.0,26206,1247,5.0,26206,26206,1399-10-2
472,خموتور,موتورسازان‌تراكتورسازي‌ايران‌,495,5840999,87556575010,14280,14990,14990,710,4.97,14990,710,4.97,14990,14990,1399-10-2
473,كشرق,صنعتي و معدني شمال شرق شاهرود,493,302632,23077532949,76068,75906,76000,-68,-0.09,76153,85,0.11,73631,79000,1399-10-2
474,ياقوت,صندوق س ياقوت آگاه-ثابت,489,12775556,148583291783,11631,11637,11630,-1,-0.01,11630,-1,-0.01,11617,11637,1399-10-2
475,وسنا,سرمايه گذاري نيروگاهي ايران,486,3236651,54328254484,16128,15360,16934,806,5.0,16785,657,4.07,15360,16934,1399-10-2
476,شپارس,بين‌ المللي‌ محصولات‌  پارس‌,483,2464286,47168323090,18270,18950,19180,910,4.98,19050,780,4.27,18790,19180,1399-10-2
477,عيار,صندوق س. پشتوانه طلاي مفيد,473,911236,26203185320,28965,28990,28800,-165,-0.57,28756,-209,-0.72,28600,29050,1399-10-2
478,دفرا,فرآورده‌هاي‌ تزريقي‌ ايران‌,467,1638975,45937967300,26700,28030,28030,1330,4.98,27850,1150,4.31,27590,28030,1399-10-2
479,پرداخت,به پرداخت ملت,466,1174693,31670271370,25690,26970,26970,1280,4.98,26440,750,2.92,26370,26970,1399-10-2
480,سمتاز,سيمان ممتازان كرمان,463,947429,25048304944,26044,26825,25890,-154,-0.59,26438,394,1.51,25263,26825,1399-10-2
481,خراسان,پتروشيمي خراسان,463,670413,47571381200,70910,69900,71800,890,1.26,70950,40,0.06,69360,72590,1399-10-2
482,خفولا,خدمات فني فولاد يزد,460,1093247,49684961924,45177,43822,46532,1355,3.0,45447,270,0.6,43822,46532,1399-10-2
483,خكرمان,گروه اقتصادي كرمان خودرو,449,5134130,30871523690,5838,6013,6013,175,3.0,6013,175,3.0,6013,6013,1399-10-2
484,ضخود1041,اختيارخ خودرو-2500-1399/10/07,447,20920,18455396000,779,900,900,121,15.53,882,103,13.22,825,950,1399-10-2
485,بسويچ,پارس‌سويچ‌,424,623678,31964912920,48830,51270,51270,2440,5.0,50370,1540,3.15,50000,51270,1399-10-2
486,دبالك,مواد اوليه دارويي البرز بالك,424,1642252,39253107304,22764,23902,23902,1138,5.0,23557,793,3.48,23902,23902,1399-10-2
487,وپخش,داروپخش‌ (هلدينگ‌,420,320317,44249960090,131590,138160,138160,6570,4.99,137110,5520,4.19,132630,138160,1399-10-2
488,كيان2,صندوق س. با درآمد ثابت كيان,413,41300000,41300000,26401,1,1,-26400,-100.0,1,-26400,-100.0,1,1,1399-10-2
489,كفرآور,فرآورده هاي سيمان شرق,407,2412608,54874540765,22093,22755,22755,662,3.0,22745,652,2.95,21870,22755,1399-10-2
490,دسانكو,داروسازي سبحان انكولوژي,403,2765580,53605237140,18460,19383,19383,923,5.0,19346,886,4.8,19383,19383,1399-10-2
491,غشوكو,شوكو پارس,396,357304,16780185718,46741,47755,46323,-418,-0.89,46919,178,0.38,46323,49187,1399-10-2
492,غمارگ,مارگارين‌,392,961352,42578280080,42190,44290,44290,2100,4.98,43830,1640,3.89,44290,44290,1399-10-2
493,افق ملت,صندوق س در سهام افق ملت,390,135608,19538944280,143860,145400,144390,530,0.37,144080,220,0.15,143000,145500,1399-10-2
494,فسا,پتروشيمي فسا,389,6336670,16202865190,2483,2557,2557,74,2.98,2544,61,2.46,2557,2557,1399-10-2
495,رانفور,خدمات‌انفورماتيك‌,384,2176052,75726609600,33150,34800,34800,1650,4.98,34240,1090,3.29,34800,34800,1399-10-2
496,ضصاد1102,اختيارخ وبصادر-3500-1399/11/12,362,9345,3577279000,411,413,407,-4,-0.97,383,-28,-6.81,340,439,1399-10-2
497,قپيرا,فرآورده‌هاي‌غدايي‌وقندپيرانشهر,356,483554,44069861970,87680,86400,92060,4380,5.0,90630,2950,3.36,85210,92060,1399-10-2
498,سفاسي,شركت فارسيت اهواز,355,1595238,26608569840,16195,16680,16680,485,2.99,16680,485,2.99,16680,16680,1399-10-2
499,سخاش,سيمان‌خاش‌,353,250273,29544727650,112430,118050,118050,5620,5.0,115320,2890,2.57,118050,118050,1399-10-2
500,نطرين,عطرين نخ قم,353,3433603,40526816209,11241,11803,11803,562,5.0,11700,459,4.08,11803,11803,1399-10-2
501,ولراز,ليزينگ رازي,342,341618,18331563498,51106,53661,53661,2555,5.0,53223,2117,4.14,53661,53661,1399-10-2
502,سهرمز,سيمان‌هرمزگان‌,339,448177,9272972510,20490,19600,20890,400,1.95,20530,40,0.2,19600,20990,1399-10-2
503,تسه9907,امتياز تسهيلات مسكن مهر99,338,4488,2565676596,594913,567335,566000,-28913,-4.86,571675,-23238,-3.91,565168,589930,1399-10-2
504,خپويش,سازه‌ پويش‌,336,534759,21925119000,39050,41000,41000,1950,4.99,39840,790,2.02,41000,41000,1399-10-2
505,ثپرديسح,ح.سرمايه گذاري مسكن پرديس,335,4778181,41547899340,9091,9545,8690,-401,-4.41,8695,-396,-4.36,8690,9545,1399-10-2
506,وپسا,س. پتروشيمي ساختمان  خليج فارس,333,5599766,21626296292,3750,3862,3862,112,2.99,3862,112,2.99,3862,3862,1399-10-2
507,ثشرقح,ح. سرمايه گذاري مسكن شمال شرق,333,8717740,39300403560,4430,4870,4460,30,0.68,4510,80,1.81,4430,4870,1399-10-2
508,غمهرا,توليدي‌مهرام‌,328,632098,47356782160,71360,74920,74920,3560,4.99,74370,3010,4.22,74920,74920,1399-10-2
509,ساروج,بين المللي ساروج بوشهر,323,1018044,24039231258,23741,24451,23400,-341,-1.44,23613,-128,-0.54,23287,24451,1399-10-2
510,وشمال,س. چشم انداز توسعه شمال,316,447797,44422805791,96314,99203,99203,2889,3.0,99203,2889,3.0,99203,99203,1399-10-2
511,خلنت,لنت‌ ترمزايران‌,316,163565,14806903000,88600,91700,90000,1400,1.58,89150,550,0.62,87270,92000,1399-10-2
512,سلار,شركت سيمان لارستان,315,949430,42623311886,43770,45083,45083,1313,3.0,44894,1124,2.57,42500,45083,1399-10-2
513,غگلستا,شير پاستوريزه پگاه گلستان,311,1611457,38953750061,23022,24173,24173,1151,5.0,23760,738,3.21,24173,24173,1399-10-2
514,خفناور,مهندسي صنعتي روان فن آور,309,558625,14591843625,25361,26121,26121,760,3.0,25934,573,2.26,26121,26121,1399-10-2
515,غبهار,كشت وصنعت بهاران گلبهار خراسان,303,656826,31452769836,46492,47886,47886,1394,3.0,47886,1394,3.0,47886,47886,1399-10-2
516,ثقزوي,شركت عمران و سازندگي قزوين,303,1814055,58711890075,31423,32365,32365,942,3.0,32365,942,3.0,32365,32365,1399-10-2
517,آساس,صندوق س.آسمان آرماني سهام-س,297,78796,13887298057,176181,177500,176150,-31,-0.02,176244,63,0.04,175000,177500,1399-10-2
518,سپاس,صندوق س. پاداش سهامداري توسعه1,295,11528968,116332342109,10089,10099,10089,0,0.0,10090,1,0.01,10088,10101,1399-10-2
519,خاور,ايران خودرو ديزل,294,4506836,33900420392,7303,7522,7522,219,3.0,7522,219,3.0,7522,7522,1399-10-2
520,ضخود2008,اختيارخ خودرو-3500-1400/02/08,294,8454,8026871000,1028,901,929,-99,-9.63,949,-79,-7.68,900,1079,1399-10-2
521,غالبر,لبنيات‌ كالبر,291,2569778,35797007540,13270,13930,13930,660,4.97,13720,450,3.39,13930,13930,1399-10-2
522,دتوزيع,توزيع دارو پخش,289,726529,22130073340,29010,30460,30460,1450,5.0,29622,612,2.11,30460,30460,1399-10-2
523,وسصفا,شركت س استان اصفهان,277,14055552,15461107200,1050,1100,1100,50,4.76,1060,10,0.95,1100,1100,1399-10-2
524,كماسه,تامين‌ ماسه‌ ريخته‌گري‌,268,599195,39007594500,62000,65100,65100,3100,5.0,64080,2080,3.35,65100,65100,1399-10-2
525,دشيري,شيرين دارو,267,153155,25538379500,161901,166758,166758,4857,3.0,166749,4848,2.99,162000,166758,1399-10-2
526,درهآور,دارويي ره آورد تامين,266,418419,21225977451,48314,50729,50729,2415,5.0,49181,867,1.79,50729,50729,1399-10-2
527,خكار,ايركا پارت صنعت,262,2240640,67488076800,28690,30120,30120,1430,4.98,30120,1430,4.98,30120,30120,1399-10-2
528,زعف0008پ11,زعفران0008نگين سحرخيز(پ),259,110353,14224680918,128318,128001,129000,682,0.53,128902,584,0.46,128000,129400,1399-10-2
529,وكادو,تكادو,250,2651343,57860258289,21188,21823,21823,635,3.0,21823,635,3.0,21823,21823,1399-10-2
530,فنفت,صنايع تجهيزات نفت,249,2509573,43699133064,16586,17415,17415,829,5.0,17413,827,4.99,17083,17415,1399-10-2
531,سرود,سيمان‌شاهرود,247,4563014,86514745440,18060,18960,18960,900,4.98,18960,900,4.98,18960,18960,1399-10-2
532,آكورد,صندوق س. آرمان آتي كوثر-د,244,5231228,156272800800,29856,29878,29873,17,0.06,29873,17,0.06,29872,29878,1399-10-2
533,كوثر,بيمه كوثر,234,2692671,74175008037,26236,27547,27547,1311,5.0,27547,1311,5.0,27547,27547,1399-10-2
534,ثنور,سرمايه گذاري كوه نور,233,4472260,43036557980,9343,9623,9623,280,3.0,9623,280,3.0,9623,9623,1399-10-2
535,لازما,كارخانه هاي صنعتي آزمايش,229,1242814,36681655210,30117,29515,29515,-602,-2.0,29515,-602,-2.0,29515,29515,1399-10-2
536,سكه0012پ01,سكه تمام بهارتحويلي 1روزه رفاه,228,94900,110058035400,1174085,1160000,1162124,-11961,-1.02,1159726,-14359,-1.22,1155558,1167500,1399-10-2
537,بمپنا,توليد برق عسلويه  مپنا,225,90917,8945574421,97564,93250,98000,436,0.45,97712,148,0.15,93250,100026,1399-10-2
538,غفارس,شير پاستوريزه پگاه فارس,223,3890883,52989935577,12971,13619,13619,648,5.0,13543,572,4.41,13619,13619,1399-10-2
539,غگرجي,بيسكويت‌  گرجي‌,221,757781,14079570980,17700,18580,18580,880,4.97,18240,540,3.05,18580,18580,1399-10-2
540,كصدف,كاشي صدف سرام استقلال آباده,217,1301685,30506289660,22320,23436,23436,1116,5.0,23436,1116,5.0,23436,23436,1399-10-2
541,شلعاب,لعابيران‌,215,799887,9598644000,11430,12000,12000,570,4.99,11520,90,0.79,12000,12000,1399-10-2
542,ضخود1045,اختيارخ خودرو-4500-1399/10/07,215,10622,14802000,3,2,1,-2,-66.67,1,-2,-66.67,1,3,1399-10-2
543,شفا,سرمايه گذاري شفادارو,212,883312,58263259520,62820,65960,65960,3140,5.0,65920,3100,4.93,65960,65960,1399-10-2
544,وسرمد,بيمه  سرمد,212,3387695,28981730725,8306,8555,8555,249,3.0,8555,249,3.0,8555,8555,1399-10-2
545,تسه9904,امتياز تسهيلات مسكن تير99,212,3102,1778772034,591733,570000,562147,-29586,-5.0,573427,-18306,-3.09,562147,620000,1399-10-2
546,سبجنو,سيمان‌ بجنورد,207,132297,5030917060,37220,39060,37860,640,1.72,37300,80,0.21,37440,39060,1399-10-2
547,وثوق,سرمايه گذاري وثوق امين,205,356781,5136219276,13977,14396,14396,419,3.0,14075,98,0.7,14396,14396,1399-10-2
548,افرا,افرانت,203,701043,34155516003,46401,48721,48721,2320,5.0,47863,1462,3.15,48721,48721,1399-10-2
549,سغرب,سيمان‌غرب‌,203,1701978,36524282370,20440,21460,21460,1020,4.99,21130,690,3.38,21450,21460,1399-10-2
550,ضخود2009,اختيارخ خودرو-4000-1400/02/08,203,3832,3371200000,875,800,800,-75,-8.57,880,5,0.57,800,950,1399-10-2
551,تسه9902,امتياز تسهيلات مسكن ارديبهشت99,200,2714,1541882884,590164,561300,560656,-29508,-5.0,568122,-22042,-3.73,560656,584990,1399-10-2
552,خفنر,فنرسازي‌خاور,200,1102905,22366913400,19320,20280,20280,960,4.97,19770,450,2.33,20280,20280,1399-10-2
553,فنورد,نوردوقطعات‌ فولادي‌,198,92122,20890505940,215980,226770,226770,10790,5.0,219720,3740,1.73,226770,226770,1399-10-2
554,لبوتان,گروه‌صنعتي‌بوتان‌,196,343711,37058920020,102690,107820,107820,5130,5.0,105850,3160,3.08,107820,107820,1399-10-2
555,تسه9906,امتياز تسهيلات مسكن شهريور99,192,2307,1300918546,591805,562217,562215,-29590,-5.0,563901,-27904,-4.72,562215,579000,1399-10-2
556,تكنار,مجتمع معادن مس تكنار,189,289451,44676761850,149855,154350,154350,4495,3.0,154350,4495,3.0,154350,154350,1399-10-2
557,بكاب,صنايع‌جوشكاب‌يزد,187,130405,44838455200,327470,343840,343840,16370,5.0,340330,12860,3.93,343840,343840,1399-10-2
558,خچرخش,چرخشگر,184,1533232,25942285440,16120,16920,16920,800,4.96,16530,410,2.54,16920,16920,1399-10-2
559,بشهاب,لامپ‌  پارس‌ شهاب‌,183,194386,14956058840,73280,76940,76940,3660,4.99,74260,980,1.34,76940,76940,1399-10-2
560,وساغربي,شركت س استان آذربايجان غربي,182,6440663,4766090620,770,740,740,-30,-3.9,770,0,0.0,740,740,1399-10-2
561,تكنو,تكنوتار,182,1746341,27574724390,15040,15790,15790,750,4.99,15410,370,2.46,15790,15790,1399-10-2
562,دكيمي,كيميدارو,181,1887465,54396741300,27450,28820,28820,1370,4.99,28820,1370,4.99,28820,28820,1399-10-2
563,سجام,مجتمع سيمان غرب آسيا,181,540275,7235758636,13150,13450,13160,10,0.08,13238,88,0.67,12901,13544,1399-10-2
564,غپونه,نوش پونه مشهد,178,1299746,25124090180,18767,19330,19330,563,3.0,19330,563,3.0,19330,19330,1399-10-2
565,دجابر,داروسازي‌ جابرابن‌حيان‌,178,3260843,77640671830,22680,23810,23810,1130,4.98,23810,1130,4.98,23810,23810,1399-10-2
566,ثزاگرس,سرمايه گذاري توسعه عمران زاگرس,178,344085,17182228560,47559,49936,49936,2377,5.0,49246,1687,3.55,49936,49936,1399-10-2
567,سكارون,سيمان كارون,177,1274081,206830487297,157609,162337,162337,4728,3.0,162337,4728,3.0,162337,162337,1399-10-2
568,پلوله,گازلوله‌,176,620097,10857484796,17592,17417,17767,175,0.99,17509,-83,-0.47,17417,17767,1399-10-2
569,معيار,سرمايه گذاري معيار صنعت پارس,176,236693,8098450995,33545,34215,34215,670,2.0,34048,503,1.5,34215,34215,1399-10-2
570,تسه9810,امتياز تسهيلات مسكن دي98,174,3333,1907427981,587628,589100,558247,-29381,-5.0,572286,-15342,-2.61,558247,616999,1399-10-2
571,واحصا,احياء صنايع خراسان,173,451206,14931760158,32130,33093,33093,963,3.0,32840,710,2.21,33093,33093,1399-10-2
572,شمواد,توليد مواداوليه الياف مصنوعي,167,316638,17594307108,53948,55566,55566,1618,3.0,55388,1440,2.67,55566,55566,1399-10-2
573,فروس,فروسيليس‌ ايران‌,166,2477918,15561325040,5990,6280,6280,290,4.84,6070,80,1.34,6280,6280,1399-10-2
574,غشصفا,شيرپاستوريزه‌پگاه‌اصفهان‌,165,1703233,52817255330,29540,31010,31010,1470,4.98,31010,1470,4.98,31010,31010,1399-10-2
575,ضخود1048,اختيارخ خودرو-7000-1399/10/07,162,7786,7788000,2,1,1,-1,-50.0,1,-1,-50.0,1,2,1399-10-2
576,ضچاد1017,اختيارخ كچاد-20000-1399/10/02,161,1977,243201000,358,60,6,-352,-98.32,123,-235,-65.64,2,500,1399-10-2
577,دمعيار,صندوق س. توازن معيار-د,161,6034506,60403874943,10005,10010,10011,6,0.06,10010,5,0.05,10005,10011,1399-10-2
578,كقزوي,شيشه‌ قزوين‌,160,973270,8671835700,8651,8910,8910,259,2.99,8766,115,1.33,8910,8910,1399-10-2
579,زكشت,كشاورزي مكانيزه اصفهان كشت,159,559082,19926241562,33944,35641,35641,1697,5.0,34590,646,1.9,35641,35641,1399-10-2
580,رتكو,كنترل‌خوردگي‌تكين‌كو,158,1217636,27226340960,21300,22360,22360,1060,4.98,21800,500,2.35,22360,22360,1399-10-2
581,تسه9711,امتياز تسهيلات مسكن بهمن 97,158,2695,1490392726,575352,561999,546585,-28767,-5.0,553021,-22331,-3.88,546585,568155,1399-10-2
582,پلاست,كارخانجات توليدي پلاستيران,158,247217,10960365695,43044,44335,44335,1291,3.0,43742,698,1.62,44335,44335,1399-10-2
583,غدشت,دشت‌ مرغاب‌,157,87827,23145049310,250990,263530,263530,12540,5.0,256090,5100,2.03,263530,263530,1399-10-2
584,شتولي,تولي‌پرس‌,153,327630,9883941840,29008,30168,30168,1160,4.0,30088,1080,3.72,30168,30168,1399-10-2
585,سدشت,صنايع سيمان دشتستان,151,261813,10277095130,37460,37990,39330,1870,4.99,37810,350,0.93,37990,39330,1399-10-2
586,شفارا,پتروشيمي فارابي,150,1955849,9812494433,4871,5017,5017,146,3.0,4943,72,1.48,5017,5017,1399-10-2
587,گپارس,امور رفاهي كارگزاران پارس,149,74009,9868762813,135365,135200,134500,-865,-0.64,134355,-1010,-0.75,131305,137000,1399-10-2
588,ثاباد,توريستي ورفاهي آبادگران ايران,144,483569,18390129070,36220,38030,38030,1810,5.0,36830,610,1.68,38030,38030,1399-10-2
589,اوصتا,صندوق انديشه ورزان صباتامين -د,143,11350895,197748644745,17412,17418,17420,8,0.05,17421,9,0.05,17418,17426,1399-10-2
590,فيروزا,صندوق بادرآمد ثابت فيروزه آسيا,143,405578,8756052676,21486,21594,21611,125,0.58,21589,103,0.48,21449,21631,1399-10-2
591,سنوين,سرمايه گذاري اقتصاد نوين,143,1533215,15201030570,9921,10119,9750,-171,-1.72,9914,-7,-0.07,9723,10119,1399-10-2
592,كخاك,صنايع‌خاك‌چيني‌ايران‌,141,689765,40599567900,56060,58860,58860,2800,4.99,57990,1930,3.44,58860,58860,1399-10-2
593,ختراك,ريخته‌گري‌ تراكتورسازي‌ ايران‌,140,1043980,15659700000,14290,15000,15000,710,4.97,14490,200,1.4,15000,15000,1399-10-2
594,ضجار1016,اختيارخ وتجارت-4000-1399/10/21,140,4828,725373000,163,120,154,-9,-5.52,150,-13,-7.98,120,180,1399-10-2
595,فپنتا,سپنتا,140,124321,56771184650,434910,456650,456650,21740,5.0,456650,21740,5.0,456650,456650,1399-10-2
596,تسه9905,امتياز تسهيلات مسكن مرداد99,134,802,453947217,592900,563258,563255,-29645,-5.0,566019,-26881,-4.53,563255,574999,1399-10-2
597,سكه9912پ04,سكه تمام بهارتحويل1روزه صادرات,133,61500,71104854600,1174084,1170000,1160000,-14084,-1.2,1156176,-17908,-1.53,1153004,1170000,1399-10-2
598,بالبر,كابل‌ البرز,132,482410,13767981400,27190,28540,28540,1350,4.97,27540,350,1.29,28540,28540,1399-10-2
599,ثعتما,س. ساختماني اعتماد گستر,131,447345,19860328620,42282,44396,44396,2114,5.0,44189,1907,4.51,44396,44396,1399-10-2
600,تابا,تابان نيرو سپاهان,131,233193,8505947868,35414,36476,36476,1062,3.0,35818,404,1.14,36476,36476,1399-10-2
601,كپرور,فرآوري زغال سنگ پروده طبس,128,324014,15477176738,45493,47767,47767,2274,5.0,46124,631,1.39,47767,47767,1399-10-2
602,ضپاس1005,اختيارخ وپارس-4500-1399/10/30,120,5389,1920530000,331,350,350,19,5.74,356,25,7.55,300,390,1399-10-2
603,تصميم,صندوق س با درآمد ثابت تصميم,114,1262988,19268155959,15244,15245,15260,16,0.1,15256,12,0.08,15245,15260,1399-10-2
604,سپر,صندوق س سپر سرمايه بيدار- ثابت,110,897805,9768312351,10800,10850,10899,99,0.92,10880,80,0.74,10850,10900,1399-10-2
605,نيرو,نيرو سرمايه,109,210077,12448532789,56436,59257,59257,2821,5.0,58001,1565,2.77,59257,59257,1399-10-2
606,ضجار1015,اختيارخ وتجارت-3500-1399/10/21,108,2783,865088000,318,314,302,-16,-5.03,311,-7,-2.2,280,350,1399-10-2
607,زعف0008پ08,زعفران0008نگين روستا(پ),107,77536,9964019282,128781,128500,129000,219,0.17,128508,-273,-0.21,128000,129400,1399-10-2
608,حاريا,كشتيراني آريا,104,759493,20638462782,26383,27174,27174,791,3.0,27174,791,3.0,27174,27174,1399-10-2
609,تسه9903,امتياز تسهيلات مسكن خرداد99,104,815,466240224,595419,590000,565649,-29770,-5.0,572074,-23345,-3.92,565649,590000,1399-10-2
610,كي بي سي,شركت كي بي سي,103,2237137,80024627627,34068,35771,35771,1703,5.0,35771,1703,5.0,35771,35771,1399-10-2
611,وبرق,س.کارکنان صنعت برق زنجان وقزوي,100,84145,17051479380,196742,202644,202644,5902,3.0,201556,4814,2.45,202644,202644,1399-10-2
612,كهرام,توليدي گرانيت بهسرام,99,172203,12344199852,69597,71684,71684,2087,3.0,70814,1217,1.75,71684,71684,1399-10-2
613,گوهر,صندوق سكه طلاي كيان,99,37578,2201305043,59244,59499,58284,-960,-1.62,58580,-664,-1.12,58252,59499,1399-10-2
614,تپولا,مهندسي مرآت پولاد,98,290848,9590712800,32015,32975,32975,960,3.0,32438,423,1.32,32975,32975,1399-10-2
615,داوه,داروسازي آوه سينا,98,335968,6769755200,19191,20150,20150,959,5.0,19312,121,0.63,20150,20150,1399-10-2
616,نتوس,پشم‌ بافي‌ توس,98,680925,9088986900,12960,13348,13348,388,2.99,13120,160,1.23,13348,13348,1399-10-2
617,ثاژن,سخت آژند,97,1214660,10313678060,8165,8491,8491,326,3.99,8474,309,3.78,8491,8491,1399-10-2
618,هجرت,پخش هجرت,95,601495,22379824465,35436,37207,37207,1771,5.0,36115,679,1.92,37207,37207,1399-10-2
619,بموتو,موتوژن‌,95,100547,5459702100,51720,54300,54300,2580,4.99,51980,260,0.5,54300,54300,1399-10-2
620,تسه9901,امتياز تسهيلات مسكن فروردين99,95,923,521031367,593659,564000,563977,-29682,-5.0,564498,-29161,-4.91,563977,570000,1399-10-2
621,صنوين,صندوق سرمايه‌گذاري صنوين-مختلط,93,25354,2668417380,105580,105300,106000,420,0.4,105250,-330,-0.31,105000,106000,1399-10-2
622,آساميد,صندوق س.مشترك آسمان اميد -د,93,2607647,29334255304,11240,11254,11256,16,0.14,11249,9,0.08,11247,11257,1399-10-2
623,فنرژي,گسترش صنايع انرژي آذرآب,92,414018,4995541188,11830,12066,12066,236,1.99,11940,110,0.93,12066,12066,1399-10-2
624,كگهر,سنگ آهن گهرزمين,90,498215,24992955475,47777,50165,50165,2388,5.0,48241,464,0.97,50165,50165,1399-10-2
625,ضصاد1104,اختيارخ وبصادر-4500-1399/11/12,90,3709,581238000,164,165,180,16,9.76,157,-7,-4.27,123,180,1399-10-2
626,ضسپا1102,اختيارخ خساپا-2000-1399/11/26,90,4071,3368268000,601,590,900,299,49.75,827,226,37.6,590,900,1399-10-2
627,كتوكا,توليدي و خدمات صنايع نسوز توكا,87,709096,18347149904,24642,25874,25874,1232,5.0,25057,415,1.68,25874,25874,1399-10-2
628,كپشير,پشم‌شيشه‌ايران‌,85,551503,13401522900,23150,24300,24300,1150,4.97,23430,280,1.21,24300,24300,1399-10-2
629,تسه9811,امتياز تسهيلات مسكن بهمن98,84,666,386236686,576334,550120,605150,28816,5.0,579935,3601,0.62,550120,605150,1399-10-2
630,دروز,داروسازي‌ روزدارو,84,444029,8472073320,18180,19080,19080,900,4.95,18320,140,0.77,19080,19080,1399-10-2
631,تسه9812,امتياز تسهيلات مسكن اسفند98,84,707,402434485,586072,558000,556769,-29303,-5.0,569214,-16858,-2.88,556769,610000,1399-10-2
632,صايند,صندوق س. گنجينه آينده روشن-د,84,1384510,13908225230,10030,10030,10045,15,0.15,10046,16,0.16,10026,10078,1399-10-2
633,سايرا,ايرانيت‌,83,157407,5359922479,34063,33382,34744,681,2.0,34057,-6,-0.02,33382,34744,1399-10-2
634,اخزا902,اسنادخزانه-م2بودجه99-011019,82,181959,122528461738,674527,673011,673011,-1516,-0.22,673385,-1142,-0.17,672000,676990,1399-10-2
635,ضخود1046,اختيارخ خودرو-5000-1399/10/07,82,5399,7567000,2,1,1,-1,-50.0,1,-1,-50.0,1,3,1399-10-2
636,اخزا815,اسنادخزانه-م15بودجه98-010406,81,183100,139892195935,761987,761000,762001,14,0.0,764021,2034,0.27,758000,778911,1399-10-2
637,تسه9710,امتياز تسهيلات مسكن دي 97,79,1954,943074071,506629,499900,481298,-25331,-5.0,482638,-23991,-4.74,481298,499900,1399-10-2
638,تسه9801,امتياز تسهيلات مسكن فروردين98,79,1117,631130357,592434,580001,562813,-29621,-5.0,565023,-27411,-4.63,562813,580028,1399-10-2
639,تسه9803,امتياز تسهيلات مسكن خرداد98,77,659,372116054,578151,551111,556000,-22151,-3.83,564668,-13483,-2.33,550000,589000,1399-10-2
640,بذر,صندوق س بذر اميد آفرين-سهام,77,25671,2897592970,112700,111290,113500,800,0.71,112870,170,0.15,111290,113900,1399-10-2
641,شصفها,پتروشيمي‌ اصفهان‌,74,84412,10542130268,120086,124889,124889,4803,4.0,123465,3379,2.81,124889,124889,1399-10-2
642,ضجار1017,اختيارخ وتجارت-4500-1399/10/21,71,2974,131384000,45,50,50,5,11.11,44,-1,-2.22,31,55,1399-10-2
643,آسام,صندوق س.آرمان سپهر آشنا-م,71,58360,6488619970,109491,108060,111511,2020,1.84,111183,1692,1.55,108060,111990,1399-10-2
644,الماس,صندوق س.امين تدبيرگران فردا-س,69,21451,2791925291,130833,130995,131127,294,0.22,130154,-679,-0.52,129500,131200,1399-10-2
645,افران,صندوق س افرا نماد پايدار-ثابت,69,507366,6255195570,12316,12330,12330,14,0.11,12329,13,0.11,12313,12330,1399-10-2
646,تسه9802,امتياز تسهيلات مسكن ارديبهشت98,69,284,163377067,587719,560001,575000,-12719,-2.16,575271,-12448,-2.12,560001,580000,1399-10-2
647,ضسپا1103,اختيارخ خساپا-2500-1399/11/26,68,2511,1625984000,585,625,628,43,7.35,648,63,10.77,622,695,1399-10-2
648,سفارود,كارخانه فارسيت درود,65,370270,4483599430,11644,12109,12109,465,3.99,11840,196,1.68,12109,12109,1399-10-2
649,شكف,كف,65,66195,5503187520,81506,83136,83136,1630,2.0,82340,834,1.02,83136,83136,1399-10-2
650,اخزا820,اسنادخزانه-م20بودجه98-020806,64,184657,107063335300,579570,580000,580000,430,0.07,579796,226,0.04,578000,580000,1399-10-2
651,ضخود1040,اختيارخ خودرو-2000-1399/10/07,63,4340,6049383000,1349,1280,1400,51,3.78,1394,45,3.34,1280,1450,1399-10-2
652,دارو,كارخانجات‌داروپخش‌,61,440002,14009663680,30330,31840,31840,1510,4.98,31110,780,2.57,31840,31840,1399-10-2
653,اخزا903,اسنادخزانه-م3بودجه99-011110,58,159058,106279971939,666279,666004,668889,2610,0.39,668184,1905,0.29,666000,669999,1399-10-2
654,تسه9809,امتياز تسهيلات مسكن آذر98,58,1588,896479901,582352,561340,555000,-27352,-4.7,564534,-17818,-3.06,553235,579990,1399-10-2
655,تسه9712,امتياز تسهيلات مسكن اسفند97,57,1153,647127499,588607,581010,559177,-29430,-5.0,561255,-27352,-4.65,559177,581010,1399-10-2
656,ضچاد1014,اختيارخ كچاد-14000-1399/10/02,55,970,6007504000,6222,5700,6010,-212,-3.41,6193,-29,-0.47,5700,6600,1399-10-2
657,ضخود2007,اختيارخ خودرو-3000-1400/02/08,54,2336,2803148000,1186,914,1180,-6,-0.51,1200,14,1.18,914,1250,1399-10-2
658,ضپاس1003,اختيارخ وپارس-3500-1399/10/30,51,1489,1406698000,805,799,970,165,20.5,945,140,17.39,799,1020,1399-10-2
659,ضجار1014,اختيارخ وتجارت-3000-1399/10/21,50,1594,1009934000,572,100,700,128,22.38,634,62,10.84,100,700,1399-10-2
660,ضملي1152,اختيارخ فملي-18252-1399/11/05,49,193,185131360,599,370,499,-100,-16.69,486,-113,-18.86,370,729,1399-10-2
661,تسه9808,امتياز تسهيلات مسكن آبان98,49,639,363588928,579867,551122,558000,-21867,-3.77,568997,-10870,-1.87,551002,608860,1399-10-2
662,ارمغان,ص سرمايه گذاري ارمغان ايرانيان,49,801891,8098169513,10092,10092,10101,9,0.09,10099,7,0.07,10090,10118,1399-10-2
663,سدبير,س. تدبيرگران فارس وخوزستان,49,134203,6897363185,48948,51395,51395,2447,5.0,49254,306,0.63,51395,51395,1399-10-2
664,وآتوس,س.آرين توسكا قيمت اسمي 350ريال,48,426788,16713871656,38022,39162,39162,1140,3.0,38885,863,2.27,39162,39162,1399-10-2
665,فوكا,فولاد كاويان,47,108047,1665652552,15892,15416,15416,-476,-3.0,15870,-22,-0.14,15416,15416,1399-10-2
666,وجامي,سرمايه گذاري جامي,46,287812,3253139036,10974,11303,11303,329,3.0,11024,50,0.46,11303,11303,1399-10-2
667,شرنگي,شيميايي رنگين,46,17995,2306743060,124455,128188,128188,3733,3.0,124868,413,0.33,128188,128188,1399-10-2
668,سكه0011پ02,سكه تمام بهارتحويلي 1روزه ملت,45,7000,8138600700,1173091,1153000,1164000,-9091,-0.77,1162657,-10434,-0.89,1153000,1170000,1399-10-2
669,ضفلا1156,اختيارخ فولاد-16000-1399/11/28,45,898,1127350000,1258,1437,1209,-49,-3.9,1255,-3,-0.24,1209,1440,1399-10-2
670,ضخود2005,اختيارخ خودرو-2000-1400/02/08,43,792,1588706000,1954,1950,1954,0,0.0,2006,52,2.66,1950,2149,1399-10-2
671,شزنگ,تجهيزنيروي‌زنگان‌,43,33116,7691753972,225502,232267,232267,6765,3.0,227863,2361,1.05,232267,232267,1399-10-2
672,ضصاد1103,اختيارخ وبصادر-4000-1399/11/12,43,481,126454000,249,274,268,19,7.63,263,14,5.62,220,297,1399-10-2
673,ضشنا1035,اختيارخ شپنا-14000-1399/10/23,43,503,1075698000,2237,2500,2110,-127,-5.68,2139,-98,-4.38,1820,2500,1399-10-2
674,وسكرد,شركت س استان كردستان,42,1441777,1081332750,780,750,750,-30,-3.85,780,0,0.0,750,750,1399-10-2
675,ضچاد1015,اختيارخ كچاد-16000-1399/10/02,42,394,1639166000,4445,4000,4100,-345,-7.76,4160,-285,-6.41,4000,4500,1399-10-2
676,زعف0008پ16,زعفران0008نگين بيرجند(پ),40,22456,2892818617,128239,128500,129300,1061,0.83,128822,583,0.45,128500,129300,1399-10-2
677,ضخود2013,اختيارخ خودرو-7000-1400/02/08,38,2387,564439000,201,260,199,-2,-1.0,236,35,17.41,199,278,1399-10-2
678,دقاضي,داروسازي شهيد قاضي,38,166729,8554864990,45467,51310,51310,5843,12.85,50062,4595,10.11,51310,51310,1399-10-2
679,سكه0112پ03,سكه تمام بهارتحويلي1روزه سامان,38,8600,9984362700,1171225,1160000,1160000,-11225,-0.96,1160972,-10253,-0.88,1155000,1169000,1399-10-2
680,ضصاد1101,اختيارخ وبصادر-3000-1399/11/12,37,1241,785043000,612,699,650,38,6.21,633,21,3.43,565,700,1399-10-2
681,ضپاس1002,اختيارخ وپارس-3000-1399/10/30,37,1349,1695166000,1094,1200,1300,206,18.83,1257,163,14.9,1200,1390,1399-10-2
682,اخزا808,اسنادخزانه-م8بودجه98-000817,37,29084,24927807276,856309,856309,858000,1691,0.2,857097,788,0.09,855017,858999,1399-10-2
683,تسه9806,امتياز تسهيلات مسكن شهريور98,36,233,133301524,564000,592200,536100,-27900,-4.95,572110,8110,1.44,535800,592200,1399-10-2
684,اخزا905,اسنادخزانه-م5بودجه99-020218,35,107560,68144607392,633986,633500,633550,-436,-0.07,633550,-436,-0.07,630000,634995,1399-10-2
685,ضفار1125,اختيارخ فارس-17826-1399/11/07,35,476,150256000,345,121,280,-65,-18.84,158,-187,-54.2,100,290,1399-10-2
686,عيار2,صندوق س. پشتوانه طلاي مفيد,35,350000,350000,28965,1,1,-28964,-100.0,1,-28964,-100.0,1,1,1399-10-2
687,ضترا1117,اختيارخ شتران-10000-1399/11/14,35,513,1281394000,2635,2900,3100,465,17.65,2498,-137,-5.2,2260,3100,1399-10-2
688,ثروتم,صندوق س. ثروت آفرين پارسيان-س,35,23020,2240442020,96463,95001,96300,-163,-0.17,97326,863,0.89,95000,97810,1399-10-2
689,هفارس912,اختيارف ت فارس-14576-99/12/13,34,785286,596817360,773,760,760,-13,-1.68,760,-13,-1.68,760,760,1399-10-2
690,پدرخش,درخشان‌ تهران‌,33,6918,1333236960,202860,192720,192720,-10140,-5.0,202570,-290,-0.14,192720,192720,1399-10-2
691,فاهواز,نورد و لوله اهواز,33,27746,511192304,18800,18424,18424,-376,-2.0,18795,-5,-0.03,18424,18424,1399-10-2
692,زعف0008پ05,زعفران0008نگين زرين(پ),33,31747,4090819900,128518,128500,129500,982,0.76,128857,339,0.26,128100,129500,1399-10-2
693,اخزا809,اسنادخزانه-م9بودجه98-000923,33,21338,17979813396,843345,843345,842900,-445,-0.05,842619,-726,-0.09,841000,843502,1399-10-2
694,اخزا814,اسنادخزانه-م14بودجه98-010318,32,123241,95220874311,770588,771000,774000,3412,0.44,772640,2052,0.27,770800,774200,1399-10-2
695,تسه9807,امتياز تسهيلات مسكن مهر98,31,471,272189945,585464,557001,580000,-5464,-0.93,577898,-7566,-1.29,556191,590000,1399-10-2
696,جوين,كشت و صنعت جوين,30,105711,2789290446,25618,26386,26386,768,3.0,25720,102,0.4,26386,26386,1399-10-2
697,حرهشا,رهشاد سپاهان (سهامي عام,30,17687,1050006442,61202,59366,59366,-1836,-3.0,61103,-99,-0.16,59366,59366,1399-10-2
698,آكورد2,صندوق س. آرمان آتي كوثر-د,30,3000000,3000000,29856,1,1,-29855,-100.0,1,-29855,-100.0,1,1,1399-10-2
699,كباده,توليد خاك نسوزاستقلال آباده,29,500000,12894000000,24560,25788,25788,1228,5.0,25253,693,2.82,25788,25788,1399-10-2
700,اخزا904,اسنادخزانه-م4بودجه99-011215,29,127374,83329502869,653581,654001,654501,920,0.14,654211,630,0.1,653132,656300,1399-10-2
701,وسيستا,شركت س استان سيستان وبلوچستان,29,608364,462356640,790,760,760,-30,-3.8,790,0,0.0,760,760,1399-10-2
702,تسه9805,امتياز تسهيلات مسكن مرداد98,27,169,93808168,582023,552922,555000,-27023,-4.64,555078,-26945,-4.63,552922,557000,1399-10-2
703,آينده,بازرگاني آينده سازان بهشت پارس,26,74234,1527661486,21215,20579,20579,-636,-3.0,21165,-50,-0.24,20579,20579,1399-10-2
704,اخزا817,اسنادخزانه-م17بودجه98-010512,26,21937,16453048810,750064,749803,750500,436,0.06,750014,-50,-0.01,749500,757990,1399-10-2
705,تسه9804,امتياز تسهيلات مسكن تير98,24,325,181616082,578438,550010,550000,-28438,-4.92,558819,-19619,-3.39,550000,578438,1399-10-2
706,ضجار1018,اختيارخ وتجارت-5000-1399/10/21,24,1992,52195000,16,13,29,13,81.25,26,10,62.5,13,90,1399-10-2
707,اخزا816,اسنادخزانه-م16بودجه98-010503,24,188580,142099742615,751620,751007,752000,380,0.05,753525,1905,0.25,750601,755000,1399-10-2
708,زعف0008پ10,زعفران0008نگين طلاي سرخ(پ),23,4655,599352500,128559,128011,128800,241,0.19,128755,196,0.15,128010,129150,1399-10-2
709,وسخوز,شركت س استان خوزستان,23,651684,606066120,970,930,930,-40,-4.12,970,0,0.0,930,930,1399-10-2
710,ضصاد1100,اختيارخ وبصادر-2500-1399/11/12,23,624,555969000,821,995,984,163,19.85,891,70,8.53,801,1000,1399-10-2
711,وسكرمان,س.سهام عدالت استان كرمان,22,384639,376946220,1030,980,980,-50,-4.85,1030,0,0.0,980,980,1399-10-2
712,سخند,صندوق س.سپهرخبرگان نفت-د,21,201350,2033426720,10082,10085,10106,24,0.24,10099,17,0.17,10085,10110,1399-10-2
713,اخزا811,اسنادخزانه-م11بودجه98-001013,21,53109,44420637377,836722,832001,837000,278,0.03,836405,-317,-0.04,832001,837000,1399-10-2
714,ضچاد1016,اختيارخ كچاد-18000-1399/10/02,21,251,547054000,2341,2010,2000,-341,-14.57,2179,-162,-6.92,1850,2400,1399-10-2
715,ضصاد1105,اختيارخ وبصادر-5000-1399/11/12,20,856,75360000,90,90,90,0,0.0,88,-2,-2.22,62,90,1399-10-2
716,طمخا1028,اختيارف اخابر-24000-1399/10/30,20,1891,17253484000,6687,9124,9124,2437,36.44,9124,2437,36.44,9124,9124,1399-10-2
717,اخزا704,اسنادخزانه-م4بودجه97-991022,19,65102,64386058607,990000,995299,989000,-1000,-0.1,989003,-997,-0.1,989000,995299,1399-10-2
718,وسگيلا,شركت س استان گيلان,19,384823,304010170,830,790,790,-40,-4.82,830,0,0.0,790,790,1399-10-2
719,وسلرستا,شركت س استان لرستان,19,469478,403751080,900,860,860,-40,-4.44,900,0,0.0,860,860,1399-10-2
720,اخزا821,اسنادخزانه-م21بودجه98-020906,18,6722,3851204460,572398,573000,572010,-388,-0.07,572925,527,0.09,572010,573900,1399-10-2
721,ضسپا1106,اختيارخ خساپا-4000-1399/11/26,17,729,115330000,121,150,130,9,7.44,158,37,30.58,130,170,1399-10-2
722,ضفلا1155,اختيارخ فولاد-14000-1399/11/28,17,358,831890000,2117,2350,2350,233,11.01,2324,207,9.78,2200,2440,1399-10-2
723,زعف0008پ18,زعفران0008نگين بهرامن(پ),17,51334,6616430005,128022,128000,129000,978,0.76,128890,868,0.68,128000,129000,1399-10-2
724,اخزا806,اسنادخزانه-م6بودجه98-000519,17,7314,6541898943,893034,893400,895998,2964,0.33,894435,1401,0.16,893400,896000,1399-10-2
725,ضترا1118,اختيارخ شتران-12000-1399/11/14,16,506,972209000,1879,2000,1800,-79,-4.2,1921,42,2.24,1800,2150,1399-10-2
726,اخزا721,اسنادخزانه-م21بودجه97-000728,16,13564,11716947684,863437,863437,862984,-453,-0.05,863827,390,0.05,862982,865950,1399-10-2
727,اخزا818,اسنادخزانه-م18بودجه98-010614,16,12574,9201282903,732638,730209,731650,-988,-0.13,731771,-867,-0.12,730209,733000,1399-10-2
728,اخزا813,اسنادخزانه-م13بودجه98-010219,16,29645,23191272795,781972,782350,782105,133,0.02,782300,328,0.04,782100,782500,1399-10-2
729,داريك,صندوق س.اعتماد داريك-د,16,304968,3179824452,10426,10427,10427,1,0.01,10427,1,0.01,10400,10439,1399-10-2
730,ضغدر1119,اختيارخ وغدير-10000-1399/11/26,16,166,566420000,3600,4000,3600,0,0.0,3412,-188,-5.22,3000,4000,1399-10-2
731,اخزا906,اسنادخزانه-م6بودجه99-020321,15,12004,7342874448,632960,610897,619700,-13260,-2.09,611702,-21258,-3.36,606000,622000,1399-10-2
732,كشم0001پ01,كشمش سبز0001خليل آباد(پ),15,218,74919560,333174,348000,349832,16658,5.0,343668,10494,3.15,333000,349832,1399-10-2
733,ضصاد1106,اختيارخ وبصادر-6000-1399/11/12,15,620,21896000,51,31,37,-14,-27.45,35,-16,-31.37,31,40,1399-10-2
734,شستا991,اجاره تامين اجتماعي-امين991226,15,151,151718980,986219,1009000,1009996,23777,2.41,1004761,18542,1.88,982013,1009996,1399-10-2
735,گنجين,صندوق س. گنجينه يكم آويد-د,15,102227,1214605103,11870,11872,11873,3,0.03,11881,11,0.09,11872,11884,1399-10-2
736,ضخود1047,اختيارخ خودرو-6000-1399/10/07,14,617,617000,2,1,1,-1,-50.0,1,-1,-50.0,1,1,1399-10-2
737,وسفارس,شركت س استان فارس,13,150728,147713440,1030,980,980,-50,-4.85,1030,0,0.0,980,980,1399-10-2
738,اخزا812,اسنادخزانه-م12بودجه98-001111,13,21684,17868560000,823103,824400,824000,897,0.11,824044,941,0.11,824000,824400,1399-10-2
739,ضشنا1036,اختيارخ شپنا-16000-1399/10/23,13,62,89108000,1451,1800,1210,-241,-16.61,1437,-14,-0.96,1210,1850,1399-10-2
740,سرو2,صندوق س سروسودمند مدبران-سهام,12,1200000,1200000,73640,1,1,-73639,-100.0,1,-73639,-100.0,1,1,1399-10-2
741,اخزا723,اسنادخزانه-م23بودجه97-000824,12,3361,2864047916,851685,852101,852100,415,0.05,852142,457,0.05,852100,853000,1399-10-2
742,ضسپا1104,اختيارخ خساپا-3000-1399/11/26,12,393,200353000,399,560,499,100,25.06,510,111,27.82,400,570,1399-10-2
743,وسرضوي,س.سهام عدالت استان خراسان رضوي,11,93849,91972020,1030,980,980,-50,-4.85,1030,0,0.0,980,980,1399-10-2
744,ضجار2001,اختيارخ وتجارت-2000-1400/02/22,11,68,137900000,1,2000,2200,2199,219900.0,2028,2027,202700.0,2000,2450,1399-10-2
745,ضپاس1001,اختيارخ وپارس-2500-1399/10/30,11,98,176226000,1343,1550,1829,486,36.19,1798,455,33.88,1550,1850,1399-10-2
746,خعمرا,توسعه و عمران شهرستان نائين,11,48341,1067320939,21436,22079,22079,643,3.0,21469,33,0.15,22079,22079,1399-10-2
747,ضملت1126,اختيارخ وبملت-4500-1399/11/28,11,451,475764000,962,1051,1050,88,9.15,1055,93,9.67,1050,1100,1399-10-2
748,وسهمدا,شركت س استان همدان,11,511213,434531050,890,850,850,-40,-4.49,890,0,0.0,850,850,1399-10-2
749,اخزا908,اسنادخزانه-م8بودجه99-020606,10,100011,60006858520,595910,625705,600000,4090,0.69,600003,4093,0.69,599999,625705,1399-10-2
750,زعف0008پ09,زعفران0008نگين نوين(پ),10,7970,1025388700,129000,128210,129000,0,0.0,128656,-344,-0.27,128210,129000,1399-10-2
751,ضملت1128,اختيارخ وبملت-6000-1399/11/28,10,111,58805000,503,510,549,46,9.15,530,27,5.37,490,549,1399-10-2
752,ضچاد1018,اختيارخ كچاد-24000-1399/10/02,10,116,1216000,86,1,12,-74,-86.05,10,-76,-88.37,1,12,1399-10-2
753,ضجار2000,اختيارخ وتجارت-1800-1400/02/22,10,45,102294000,1,2200,2499,2498,249800.0,2273,2272,227200.0,2200,2500,1399-10-2
754,زر2,صندوق س.پشتوانه سكه طلاي زر,10,1000000,1000000,48803,1,1,-48802,-100.0,1,-48802,-100.0,1,1,1399-10-2
755,هترول911,اختيارف ت پترول-14730-99/11/15,10,8745,19422645,2293,2221,2221,-72,-3.14,2221,-72,-3.14,2221,2221,1399-10-2
756,نگين,ص.س. زمين و ساختمان نگين شهرري,9,8758,416291940,47540,47530,47530,-10,-0.02,47530,-10,-0.02,47530,47750,1399-10-2
757,كابگن,توليدي و صنعتي آبگينه‌,8,67085,338913420,5002,5052,5052,50,1.0,5005,3,0.06,5052,5052,1399-10-2
758,زعف0008پ15,زعفران0008پوشالمعمول طلاسرخ(پ),8,625,56455811,85466,89999,88000,2534,2.96,90329,4863,5.69,87000,91335,1399-10-2
759,غنيلي,مجتمع توليدي نيلي صنعت كرمان,8,110000,1870000000,16983,17000,17000,17,0.1,17000,17,0.1,17000,17000,1399-10-2
760,ضصاد1107,اختيارخ وبصادر-7000-1399/11/12,8,500,8110000,16,12,17,1,6.25,16,0,0.0,12,18,1399-10-2
761,اخزا810,اسنادخزانه-م10بودجه98-001006,8,14353,12026616439,836843,838100,837000,157,0.02,837917,1074,0.13,834824,838999,1399-10-2
762,كرونا2,تامين مالي جمعي صرفا اهداي سود,8,436,4360000,10000,10000,10000,0,0.0,10000,0,0.0,10000,10000,1399-10-2
763,پست0008پ09,پسته بادامي30-28مه ولات0008(پ),8,322,425089950,1365829,1330000,1320000,-45829,-3.36,1320155,-45674,-3.34,1315000,1330000,1399-10-2
764,وسقم,شركت س استان قم,7,52142,69870280,1410,1340,1340,-70,-4.96,1410,0,0.0,1340,1340,1399-10-2
765,وسيزد,شركت س استان يزد,7,126650,154513000,1280,1220,1220,-60,-4.69,1280,0,0.0,1220,1220,1399-10-2
766,ضسپا1100,اختيارخ خساپا-1600-1399/11/26,7,54,65077000,1117,1200,1276,159,14.23,1205,88,7.88,1200,1276,1399-10-2
767,ضپيك1023,اختيارخ تاپيكو-20000-99/10/16,7,50,5034000,96,100,100,4,4.17,101,5,5.21,100,101,1399-10-2
768,ضفلا1154,اختيارخ فولاد-12000-1399/11/28,7,30,104167000,3594,3999,3450,-144,-4.01,3472,-122,-3.39,3320,3999,1399-10-2
769,وسخراج,شركت س استان خراسان جنوبي,7,36035,76033850,2220,2110,2110,-110,-4.95,2220,0,0.0,2110,2110,1399-10-2
770,ضشنا1044,اختيارخ شپنا-10000-1399/10/23,7,99,463500000,4717,4700,4700,-17,-0.36,4682,-35,-0.74,4400,4700,1399-10-2
771,اخزا901,اسنادخزانه-م1بودجه99-010621,7,5626,4095083376,730495,727406,727600,-2895,-0.4,727885,-2610,-0.36,727400,732000,1399-10-2
772,وساربيل,شركت س استان اردبيل,6,34152,41665440,1280,1220,1220,-60,-4.69,1280,0,0.0,1220,1220,1399-10-2
773,اراد62,مرابحه عام دولت62-ش.خ0309,6,150000,150000000000,1000000,1000000,1000000,0,0.0,1000000,0,0.0,1000000,1000000,1399-10-2
774,پست0008پ08,پسته فندقي32-30مه ولات0008(پ),6,418,623916529,1461963,1400001,1495000,33037,2.26,1492623,30660,2.1,1400001,1516499,1399-10-2
775,صايپا112,صكوك مرابحه سايپا112-3ماهه 16%,6,48492,48525250000,980000,980000,1000725,20725,2.11,1000686,20686,2.11,980000,1000725,1399-10-2
776,اخزا807,اسنادخزانه-م7بودجه98-000719,6,3357,2911094276,866350,867000,867800,1450,0.17,867171,821,0.09,866773,867800,1399-10-2
777,هبركت912,اختيارف ت بركت-22100-99/12/17,6,112000,112000,1,1,1,0,0.0,1,0,0.0,1,1,1399-10-2
778,ضچاد1013,اختيارخ كچاد-12000-1399/10/02,6,29,232562000,8375,8003,8250,-125,-1.49,8019,-356,-4.25,8000,8250,1399-10-2
779,ضسپا1105,اختيارخ خساپا-3500-1399/11/26,6,37,10280000,259,230,290,31,11.97,278,19,7.34,230,299,1399-10-2
780,غگز,گز سكه,6,290000,6960000000,25500,24000,24000,-1500,-5.88,24000,-1500,-5.88,24000,24000,1399-10-2
781,اخزا713,اسنادخزانه-م13بودجه97-000518,5,1377,1234396293,895001,893831,899800,4799,0.54,896439,1438,0.16,893831,899800,1399-10-2
782,ضپنا1023,اختيارخ رمپنا-21506-1399/10/09,5,27,27072680,900,800,711,-189,-21.0,677,-223,-24.78,500,800,1399-10-2
783,ضچاد1012,اختيارخ كچاد-10000-1399/10/02,5,10,93842000,10287,8800,10400,113,1.1,9384,-903,-8.78,8800,10400,1399-10-2
784,ضجار1011,اختيارخ وتجارت-1800-1399/10/21,5,10,16790000,1705,1690,1700,-5,-0.29,1679,-26,-1.52,1600,1700,1399-10-2
785,زعف0008پ12,زعفران0008پوشالمعمول سحرخيز(پ),5,894,79532200,88500,89000,88800,300,0.34,88962,462,0.52,88800,89000,1399-10-2
786,ضپيك1019,اختيارخ تاپيكو-12000-99/10/16,5,60,179500000,2969,3000,3000,31,1.04,2992,23,0.77,2900,3050,1399-10-2
787,ضفار1120,اختيارخ فارس-8826-1399/11/07,5,19,227300000,5033,6950,4850,-183,-3.64,5982,949,18.86,4850,6950,1399-10-2
788,ياقوت2,صندوق س ياقوت آگاه-ثابت,5,33340500,33340500,11631,1,1,-11630,-99.99,1,-11630,-99.99,1,1,1399-10-2
789,پست0008پ04,پسته فندقي32-30سبزدانه0008(پ),5,540,750600740,1482587,1390003,1390001,-92586,-6.24,1390001,-92586,-6.24,1390001,1390003,1399-10-2
790,اخزا804,اسنادخزانه-م4بودجه98-000421,5,3549,3218950098,906326,907002,907002,676,0.07,907002,676,0.07,907002,907002,1399-10-2
791,ضپيك1020,اختيارخ تاپيكو-14000-99/10/16,4,5,7500000,1284,1500,1500,216,16.82,1500,216,16.82,1500,1500,1399-10-2
792,ضملت1127,اختيارخ وبملت-5000-1399/11/28,4,14,10600000,701,700,900,199,28.39,757,56,7.99,700,900,1399-10-2
793,صمعاد412,صكوك اجاره معادن412-6ماهه21%,4,30610,30000861000,980100,980100,980100,0,0.0,980100,0,0.0,980100,980100,1399-10-2
794,وسگلستا,شركت س استان گلستان,4,21992,25950560,1240,1180,1180,-60,-4.84,1240,0,0.0,1180,1180,1399-10-2
795,ضپنا1022,اختيارخ رمپنا-18806-1399/10/09,4,23,66676101,1687,1957,1958,271,16.06,1957,270,16.0,1957,1958,1399-10-2
796,زير0003پ04,زيره سبز0003شركت مينوبذر(پ),4,111,51360000,459548,463000,460000,452,0.1,462703,3155,0.69,460000,463000,1399-10-2
797,ضملت1123,اختيارخ وبملت-3000-1399/11/28,4,182,408820000,2245,2200,2400,155,6.9,2246,1,0.04,1801,2400,1399-10-2
798,ضجار2007,اختيارخ وتجارت-5000-1400/02/22,4,22,30408000,1,1000,1000,999,99900.0,1382,1381,138100.0,1000,1422,1399-10-2
799,ضپاس1000,اختيارخ وپارس-2000-1399/10/30,4,101,238250000,2228,2250,2360,132,5.92,2359,131,5.88,2250,2360,1399-10-2
800,ضسپا1101,اختيارخ خساپا-1800-1399/11/26,3,90,92754000,900,1000,1000,100,11.11,1031,131,14.56,1000,1081,1399-10-2
801,اخزا718,اسنادخزانه-م18بودجه97-000525,3,1863,1659899810,890353,890790,893000,2647,0.3,890982,629,0.07,890790,893001,1399-10-2
802,ساذري,آذريت‌,3,599,3586213,5813,5987,5987,174,2.99,5813,0,0.0,5987,5987,1399-10-2
803,افران2,صندوق س افرا نماد پايدار-ثابت,3,300000,300000,12316,1,1,-12315,-99.99,1,-12315,-99.99,1,1,1399-10-2
804,اراد60,مرابحه عام دولتي6-ش.خ0210,3,191000,176503100000,923900,924100,924100,200,0.02,924100,200,0.02,924100,924100,1399-10-2
805,وسيلام,شركت س استان ايلام,3,19301,22775180,1240,1180,1180,-60,-4.84,1240,0,0.0,1180,1180,1399-10-2
806,ضپنا1021,اختيارخ رمپنا-16106-1399/10/09,3,10,57907100,4000,4000,3900,-100,-2.5,3910,-90,-2.25,3900,4000,1399-10-2
807,ضملت1129,اختيارخ وبملت-7000-1399/11/28,3,33,7496000,232,201,284,52,22.41,227,-5,-2.16,201,284,1399-10-2
808,ضملي1153,اختيارخ فملي-20280-1399/11/05,3,60,34529720,364,300,300,-64,-17.58,292,-72,-19.78,251,300,1399-10-2
809,شستا992,اجاره تامين اجتماعي-سپهر991226,3,36,35704226,1004999,991221,992001,-12998,-1.29,991784,-13215,-1.31,991221,992001,1399-10-2
810,اشاد10,مشاركت دولتي10-شرايط خاص001226,3,25000,23750000000,950000,950000,950000,0,0.0,950000,0,0.0,950000,950000,1399-10-2
811,هاباد912,اختيارف ت آبادا-30100-99/12/12,3,211,2249260,10331,10660,10660,329,3.18,10660,329,3.18,10660,10660,1399-10-2
812,ضخود2011,اختيارخ خودرو-5000-1400/02/08,3,5,3270000,335,770,400,65,19.4,654,319,95.22,400,770,1399-10-2
813,ضفلا1157,اختيارخ فولاد-18000-1399/11/28,3,30,15550000,502,500,550,48,9.56,518,16,3.19,500,550,1399-10-2
814,تبريز112,مشاركت شهرداري تبريز-3ماهه18%,2,10,9650000,965000,965000,965000,0,0.0,965000,0,0.0,965000,965000,1399-10-2
815,ضبدر1158,اختيارخ شبندر-24000-1399/11/19,2,52,210000000,14900,4000,5000,-9900,-66.44,4038,-10862,-72.9,4000,5000,1399-10-2
816,اخزا805,اسنادخزانه-م5بودجه98-000422,2,1596,1445822596,909018,905691,906001,-3017,-0.33,905904,-3114,-0.34,905691,906001,1399-10-2
817,ضملي1150,اختيارخ فملي-14196-1399/11/05,2,40,236640000,3000,3000,3000,0,0.0,3000,0,0.0,3000,3000,1399-10-2
818,اراد584,مرابحه عام دولت5-ش.خ 0110,2,7301384,6886300319600,1000000,943150,943150,-56850,-5.69,943150,-56850,-5.69,943150,943150,1399-10-2
819,ضصاد1109,اختيارخ وبصادر-2000-1399/11/12,2,2,2600000,1,1300,1300,1299,129900.0,1300,1299,129900.0,1300,1300,1399-10-2
820,اراد55,مرابحه عام دولت5-ش.خ 0209,2,300000,277605000000,925720,925350,925350,-370,-0.04,925350,-370,-0.04,925350,925350,1399-10-2
821,ضغدر1118,اختيارخ وغدير-9000-1399/11/26,2,7,32900000,3649,4700,4700,1051,28.8,4700,1051,28.8,4700,4700,1399-10-2
822,اراد554,مرابحه عام دولت5-ش.خ 0209,2,4080019,3775445581650,925720,925350,925350,-370,-0.04,925350,-370,-0.04,925350,925350,1399-10-2
823,ضپيك2008,اختيارخ تاپيكو-9000-00/02/19,2,10,80000000,1,8000,8000,7999,799900.0,8000,7999,799900.0,8000,8000,1399-10-2
824,وسمركز,شركت س استان مركزي,2,10169,13524770,1400,1330,1330,-70,-5.0,1400,0,0.0,1330,1330,1399-10-2
825,اخزا716,اسنادخزانه-م16بودجه97-000407,2,880,805244000,915050,915050,915050,0,0.0,915050,0,0.0,915050,915050,1399-10-2
826,ضخود2006,اختيارخ خودرو-2500-1400/02/08,2,4,5920000,1409,1450,1570,161,11.43,1480,71,5.04,1450,1570,1399-10-2
827,ضخود2010,اختيارخ خودرو-4500-1400/02/08,2,5,3670000,480,780,550,70,14.58,734,254,52.92,550,780,1399-10-2
828,ضپاس1004,اختيارخ وپارس-4000-1399/10/30,2,100,60000000,528,600,600,72,13.64,600,72,13.64,600,600,1399-10-2
829,صخود412,ص مرابحه خودرو412- 3ماهه 18%,2,8,7919992,990000,989999,989999,-1,0.0,989999,-1,0.0,989999,989999,1399-10-2
830,صمسكن912,ص دين مسكن جنوب-ماهانه16درصد,2,110,5707350,54615,51885,51885,-2730,-5.0,51885,-2730,-5.0,51885,51885,1399-10-2
831,ضگل1142,اختيارخ كگل-16000-1399/11/21,2,10,35000000,4198,3500,3500,-698,-16.63,3500,-698,-16.63,3500,3500,1399-10-2
832,تملي708,تسهيلات مسكن ب. ملي-آبان97,2,19,11651598,645517,613242,613242,-32275,-5.0,613242,-32275,-5.0,613242,613242,1399-10-2
833,بتك,كارخانجات كابل سازي‌ تك‌,2,846,29192922,33831,34507,34507,676,2.0,33833,2,0.01,34507,34507,1399-10-2
834,ضمخا7066,اختيارخ اخابر-12000-1400/07/28,2,29,119900000,6000,4100,4300,-1700,-28.33,4134,-1866,-31.1,4100,4300,1399-10-2
835,ضبدر1149,اختيارخ شبندر-28000-1399/11/19,2,101,474482000,4000,4482,4700,700,17.5,4698,698,17.45,4482,4700,1399-10-2
836,اطلس2,صندوق س.توسعه اندوخته آينده-س,2,20000,20000,214365,1,1,-214364,-100.0,1,-214364,-100.0,1,1,1399-10-2
837,ضفار1121,اختيارخ فارس-9826-1399/11/07,2,13,120800000,4020,4800,4300,280,6.97,4646,626,15.57,4300,4800,1399-10-2
838,ضفار1122,اختيارخ فارس-11826-1399/11/07,1,53,296800000,2382,2800,2800,418,17.55,2800,418,17.55,2800,2800,1399-10-2
839,تملي705,تسهيلات مسكن ب. ملي-مرداد97,1,6,5183064,909309,863844,863844,-45465,-5.0,863844,-45465,-5.0,863844,863844,1399-10-2
840,ضمخا7069,اختيارخ اخابر-18000-1400/07/28,1,3,13500000,5000,4500,4500,-500,-10.0,4500,-500,-10.0,4500,4500,1399-10-2
841,ضپار1118,اختيارخ خپارس-8000-1399/11/19,1,1,310000,1000,310,310,-690,-69.0,310,-690,-69.0,310,310,1399-10-2
842,شجم2,صنايع پتروشيمي تخت جمشيد,1,10000000,112000000000,11196,11200,11200,4,0.04,11200,4,0.04,11200,11200,1399-10-2
843,كرمان02,مرابحه كرمان موتور14020306,1,6,6000000,1000000,1000000,1000000,0,0.0,1000000,0,0.0,1000000,1000000,1399-10-2
844,هصيكو402,اختيارف ت تاصيكو13500-00/02/20,1,5000,6735000,1735,1347,1347,-388,-22.36,1347,-388,-22.36,1347,1347,1399-10-2
845,تملي807,تسهيلات مسكن ب. ملي-مهر98,1,7,5804960,872926,829280,829280,-43646,-5.0,829280,-43646,-5.0,829280,829280,1399-10-2
846,صگل3092,صكوك اجاره گل گهر309-3ماهه20%,1,1205000,1259225000000,1020000,1045000,1045000,25000,2.45,1045000,25000,2.45,1045000,1045000,1399-10-2
847,ضمخا7068,اختيارخ اخابر-16000-1400/07/28,1,2,400000,4240,200,200,-4040,-95.28,200,-4040,-95.28,200,200,1399-10-2
848,ضخوز1014,اختيارخ فخوز-12191-1399/10/16,1,24,220500000,4356,3500,3500,-856,-19.65,3500,-856,-19.65,3500,3500,1399-10-2
849,ضمخا7067,اختيارخ اخابر-14000-1400/07/28,1,1,3500000,7700,3500,3500,-4200,-54.55,3500,-4200,-54.55,3500,3500,1399-10-2
850,ثنور2,سرمايه گذاري كوه نور,1,8000000,76984000000,9343,9623,9623,280,3.0,9623,280,3.0,9623,9623,1399-10-2
851,اراد624,مرابحه عام دولت62-ش.خ0309,1,1000000,1000000000000,1000000,1000000,1000000,0,0.0,1000000,0,0.0,1000000,1000000,1399-10-2
852,غيوان,كيوان,1,100,1564000,15334,15640,15640,306,2.0,15334,0,0.0,15640,15640,1399-10-2
853,ضپنا2009,اختيارخ رمپنا-36000-1400/02/12,1,1,1111000,1,1111,1111,1110,111000.0,1111,1110,111000.0,1111,1111,1399-10-2
854,كمند2,صندوق س. با درآمد ثابت كمند,1,60000000,60000000,10089,1,1,-10088,-99.99,1,-10088,-99.99,1,1,1399-10-2
855,قچار4,فراوردههاي غذايي وقند چهارمحال,1,1700000,117036500000,72468,68845,68845,-3623,-5.0,68845,-3623,-5.0,68845,68845,1399-10-2
856,ضفار1126,اختيارخ فارس-19826-1399/11/07,1,80,4960000,200,31,31,-169,-84.5,31,-169,-84.5,31,31,1399-10-2
857,ضغدر1120,اختيارخ وغدير-12000-1399/11/26,1,7,16100000,2494,2300,2300,-194,-7.78,2300,-194,-7.78,2300,2300,1399-10-2
858,تملي701,تسهيلات مسكن ب. ملي-فروردين97,1,6,5124066,898958,854011,854011,-44947,-5.0,854011,-44947,-5.0,854011,854011,1399-10-2
859,ضبدر1160,اختيارخ شبندر-18000-1399/11/19,1,1,12500000,11967,12500,12500,533,4.45,12500,533,4.45,12500,12500,1399-10-2
860,ضبدر1159,اختيارخ شبندر-16000-1399/11/19,1,1,15100000,15232,15100,15100,-132,-0.87,15100,-132,-0.87,15100,15100,1399-10-2
861,گواهي ظرفيت,گواهي ظرفيت نقدي,1,3500000,37236500000,10639,10639,10639,0,0.0,10639,0,0.0,10639,10639,1399-10-2
862,ضمخا1024,اختيارخ اخابر-14000-1399/10/30,1,100,230000000,2000,2300,2300,300,15.0,2300,300,15.0,2300,2300,1399-10-2
863,پارسان2,گسترش نفت و گاز پارسيان,1,3700000,88023000000,23790,23790,23790,0,0.0,23790,0,0.0,23790,23790,1399-10-2
864,وبصادر2,بانك صادرات ايران,1,48800000,148352000000,3040,3040,3040,0,0.0,3040,0,0.0,3040,3040,1399-10-2
865,ضملت1125,اختيارخ وبملت-4000-1399/11/28,1,70,91000000,1381,1300,1300,-81,-5.87,1300,-81,-5.87,1300,1300,1399-10-2
866,سجام2,مجتمع سيمان غرب آسيا,1,19991239,264504083209,13150,13231,13231,81,0.62,13231,81,0.62,13231,13231,1399-10-2
867,اجاد21,اجاره دولتي آپرورش-تمدن991118,1,500,504750500,1028501,1009501,1009501,-19000,-1.85,1009501,-19000,-1.85,1009501,1009501,1399-10-2
868,آسام2,صندوق س.آرمان سپهر آشنا-م,1,100000,100000,109491,1,1,-109490,-100.0,1,-109490,-100.0,1,1,1399-10-2
869,اراد604,مرابحه عام دولتي6-ش.خ0210,1,750000,693075000000,923900,924100,924100,200,0.02,924100,200,0.02,924100,924100,1399-10-2
870,پست0008پ02,پسته فندقي32-30طلاسبززرند0008,1,15,20850045,1517526,1390003,1390003,-127523,-8.4,1390003,-127523,-8.4,1390003,1390003,1399-10-2
871,حريل4,ريل پردازسير,1,3000000,16371000000,5307,5457,5457,150,2.83,5457,150,2.83,5457,5457,1399-10-2
872,ضشنا1045,اختيارخ شپنا-12000-1399/10/23,1,10,34400000,2651,3440,3440,789,29.76,3440,789,29.76,3440,3440,1399-10-2
873,زير0003پ02,زيره سبز0003 دانش(پ),1,10,4500000,458001,450000,450000,-8001,-1.75,450000,-8001,-1.75,450000,450000,1399-10-2
874,ضمخا1033,اختيارخ اخابر-10000-1399/10/30,1,1,5700000,5800,5700,5700,-100,-1.72,5700,-100,-1.72,5700,5700,1399-10-2
875,سپرمي,پرميت‌,1,1000,8440000,8357,8440,8440,83,0.99,8357,0,0.0,8440,8440,1399-10-2
876,اخزا9062,اسنادخزانه-م6بودجه99-020321,1,482000,299804000000,632960,622000,622000,-10960,-1.73,622000,-10960,-1.73,622000,622000,1399-10-2
877,ضپار1117,اختيارخ خپارس-7000-1399/11/19,1,20,40000000,1653,2000,2000,347,20.99,2000,347,20.99,2000,2000,1399-10-2
878,زير0003پ01,زيره سبز0003كيميابذر(پ),1,10,4700000,499990,470000,470000,-29990,-6.0,470000,-29990,-6.0,470000,470000,1399-10-2
879,اشاد102,مشاركت دولتي10-شرايط خاص001226,1,31,27993000,950000,903000,903000,-47000,-4.95,903000,-47000,-4.95,903000,903000,1399-10-2
880,سلامت4,مرابحه دولتي تعاون-لوتوس991118,1,13000,13039000000,1005000,1003000,1003000,-2000,-0.2,1003000,-2000,-0.2,1003000,1003000,1399-10-2
881,اشاد104,مشاركت دولتي10-شرايط خاص001226,1,100000,93500000000,950000,935000,935000,-15000,-1.58,935000,-15000,-1.58,935000,935000,1399-10-2
882,ضپيك1021,اختيارخ تاپيكو-16000-99/10/16,1,2,1200000,300,600,600,300,100.0,600,300,100.0,600,600,1399-10-2
883,بركت4,گروه دارويي بركت,1,12100000,326942000000,25740,27020,27020,1280,4.97,27020,1280,4.97,27020,27020,1399-10-2
884,پا ر 3,بار پايه روز 3,1,500,192500,718,385,385,-333,-46.38,385,-333,-46.38,385,385,1399-10-2
885,ضخوز1015,اختيارخ فخوز-13715-1399/10/16,1,1,8662500,3623,3300,3300,-323,-8.92,3300,-323,-8.92,3300,3300,1399-10-2
886,ضفار1123,اختيارخ فارس-13826-1399/11/07,1,25,50000000,1500,1000,1000,-500,-33.33,1000,-500,-33.33,1000,1000,1399-10-2
887,شستا993,اجاره ت.اجتماعي-كاردان991226,1,5,4950055,1000000,990011,990011,-9989,-1.0,990011,-9989,-1.0,990011,990011,1399-10-2
888,فماك,ماداكتو استيل كرد,1,38000,912000000,25837,24000,24000,-1837,-7.11,24000,-1837,-7.11,24000,24000,1399-10-2
889,اراد50,مرابحه عام دولت5-ش.خ0302,1,15000,15000000000,1000000,1000000,1000000,0,0.0,1000000,0,0.0,1000000,1000000,1399-10-2
890,ضجار1013,اختيارخ وتجارت-2500-1399/10/21,1,1,1000000,1603,1000,1000,-603,-37.62,1000,-603,-37.62,1000,1000,1399-10-2
