,نماد,نام,تعداد,حجم,ارزش,دیروز,اولین,آخرین معامله - مقدار,آخرین معامله - تغییر,آخرین معامله - درصد,قیمت پایانی - مقدار,قیمت پایانی - تغییر,قیمت پایانی - درصد,کمترین,بیشترین,تاریخ
0,فولاد,فولاد مباركه اصفهان,100132,650651559,10573015247380,16830,17500,16700,-130,-0.77,16250,-580,-3.45,15990,17670,1399-6-3
1,فملي,ملي‌ صنايع‌ مس‌ ايران‌,86625,286958570,7958826399360,27060,28410,28410,1350,4.99,27740,680,2.51,26240,28410,1399-6-3
2,وتجارت,بانك تجارت,84911,3251044446,9260044085420,2960,2900,2980,20,0.68,2850,-110,-3.72,2820,2990,1399-6-3
3,شستا,سرمايه گذاري تامين اجتماعي,59076,383256564,15886906120470,43630,41450,41450,-2180,-5.0,41450,-2180,-5.0,41450,45810,1399-6-3
4,آبادا,توليد نيروي برق آبادان,52605,11455862,345623356800,31750,30170,30170,-1580,-4.98,30170,-1580,-4.98,30170,30180,1399-6-3
5,شبندر,پالايش نفت بندرعباس,47000,185680271,7125073892900,40040,41000,39900,-140,-0.35,38370,-1670,-4.17,38040,41870,1399-6-3
6,وبصادر,بانك صادرات ايران,45800,1968425645,6358063433250,3370,3420,3350,-20,-0.59,3230,-140,-4.15,3210,3430,1399-6-3
7,شپنا,پالايش نفت اصفهان,42486,352254175,11846869051930,35340,33800,33580,-1760,-4.98,33630,-1710,-4.84,33580,35000,1399-6-3
8,دارا يكم,صندوق واسطه گري مالي يكم-سهام,42232,8940162,1553104762500,177230,185000,177300,70,0.04,173720,-3510,-1.98,165200,185200,1399-6-3
9,صبا,سرمايه گذاري صبا تامين,24949,74252681,2200320389366,31036,31036,29900,-1136,-3.66,29633,-1403,-4.52,29485,32490,1399-6-3
10,وغدير,سرمايه‌گذاري‌غدير(هلدينگ‌,24160,322187658,5171382092000,16880,16210,16080,-800,-4.74,16050,-830,-4.92,16040,16800,1399-6-3
11,امين,تامين سرمايه امين,19947,3115816,42094674160,12870,13510,13510,640,4.97,13350,480,3.73,13510,13510,1399-6-3
12,شتران,پالايش نفت تهران,19153,127166135,4228382394930,34960,33220,33220,-1740,-4.98,33250,-1710,-4.89,33220,34700,1399-6-3
13,ثبهساز,بهساز كاشانه تهران,15328,19716959,58165029050,2810,2950,2950,140,4.98,2950,140,4.98,2950,2950,1399-6-3
14,فارس,صنايع پتروشيمي خليج فارس,14335,120080601,3016065123190,26320,25500,25010,-1310,-4.98,25120,-1200,-4.56,25010,27120,1399-6-3
15,فخوز,فولاد  خوزستان,13464,63378978,2504132816320,39610,41390,41590,1980,5.0,39510,-100,-0.25,37630,41590,1399-6-3
16,گدنا,تهيه توزيع غذاي دنا آفرين فدك,12516,146749,932883393,6055,6357,6357,302,4.99,6060,5,0.08,6357,6357,1399-6-3
17,ولپارس,ليزينگ پارسيان,12405,2704502,10060747440,3550,3720,3720,170,4.79,3580,30,0.85,3720,3720,1399-6-3
18,زملارد,كشاورزي و دامپروري ملارد شير,11763,2324522,55202748456,22618,23748,23748,1130,5.0,23748,1130,5.0,23748,23748,1399-6-3
19,بگيلان,توسعه مسير برق گيلان,10994,543932,16003023372,28020,29421,29421,1401,5.0,28438,418,1.49,29421,29421,1399-6-3
20,تاپيكو,س. نفت و گاز و پتروشيمي تأمين,10942,126189371,2293217173360,19060,18520,18130,-930,-4.88,18170,-890,-4.67,18110,19160,1399-6-3
21,ومعادن,توسعه‌معادن‌وفلزات‌,10013,138335027,2096795068850,15770,15310,15900,130,0.82,15160,-610,-3.87,14990,16550,1399-6-3
22,وصنعت,سرمايه گذاري توسعه صنعت وتجارت,9303,110133380,1182024952550,11270,10710,10710,-560,-4.97,10730,-540,-4.79,10710,11100,1399-6-3
23,وبانك,سرمايه گذاري گروه توسعه ملي,8894,105430806,2138028871200,21240,21550,20180,-1060,-4.99,20280,-960,-4.52,20180,21970,1399-6-3
24,ذوب,سهامي ذوب آهن  اصفهان,8440,78314244,543135562279,7298,6934,6934,-364,-4.99,6935,-363,-4.97,6934,7020,1399-6-3
25,رافزا,رايان هم افزا,8409,49308,1380278844,26660,27993,27993,1333,5.0,26695,35,0.13,27993,27993,1399-6-3
26,فسپا,گروه‌صنعتي‌سپاهان‌,7202,21165534,1347265982800,60750,61700,63780,3030,4.99,63650,2900,4.77,61700,63780,1399-6-3
27,تملت,تامين سرمايه بانك ملت,6916,60956639,997949056320,17230,16370,16370,-860,-4.99,16370,-860,-4.99,16370,17100,1399-6-3
28,ونيكي,سرمايه‌گذاري‌ ملي‌ايران‌,6911,28542058,1208733400710,43590,44000,41420,-2170,-4.98,42350,-1240,-2.84,41420,45000,1399-6-3
29,بجهرم,توسعه مولد نيروگاهي جهرم,6515,62683857,341009293462,5726,5440,5440,-286,-4.99,5440,-286,-4.99,5440,5490,1399-6-3
30,وپاسار,بانك  پاسارگاد,5877,122335475,1253157617970,10770,10250,10250,-520,-4.83,10240,-530,-4.92,10240,10550,1399-6-3
31,پارسان,گسترش نفت و گاز پارسيان,5365,71234379,1875345332890,27650,27000,26700,-950,-3.44,26330,-1320,-4.77,26270,27700,1399-6-3
32,سيتا,سرمايه گذاري سيمان تامين,5363,4541497,126844011210,29390,27930,27930,-1460,-4.97,27930,-1460,-4.97,27930,27930,1399-6-3
33,كگل,معدني و صنعتي گل گهر,5215,36168585,626749722880,17710,17650,17910,200,1.13,17330,-380,-2.15,16830,18300,1399-6-3
34,كچاد,معدني‌وصنعتي‌چادرملو,5154,24855589,400370707580,16360,16780,16550,190,1.16,16110,-250,-1.53,15710,16780,1399-6-3
35,خساپا,سايپا,5130,42263804,144964847720,3610,3430,3430,-180,-4.99,3430,-180,-4.99,3430,3430,1399-6-3
36,پترول,گروه پتروشيمي س. ايرانيان,5066,33209910,442543213090,14020,13320,13320,-700,-4.99,13330,-690,-4.92,13320,13640,1399-6-3
37,خبهمن,گروه‌بهمن‌,5043,63247098,2396255812980,39690,38000,37710,-1980,-4.99,37890,-1800,-4.54,37710,39400,1399-6-3
38,خودرو,ايران‌ خودرو,4981,34993225,140672764500,4230,4020,4020,-210,-4.96,4020,-210,-4.96,4020,4020,1399-6-3
39,وسپه,سرمايه‌گذاري‌ سپه‌,4501,49925153,741813544390,15560,15000,15890,330,2.12,14860,-700,-4.5,14790,15900,1399-6-3
40,ماديرا,صنايع ماشين هاي اداري ايران,4327,9439090,475576930906,51367,51020,48799,-2568,-5.0,50384,-983,-1.91,48799,53930,1399-6-3
41,غگيلا,شيرپاستوريزه پگاه گيلان,4057,64604,1011246412,14908,15653,15653,745,5.0,14922,14,0.09,15653,15653,1399-6-3
42,اخابر,مخابرات ايران,4001,51235183,1217648723350,24970,23900,23730,-1240,-4.97,23770,-1200,-4.81,23730,24480,1399-6-3
43,امين يكم,صندوق درآمد ثابت امين يكم فردا,3976,137826138,1444945636620,10600,10610,10450,-150,-1.42,10480,-120,-1.13,10390,10630,1399-6-3
44,شبريز,پالايش نفت تبريز,3950,19809580,819294856810,43520,41350,41350,-2170,-4.99,41360,-2160,-4.96,41350,42990,1399-6-3
45,غشان,شيرپاستوريزه‌پگاه‌خراسان‌,3515,4451473,339819572200,76210,80020,72400,-3810,-5.0,76340,130,0.17,72400,80020,1399-6-3
46,پترولح,ح . گروه پتروشيمي س. ايرانيان,3343,20939254,227506581220,11910,11600,10740,-1170,-9.82,10870,-1040,-8.73,10720,11880,1399-6-3
47,كمند,صندوق س. با درآمد ثابت كمند,3259,148004061,1509788474270,10190,10200,10200,10,0.1,10200,10,0.1,10180,10250,1399-6-3
48,غاذر,كشت‌وصنعت‌پياذر,3237,5188257,335500867400,63330,61000,66490,3160,4.99,64670,1340,2.12,61000,66490,1399-6-3
49,كويرح,ح. توليدي فولاد سپيد فراب كوير,3221,15820946,176875998590,12160,12800,11250,-910,-7.48,11180,-980,-8.06,10940,12800,1399-6-3
50,نوري,پتروشيمي نوري,3202,5731025,791807131710,145210,140300,137950,-7260,-5.0,138160,-7050,-4.86,137950,149600,1399-6-3
51,كاوه,فولاد كاوه جنوب كيش,3091,25075490,403578048020,16710,16670,16800,90,0.54,16090,-620,-3.71,15880,17540,1399-6-3
52,قشرين,قند شيرين خراسان,3039,12730228,290058381212,22147,22255,22811,664,3.0,22785,638,2.88,22255,22811,1399-6-3
53,اعتماد,صندوق س.اعتماد آفرين پارسيان-د,3002,131270280,4204292185580,32014,32032,32015,1,0.0,32028,14,0.04,32015,32036,1399-6-3
54,وسكاب,س.ص.بازنشستگي كاركنان بانكها,2994,34990253,233755365500,6880,6850,6700,-180,-2.62,6680,-200,-2.91,6540,7220,1399-6-3
55,بترانس,ايران‌ ترانسفو,2992,12854349,631776778470,51690,49130,49110,-2580,-4.99,49150,-2540,-4.91,49110,51670,1399-6-3
56,وسبحان,سرمايه گذاري سبحان,2959,26947239,299633855654,10650,11182,11182,532,5.0,11119,469,4.4,10400,11182,1399-6-3
57,غسالم,سالمين‌,2950,14278039,100972383010,7440,7070,7070,-370,-4.97,7070,-370,-4.97,7070,7120,1399-6-3
58,بپاس,بيمه پاسارگاد,2864,7316499,610602211036,86499,82180,85000,-1499,-1.73,83456,-3043,-3.52,82175,86490,1399-6-3
59,شيران,س. صنايع‌شيميايي‌ايران,2863,10767197,406147581690,39450,39000,37480,-1970,-4.99,37720,-1730,-4.39,37480,39990,1399-6-3
60,ونوين,بانك‌اقتصادنوين‌,2774,69676859,346041760050,5150,5000,4900,-250,-4.85,4970,-180,-3.5,4900,5150,1399-6-3
61,البرز,بيمه البرز,2673,42314837,678234070190,16860,16020,16020,-840,-4.98,16030,-830,-4.92,16020,16400,1399-6-3
62,آگاس,صندوق س.هستي بخش آگاه-س,2653,2211306,610519709699,292696,284000,275000,-17696,-6.05,276090,-16606,-5.67,270000,301000,1399-6-3
63,چكارن,كارتن‌ ايران‌,2621,15742308,93856632570,6830,6180,5880,-950,-13.91,5960,-870,-12.74,5880,6180,1399-6-3
64,واميد,گروه مديريت سرمايه گذاري اميد,2569,16488939,625094864400,38420,38040,39850,1430,3.72,37910,-510,-1.33,36500,40300,1399-6-3
65,وهور,مديريت انرژي اميد  تابان هور,2568,13161919,517690548991,40733,39960,39210,-1523,-3.74,39332,-1401,-3.44,38697,42600,1399-6-3
66,حكشتيح,ح . كشتيراني ج. ا. ا,2354,5576534,238971276110,46560,46560,41900,-4660,-10.01,42850,-3710,-7.97,41900,48000,1399-6-3
67,ارزش,صندوق س ارزش آفرين بيدار-سهام,2283,11116059,114502809980,10300,10500,10340,40,0.39,10300,0,0.0,10170,10900,1399-6-3
68,آكورد,صندوق س. آرمان آتي كوثر-د,2220,11687445,332981224174,28465,28464,28487,22,0.08,28491,26,0.09,28464,28550,1399-6-3
69,تيپيكو,سرمايه گذاري دارويي تامين,2109,6186033,303417261890,51000,51200,50100,-900,-1.76,49050,-1950,-3.82,48450,52970,1399-6-3
70,گكوثر,هتل پارسيان كوثر اصفهان,2067,2030420,383679672807,188286,180010,197700,9414,5.0,188966,680,0.36,178872,197700,1399-6-3
71,اميد,تامين سرمايه اميد,2063,24352278,612703314480,26480,25160,25160,-1320,-4.98,25160,-1320,-4.98,25160,25160,1399-6-3
72,سرچشمه,سرمايه گذاري مس سرچشمه,2059,18519642,192157170926,10838,11110,10340,-498,-4.59,10376,-462,-4.26,10297,11190,1399-6-3
73,سباقر,سيمان باقران,2036,6386737,100386642423,15515,15980,15700,185,1.19,15718,203,1.31,15100,15980,1399-6-3
74,قرن,پديده شيمي قرن,2012,2294753,126648891850,57570,57000,54700,-2870,-4.99,55190,-2380,-4.13,54700,57730,1399-6-3
75,وتوسم,سرمايه‌گذاري‌توسعه‌ملي‌,1918,12815322,176265774840,14350,14020,13850,-500,-3.48,13750,-600,-4.18,13640,14880,1399-6-3
76,شصدف,صنعتي دوده فام,1906,64743,1207003749,17756,18643,18643,887,5.0,17776,20,0.11,18643,18643,1399-6-3
77,ولساپا,ليزينگ رايان‌ سايپا,1888,23765866,137741385450,6090,5790,5790,-300,-4.93,5800,-290,-4.76,5790,5980,1399-6-3
78,دماوند,توليد نيروي برق دماوند,1881,2377757,128719434760,56852,54010,54010,-2842,-5.0,54135,-2717,-4.78,54010,55900,1399-6-3
79,همراه,شركت ارتباطات سيار ايران,1792,18221562,975823851800,56360,53550,53550,-2810,-4.99,53550,-2810,-4.99,53550,54450,1399-6-3
80,وساخت,سرمايه‌ گذاري‌ ساختمان‌ايران‌,1767,8822829,456825243810,54340,53010,51630,-2710,-4.99,51780,-2560,-4.71,51630,54910,1399-6-3
81,وخارزم,سرمايه گذاري خوارزمي,1721,44132356,699497842600,16680,15850,15850,-830,-4.98,15850,-830,-4.98,15850,15850,1399-6-3
82,شاراك,پتروشيمي شازند,1708,9893878,211058947910,22380,22340,21300,-1080,-4.83,21330,-1050,-4.69,21270,22550,1399-6-3
83,رمپنا,گروه مپنا (سهامي عام),1696,15161982,580308799780,40280,38270,38270,-2010,-4.99,38270,-2010,-4.99,38270,38800,1399-6-3
84,خگستر,گسترش‌سرمايه‌گذاري‌ايران‌خودرو,1694,6621797,49133733740,7810,7420,7420,-390,-4.99,7630,-180,-2.3,7420,7420,1399-6-3
85,كحافظ,كاشي‌ وسراميك‌ حافظ‌,1693,6295350,89418801920,14700,14500,13970,-730,-4.97,14200,-500,-3.4,13970,15420,1399-6-3
86,شكلر,نيروكلر,1668,6031736,270545716700,46660,46700,44480,-2180,-4.67,44850,-1810,-3.88,44330,48850,1399-6-3
87,شغدير,پتروشيمي غدير,1658,8226945,350764284364,44880,42636,42637,-2243,-5.0,42636,-2244,-5.0,42636,43000,1399-6-3
88,وآيند,بانك  آينده,1648,68927377,2036045789203,30769,29539,29539,-1230,-4.0,29539,-1230,-4.0,29539,29539,1399-6-3
89,آريا,پليمر آريا ساسول,1648,365111,55567703534,160204,152194,152194,-8010,-5.0,155087,-5117,-3.19,152194,152194,1399-6-3
90,شگويا,پتروشيمي تندگويان,1647,5779979,107328430051,19546,18569,18569,-977,-5.0,18569,-977,-5.0,18569,18569,1399-6-3
91,رتاپ,تجارت الكترونيك  پارسيان,1566,9272058,128720010130,14610,13880,13880,-730,-5.0,13880,-730,-5.0,13880,14100,1399-6-3
92,پارس,پتروشيمي پارس,1560,1991343,261153420780,137070,130500,139460,2390,1.74,131140,-5930,-4.33,130220,143500,1399-6-3
93,حكشتي,كشتيراني جمهوري اسلامي ايران,1536,1254359,77745170820,65240,61980,61980,-3260,-5.0,62900,-2340,-3.59,61980,61980,1399-6-3
94,والبر,سرمايه‌ گذاري‌ البرز(هلدينگ‌,1480,9147557,191049842430,21970,20880,20880,-1090,-4.96,20890,-1080,-4.92,20880,21200,1399-6-3
95,كگهر,سنگ آهن گهرزمين,1362,4512139,191576209734,44080,42002,43000,-1080,-2.45,42458,-1622,-3.68,41876,46284,1399-6-3
96,وخاور,بانك خاورميانه,1350,13868132,140147026080,10630,10100,10110,-520,-4.89,10110,-520,-4.89,10100,10490,1399-6-3
97,وصندوق,سرمايه‌گذاري‌صندوق‌بازنشستگي‌,1332,12098497,219146056300,18990,18800,18050,-940,-4.95,18110,-880,-4.63,18050,18880,1399-6-3
98,وپست,پست بانك ايران,1316,27013956,417536117860,16260,15450,15450,-810,-4.98,15460,-800,-4.92,15450,15880,1399-6-3
99,ثاختح,ح . بين‌المللي‌توسعه‌ساختمان,1300,13759804,60654696530,4810,4500,4330,-480,-9.98,4410,-400,-8.32,4330,4780,1399-6-3
100,وبيمه,سرمايه‌ گذاري‌ صنعت‌ بيمه‌,1289,16007060,112322763020,7340,7150,6980,-360,-4.9,7020,-320,-4.36,6980,7500,1399-6-3
101,شپديس,پتروشيمي پرديس,1275,2952498,263718696000,90500,90000,92480,1980,2.19,89320,-1180,-1.3,86020,92490,1399-6-3
102,مبين,مبين انرژي خليج فارس,1267,6430524,148044723350,23800,23000,24270,470,1.97,23020,-780,-3.28,22610,24600,1399-6-3
103,ومهان,گروه توسعه مالي مهر آيندگان,1240,10720316,197944849806,19435,18464,18464,-971,-5.0,18464,-971,-5.0,18464,18646,1399-6-3
104,جم,پتروشيمي جم,1214,7125241,273221558620,40310,40400,39440,-870,-2.16,38350,-1960,-4.86,38300,40500,1399-6-3
105,حتايد,تايدواترخاورميانه,1204,5699756,145537038280,26270,26220,24960,-1310,-4.99,25530,-740,-2.82,24960,27300,1399-6-3
106,ولصنم,ليزينگ‌صنعت‌ومعدن‌,1194,17197698,213089267740,13010,13010,12360,-650,-5.0,12390,-620,-4.77,12360,13400,1399-6-3
107,ولانا,شركت ليزينگ آريا دانا,1192,4444897,113474686540,25000,24250,25750,750,3.0,25529,529,2.12,24250,25750,1399-6-3
108,بركت,گروه دارويي بركت,1191,3690722,99538772340,28380,26970,26970,-1410,-4.97,26970,-1410,-4.97,26970,26970,1399-6-3
109,لوتوس,تامين سرمايه لوتوس پارسيان,1186,7564328,122760617790,16430,15620,15610,-820,-4.99,16230,-200,-1.22,15610,17200,1399-6-3
110,تكشاح,ح . صنايع‌وخدمات‌كشاورزي‌,1181,2817877,126027565230,41670,43500,45840,4170,10.01,44720,3050,7.32,41060,45840,1399-6-3
111,جم پيلن,پلي پروپيلن جم - جم پيلن,1169,3563131,277213200450,80740,76760,81100,360,0.45,77800,-2940,-3.64,76710,84000,1399-6-3
112,حريل,ريل پردازسير,1169,9344711,50867854633,5675,5440,5392,-283,-4.99,5443,-232,-4.09,5392,5675,1399-6-3
113,كرمان,س. توسعه و عمران استان كرمان,1123,1016862,119219039345,122220,116200,116109,-6111,-5.0,117242,-4978,-4.07,116109,121900,1399-6-3
114,دي,بانك دي,1116,1032698,56443141888,57532,54656,54656,-2876,-5.0,55679,-1853,-3.22,54656,54656,1399-6-3
115,غپينو,پارس‌ مينو,1115,5032745,39406393350,8240,7830,7830,-410,-4.98,7870,-370,-4.49,7830,7830,1399-6-3
116,سرو,صندوق س سروسودمند مدبران-سهام,1099,1969803,121659948250,62890,61100,61030,-1860,-2.96,61760,-1130,-1.8,60210,64500,1399-6-3
117,كمنگنز,معادن‌منگنزايران‌,1088,2074653,213746681300,107930,102540,102540,-5390,-4.99,103030,-4900,-4.54,102540,108000,1399-6-3
118,وپترو,سرمايه‌گذاري صنايع پتروشيمي‌,1084,6622981,109543411900,17400,16530,16580,-820,-4.71,16540,-860,-4.94,16530,17050,1399-6-3
119,شاوان,پالايش نفت لاوان,1041,2785764,334141914000,125252,125000,119800,-5452,-4.35,119946,-5306,-4.24,118990,130500,1399-6-3
120,تنوين,تامين سرمايه نوين,1031,12204517,142263319320,12220,11800,11610,-610,-4.99,11660,-560,-4.58,11610,12210,1399-6-3
121,افقح,ح .فروشگاه زنجيره اي افق كوروش,995,1977785,106113212513,54797,55000,57000,2203,4.02,53653,-1144,-2.09,50900,57000,1399-6-3
122,رانفور,خدمات‌انفورماتيك‌,994,4010494,131593584160,34390,34390,32680,-1710,-4.97,32810,-1580,-4.59,32680,34390,1399-6-3
123,افق,فروشگاههاي زنجيره اي افق كوروش,988,1733283,115751656680,70290,66780,66780,-3510,-4.99,66780,-3510,-4.99,66780,67050,1399-6-3
124,مارون,پتروشيمي مارون,982,1401972,162738175022,121731,121000,116999,-4732,-3.89,116078,-5653,-4.64,115645,124800,1399-6-3
125,وشمال,س. چشم انداز توسعه شمال,975,726083,75281975276,105874,108500,102698,-3176,-3.0,103682,-2192,-2.07,102698,108500,1399-6-3
126,فجر,فولاد اميركبيركاشان,966,2547954,125895956170,51590,49210,50200,-1390,-2.69,49410,-2180,-4.23,49020,51260,1399-6-3
127,ودي,بيمه  دي,966,7161805,189450661439,27473,26100,26100,-1373,-5.0,26453,-1020,-3.71,26100,28500,1399-6-3
128,كروي,توسعه‌ معادن‌ روي‌ ايران‌,953,6214587,275119766490,46590,44270,44270,-2320,-4.98,44270,-2320,-4.98,44270,44270,1399-6-3
129,تاپكيش,تجارت الكترونيك پارسيان كيش,946,1612893,66534241937,42311,42900,40196,-2115,-5.0,41251,-1060,-2.51,40196,43500,1399-6-3
130,هرمز,فولاد هرمزگان جنوب,939,6022967,69155734288,12079,11476,11476,-603,-4.99,11692,-387,-3.2,11476,11764,1399-6-3
131,وگستر,گسترش سرمايه گذاري ايرانيان,934,3217277,94010028363,30649,29117,29117,-1532,-5.0,29220,-1429,-4.66,29117,31000,1399-6-3
132,كاريس,صندوق س.سپهر كاريزما-س,933,1180680,239816387397,214009,210000,201490,-12519,-5.85,203117,-10892,-5.09,198101,215500,1399-6-3
133,فولاژ,فولاد آلياژي ايران,919,3334737,84573909270,26600,25300,26000,-600,-2.26,25360,-1240,-4.66,25270,27000,1399-6-3
134,كسرام,پارس‌ سرام‌,914,417811,52873982050,133210,126550,126550,-6660,-5.0,126550,-6660,-5.0,126550,126550,1399-6-3
135,تسه9904,امتياز تسهيلات مسكن تير99,911,13867,11081549577,761078,799131,799131,38053,5.0,799131,38053,5.0,799131,799131,1399-6-3
136,اطلس,صندوق س.توسعه اندوخته آينده-س,903,480652,88451619770,192667,191000,184990,-7677,-3.98,184024,-8643,-4.49,178010,193000,1399-6-3
137,شخارك,پتروشيمي‌ خارك‌,899,5381703,207102266530,40440,40000,38420,-2020,-5.0,38480,-1960,-4.85,38420,40100,1399-6-3
138,گوهران,سرمايه گذاري توسعه گوهران اميد,897,6224499,60999595164,10267,9754,9754,-513,-5.0,9800,-467,-4.55,9754,10300,1399-6-3
139,ختورح,ح . رادياتور ايران‌,885,1784586,47227495760,28710,28000,25840,-2870,-10.0,26460,-2250,-7.84,25840,30300,1399-6-3
140,وجامي,سرمايه گذاري جامي,882,7090729,72414809341,10286,9980,10594,308,2.99,10213,-73,-0.71,9978,10594,1399-6-3
141,كاردان,صندوق س تجارت شاخصي كاردان,869,1674766,325019012730,185430,180000,195000,9570,5.16,194070,8640,4.66,167100,198410,1399-6-3
142,ختوقا,قطعات‌ اتومبيل‌ ايران‌,854,5708652,31283412960,5760,5480,5480,-280,-4.86,5560,-200,-3.47,5480,5480,1399-6-3
143,خپارس,پارس‌ خودرو,843,2250689,27368378240,12790,12160,12160,-630,-4.93,12630,-160,-1.25,12160,12160,1399-6-3
144,زاگرس,پتروشيمي زاگرس,835,1382528,190974550993,144262,140650,137049,-7213,-5.0,138134,-6128,-4.25,137049,144000,1399-6-3
145,غگل,گلوكوزان‌,800,3083449,29046089580,9910,9420,9420,-490,-4.94,9590,-320,-3.23,9420,9420,1399-6-3
146,ستران,سيمان‌ تهران‌,795,1208995,62303674130,54150,51500,51450,-2700,-4.99,51530,-2620,-4.84,51450,53500,1399-6-3
147,بورس,بورس اوراق بهادار تهران,787,1198414,116084529160,101870,96780,96780,-5090,-5.0,96870,-5000,-4.91,96780,98710,1399-6-3
148,فخاسح,ح . فولاد خراسان,786,1017914,28314674650,28900,28510,28200,-700,-2.42,27820,-1080,-3.74,27000,31000,1399-6-3
149,ولملت,واسپاري ملت,782,5346654,72501305030,12940,13580,13580,640,4.95,13560,620,4.79,13070,13580,1399-6-3
150,دفارا,داروسازي‌ فارابي‌,758,703137,47249099450,70190,71000,66690,-3500,-4.99,67200,-2990,-4.26,66690,72840,1399-6-3
151,پكرمان,گروه‌ صنعتي‌ بارز,749,4714536,105043237900,23380,23010,22220,-1160,-4.96,22280,-1100,-4.7,22220,23290,1399-6-3
152,شرانل,نفت ايرانول,736,3922946,114500625940,30720,29184,29184,-1536,-5.0,29187,-1533,-4.99,29184,30718,1399-6-3
153,ملت,بيمه ملت,733,5912072,94670060370,16850,16010,16010,-840,-4.99,16010,-840,-4.99,16010,16220,1399-6-3
154,ثاخت,بين‌المللي‌توسعه‌ساختمان,701,2731390,16907304100,6510,6190,6190,-320,-4.92,6390,-120,-1.84,6190,6190,1399-6-3
155,شلرد,كود شيميايي اوره لردگان,696,5783887,80731494746,14692,13958,13958,-734,-5.0,13958,-734,-5.0,13958,13958,1399-6-3
156,وپويا,سرمايه گذاري پويا,694,1121986,16356311908,15345,14578,14578,-767,-5.0,15065,-280,-1.82,14578,14578,1399-6-3
157,كلر,كلر پارس,687,532836,43600522329,85480,81385,81206,-4274,-5.0,81897,-3583,-4.19,81206,85400,1399-6-3
158,شفن,پتروشيمي فناوران,679,605078,158388045520,275110,261600,261360,-13750,-5.0,261760,-13350,-4.85,261360,275110,1399-6-3
159,فاما,صنعتي‌ آما,666,1913848,40153499350,22070,20980,20970,-1100,-4.98,21060,-1010,-4.58,20970,21970,1399-6-3
160,آتيمس,صندوق س.آرمان آتيه درخشان مس-س,663,284141,68334467670,248572,248010,234550,-14022,-5.64,240495,-8077,-3.25,230000,252500,1399-6-3
161,پارند,صندوق س. پارند پايدار سپهر,663,24386132,286060758590,11670,11720,11730,60,0.51,11730,60,0.51,11660,11770,1399-6-3
162,شپاس,نفت پاسارگاد,651,4900150,137499045406,29535,28059,28061,-1474,-4.99,28060,-1475,-4.99,28059,28500,1399-6-3
163,خراسان,پتروشيمي خراسان,650,1844708,138274828150,78360,75230,74500,-3860,-4.93,74960,-3400,-4.34,74450,78800,1399-6-3
164,كاما,باما,636,186002,39562625400,223890,212700,212700,-11190,-5.0,218690,-5200,-2.32,212700,212700,1399-6-3
165,ولغدر,ليزينگ‌خودروغدير,629,3935613,75128353920,19760,18880,18780,-980,-4.96,19090,-670,-3.39,18780,20340,1399-6-3
166,شنفت,نفت‌ پارس‌,613,1976551,144259473870,76820,72980,72980,-3840,-5.0,72990,-3830,-4.99,72980,73510,1399-6-3
167,شيراز,پتروشيمي‌شيراز,610,2270568,119790895410,55470,52760,52700,-2770,-4.99,52760,-2710,-4.89,52700,55350,1399-6-3
168,وايران,ليزينگ ايرانيان,605,3908127,54305624030,14610,13880,13880,-730,-5.0,13900,-710,-4.86,13880,14060,1399-6-3
169,ثشاهد,سرمايه‌ گذاري‌ شاهد,602,420515,26799420950,67080,63730,63730,-3350,-4.99,66090,-990,-1.48,63730,63730,1399-6-3
170,بفجر,فجر انرژي خليج فارس,598,7757581,203933361080,27630,26940,26250,-1380,-4.99,26290,-1340,-4.85,26250,28900,1399-6-3
171,سيدكو,سرمايه گذاري توسعه صنايع سيمان,595,4821135,44233672230,9640,9170,9160,-480,-4.98,9170,-470,-4.88,9160,9630,1399-6-3
172,ثشرقح,ح. سرمايه گذاري مسكن شمال شرق,594,1592606,7686913120,5030,4700,4840,-190,-3.78,4830,-200,-3.98,4680,5200,1399-6-3
173,خمحركه,نيرو محركه‌,592,1261359,15502102110,12930,12290,12290,-640,-4.95,12710,-220,-1.7,12290,12290,1399-6-3
174,فسازان,غلتك سازان سپاهان,578,2491544,94705282370,39920,37930,37930,-1990,-4.98,38010,-1910,-4.78,37930,39100,1399-6-3
175,شپاكسا,پاكسان‌,578,1435811,44236461220,32380,30850,30770,-1610,-4.97,30830,-1550,-4.79,30770,32000,1399-6-3
176,وبشهر,توسعه‌ صنايع‌ بهشهر(هلدينگ,577,7291893,152440100570,22000,20900,20900,-1100,-5.0,20910,-1090,-4.95,20900,21100,1399-6-3
177,شوينده,مديريت صنعت شوينده ت.ص.بهشهر,564,1355184,53845594730,41800,39710,39710,-2090,-5.0,39730,-2070,-4.95,39710,40840,1399-6-3
178,فروي,ذوب روي اصفهان,542,1296118,88777602410,72099,68495,68495,-3604,-5.0,68495,-3604,-5.0,68495,68495,1399-6-3
179,سپ,پرداخت الكترونيك سامان كيش,540,2717272,80007840560,30280,28770,28770,-1510,-4.99,29440,-840,-2.77,28770,30980,1399-6-3
180,دعبيد,لابراتوارداروسازي‌  دكترعبيدي‌,536,569356,18931087000,35000,33250,33250,-1750,-5.0,34450,-550,-1.57,33250,33250,1399-6-3
181,مفاخر,توسعه فناوري اطلاعات خوارزمي,533,3436103,157167351220,48147,45740,45740,-2407,-5.0,45740,-2407,-5.0,45740,45740,1399-6-3
182,بكاب,صنايع‌جوشكاب‌يزد,520,182941,23528804850,131040,136600,124490,-6550,-5.0,129920,-1120,-0.85,124490,136600,1399-6-3
183,سخاش,سيمان‌خاش‌,519,298428,24930626970,87670,83290,83290,-4380,-5.0,85470,-2200,-2.51,83290,90000,1399-6-3
184,تليسه,دامداري تليسه نمونه,515,469868,34869143731,77922,74650,74026,-3896,-5.0,74979,-2943,-3.78,74026,77723,1399-6-3
185,وتوكا,سرمايه‌گذاري‌توكافولاد(هلدينگ,504,3619651,45524712100,13120,12600,12470,-650,-4.95,12580,-540,-4.12,12470,12980,1399-6-3
186,ميدكو,هلدينگ صنايع  معدني خاورميانه,501,10625225,222195341431,22012,20912,20912,-1100,-5.0,20912,-1100,-5.0,20912,20929,1399-6-3
187,امين يكم2,صندوق درآمد ثابت امين يكم فردا,500,50000000,50000000,10600,1,1,-10599,-99.99,1,-10599,-99.99,1,1,1399-6-3
188,فرآور,فرآوري‌موادمعدني‌ايران‌,499,1658753,38659138810,24430,23400,23210,-1220,-4.99,23520,-910,-3.72,23210,24200,1399-6-3
189,طلا,صندوق س.پشتوانه طلاي لوتوس,499,368149,33000193539,89770,88910,89520,-250,-0.28,89638,-132,-0.15,88910,90000,1399-6-3
190,كهمدا,شيشه‌ همدان‌,493,1785125,47942811030,28140,27220,26740,-1400,-4.98,26860,-1280,-4.55,26740,27500,1399-6-3
191,غويتا,ويتانا,488,861582,50579422988,61244,59100,58182,-3062,-5.0,58705,-2539,-4.15,58182,60713,1399-6-3
192,آپ,آسان پرداخت پرشين,487,1402877,36727415460,27550,26180,26180,-1370,-4.97,26180,-1370,-4.97,26180,26770,1399-6-3
193,خودكفا,اقتصادي و خودكفايي آزادگان,473,252447,37860233931,154611,149973,149973,-4638,-3.0,150429,-4182,-2.7,149973,149973,1399-6-3
194,عيار,صندوق س. پشتوانه طلاي مفيد,471,536985,16372614163,30753,30201,30460,-293,-0.95,30490,-263,-0.86,30201,30800,1399-6-3
195,پرديس,سرمايه گذاري پرديس,470,3164873,32918521990,10930,10390,10390,-540,-4.94,10550,-380,-3.48,10390,10540,1399-6-3
196,آوا,صندوق س.سهام آواي معيار-س,469,2350647,20389589057,9083,8880,8600,-483,-5.32,8674,-409,-4.5,8412,9170,1399-6-3
197,سيمرغ,سيمرغ,465,984286,22180625080,23700,22520,22520,-1180,-4.98,23110,-590,-2.49,22520,22990,1399-6-3
198,غشصفا,شيرپاستوريزه‌پگاه‌اصفهان‌,459,2042167,62049000760,31970,30380,30380,-1590,-4.97,30380,-1590,-4.97,30380,31000,1399-6-3
199,غمارگ,مارگارين‌,456,1182422,43252996760,38500,36580,36580,-1920,-4.99,36610,-1890,-4.91,36580,36580,1399-6-3
200,فسرب,ملي‌ سرب‌وروي‌ ايران‌,456,322680,43346572990,140490,133470,133470,-7020,-5.0,134830,-5660,-4.03,133470,143470,1399-6-3
201,دمعيار,صندوق س. توازن معيار-د,455,19166501,192015895957,10008,10010,10020,12,0.12,10018,10,0.1,10010,10023,1399-6-3
202,واتي,سرمايه‌ گذاري‌ آتيه‌ دماوند,455,2899847,43871108060,15760,15160,14980,-780,-4.95,15150,-610,-3.87,14980,16000,1399-6-3
203,تسه9903,امتياز تسهيلات مسكن خرداد99,452,5970,4852337769,790781,800000,830320,39539,5.0,812787,22006,2.78,752000,830320,1399-6-3
204,كيميا,معدني كيمياي زنجان گستران,450,880542,32399756740,38461,36700,36538,-1923,-5.0,37360,-1101,-2.86,36538,38790,1399-6-3
205,ضصاد8024,اختيارخ وبصادر-5500-1399/08/11,440,20607,4161797000,272,330,300,28,10.29,202,-70,-25.74,173,380,1399-6-3
206,كفرآور,فرآورده هاي سيمان شرق,438,4049586,70074152000,17508,18280,16633,-875,-5.0,17304,-204,-1.17,16633,18280,1399-6-3
207,كرماشا,صنايع پتروشيمي كرمانشاه,426,1237967,43746392400,37130,36170,35280,-1850,-4.98,35560,-1570,-4.23,35280,36170,1399-6-3
208,خصدرا,صنعتي‌ دريايي‌ ايران‌,423,2456795,18214678130,7643,7414,7414,-229,-3.0,7589,-54,-0.71,7414,7414,1399-6-3
209,فاراك,ماشين‌ سازي‌ اراك‌,421,1057782,15009926580,14930,14190,14190,-740,-4.96,14680,-250,-1.67,14190,14190,1399-6-3
210,دارا,صندوق س. دارا الگوريتم-د,420,9758347,97898036405,10016,10025,10050,34,0.34,10032,16,0.16,10018,10050,1399-6-3
211,وكادو,تكادو,417,1737935,44288281746,26793,25454,25454,-1339,-5.0,25483,-1310,-4.89,25454,26000,1399-6-3
212,فرابورس,فرابورس ايران,416,524207,27593208066,55408,52638,52638,-2770,-5.0,54112,-1296,-2.34,52638,52638,1399-6-3
213,فباهنر,مس‌ شهيدباهنر,414,467579,26335035500,59220,56260,56260,-2960,-5.0,57480,-1740,-2.94,56260,58300,1399-6-3
214,فجام,جام‌دارو,413,321293,19827003310,64850,61610,61610,-3240,-5.0,63570,-1280,-1.97,61610,63500,1399-6-3
215,شمواد,توليد مواداوليه الياف مصنوعي,412,542018,31900469390,57141,58855,58855,1714,3.0,58855,1714,3.0,58855,58855,1399-6-3
216,وآوا,سرمايه گذاري آوا نوين,409,1442103,21614661166,15773,14985,14985,-788,-5.0,15397,-376,-2.38,14985,15300,1399-6-3
217,پيزد,مجتمع صنايع لاستيك يزد,408,62397,7602887259,128259,121847,121847,-6412,-5.0,127216,-1043,-0.81,121847,121847,1399-6-3
218,غگرجي,بيسكويت‌  گرجي‌,408,1986068,81167109860,42990,40850,42990,0,0.0,40870,-2120,-4.93,40850,42990,1399-6-3
219,لوتوسح,ح . تامين سرمايه لوتوس پارسيان,406,1405510,16591040980,12110,11370,11610,-500,-4.13,11800,-310,-2.56,11050,13000,1399-6-3
220,فولاي,صنايع فولاد آلياژي يزد,404,431739,23850557577,58150,55243,55243,-2907,-5.0,56750,-1400,-2.41,55243,55243,1399-6-3
221,بهپاك,صنعتي بهپاك,403,1019062,50826512526,52474,49851,49851,-2623,-5.0,49876,-2598,-4.95,49851,50682,1399-6-3
222,كگهرح,ح . سنگ آهن گهرزمين,403,5065432,190725329477,39629,38100,37648,-1981,-5.0,37652,-1977,-4.99,37648,38600,1399-6-3
223,زنجان,صنايع كشاورزي وكود زنجان,401,4670072,37252841583,8383,7964,7964,-419,-5.0,7977,-406,-4.84,7964,8200,1399-6-3
224,كبافق,معادن‌ بافق‌,396,444710,16898980000,39990,38000,38000,-1990,-4.98,39240,-750,-1.88,38000,38000,1399-6-3
225,زكوثر,سرمايه گذاري كشاورزي كوثر,391,528574,14556927960,28980,27540,27540,-1440,-4.97,28500,-480,-1.66,27540,27540,1399-6-3
226,قصفها,قنداصفهان‌,390,153788,33132086720,226770,215440,215440,-11330,-5.0,218280,-8490,-3.74,215440,215440,1399-6-3
227,ريشمك,توليد و صادرات ريشمك,390,495885,17549027309,37173,35315,35315,-1858,-5.0,36474,-699,-1.88,35315,37000,1399-6-3
228,سشرق,سيمان‌ شرق‌,389,1425593,13671436870,10090,9590,9590,-500,-4.96,9940,-150,-1.49,9590,9590,1399-6-3
229,حفاري,حفاري شمال,386,579267,10073453130,18300,17390,17390,-910,-4.97,18100,-200,-1.09,17390,17390,1399-6-3
230,كي بي سي,شركت كي بي سي,386,2170625,86832068915,41912,39910,39817,-2095,-5.0,40003,-1909,-4.55,39817,41990,1399-6-3
231,آساس,صندوق س.آسمان آرماني سهام-س,386,298610,46346414816,164458,166500,154500,-9958,-6.06,155207,-9251,-5.63,149250,171700,1399-6-3
232,دعبيدح,ح . داروسازي‌ دكترعبيدي‌,385,171550,4590421090,28890,28360,26330,-2560,-8.86,26760,-2130,-7.37,26120,28360,1399-6-3
233,فزرين,زرين معدن آسيا,384,1709570,38361729305,23501,22326,22326,-1175,-5.0,22590,-911,-3.88,22326,23501,1399-6-3
234,تسه9902,امتياز تسهيلات مسكن ارديبهشت99,383,5599,4475297260,773519,775005,812194,38675,5.0,799303,25784,3.33,775005,812194,1399-6-3
235,افق ملت,صندوق س در سهام افق ملت,380,250211,36942251860,154990,152830,147510,-7480,-4.83,147640,-7350,-4.74,147500,152830,1399-6-3
236,زعف9908پ10,زعفران9908نگين طلاي سرخ(پ),379,225959,22465149815,96588,97100,101010,4422,4.58,99421,2833,2.93,95000,101417,1399-6-3
237,وساپا,سرمايه‌گذاري‌ سايپا,379,733792,11344424320,16270,15460,15460,-810,-4.98,16130,-140,-0.86,15460,15460,1399-6-3
238,دتوزيع,توزيع دارو پخش,375,301417,17565920559,61297,58233,58233,-3064,-5.0,60167,-1130,-1.84,58233,60000,1399-6-3
239,شتوكا,توكا رنگ فولاد سپاهان,374,371175,14199358747,39987,39987,37988,-1999,-5.0,39457,-530,-1.33,37988,40000,1399-6-3
240,شفارس,صنايع‌ شيميايي‌ فارس‌,373,1351180,57329479020,44650,42420,42420,-2230,-4.99,42430,-2220,-4.97,42420,43270,1399-6-3
241,پاكشو,گروه صنعتي پاكشو,373,689342,37769687890,57510,54640,54640,-2870,-4.99,56340,-1170,-2.03,54640,58700,1399-6-3
242,دزهراوي,داروسازي‌زهراوي‌,370,1023711,16512458430,16970,16130,16130,-840,-4.95,16660,-310,-1.83,16130,16130,1399-6-3
243,زر,صندوق س.پشتوانه سكه طلاي زر,363,384196,20721481873,53272,53200,53699,427,0.8,53935,663,1.24,52500,55100,1399-6-3
244,سدشت,صنايع سيمان دشتستان,363,472306,16937506830,36730,38560,36000,-730,-1.99,36440,-290,-0.79,35000,38560,1399-6-3
245,وصنا,گروه‌صنايع‌بهشهرايران‌,359,2956634,36724047750,13060,12410,12410,-650,-4.98,12540,-520,-3.98,12410,13000,1399-6-3
246,خكرمان,گروه اقتصادي كرمان خودرو,354,2802722,27788988630,10436,9915,9915,-521,-4.99,9915,-521,-4.99,9915,9915,1399-6-3
247,دلر,داروسازي‌ اكسير,349,238775,21375881900,92860,95870,92280,-580,-0.62,91330,-1530,-1.65,88220,95900,1399-6-3
248,قنيشا,قند  نيشابور,344,1919629,166220675110,91140,86590,86590,-4550,-4.99,86590,-4550,-4.99,86590,86590,1399-6-3
249,ارفع,شركت آهن و فولاد ارفع,343,1288974,23298205050,19026,18075,18075,-951,-5.0,18771,-255,-1.34,18075,18075,1399-6-3
250,ساينا,صنايع بهداشتي ساينا,338,544274,76587063157,147467,140100,147000,-467,-0.32,140714,-6753,-4.58,140094,149690,1399-6-3
251,كرازي,كارخانجات‌توليدي‌شيشه‌رازي‌,332,790484,13129939240,17480,16610,16610,-870,-4.98,17220,-260,-1.49,16610,16610,1399-6-3
252,بموتو,موتوژن‌,331,766657,37937729360,51970,49600,49380,-2590,-4.98,49860,-2110,-4.06,49380,50580,1399-6-3
253,حسينا,توسعه خدمات دريايي وبندري سينا,327,1471838,82080705471,58634,57500,55705,-2929,-5.0,55767,-2867,-4.89,55703,59800,1399-6-3
254,تسه9810,امتياز تسهيلات مسكن دي98,327,7478,5965360807,772194,774222,795510,23316,3.02,797721,25527,3.31,774222,810803,1399-6-3
255,فيروزه,صندوق شاخص30 شركت فيروزه- سهام,323,316258,57714437230,191370,190000,180890,-10480,-5.48,182490,-8880,-4.64,180000,190000,1399-6-3
256,شبهرن,نفت‌ بهران‌,323,507712,38200250880,79200,75240,75240,-3960,-5.0,77270,-1930,-2.44,75240,75240,1399-6-3
257,وملل,اعتباري ملل,323,4089397,72570439162,18679,17746,17746,-933,-4.99,17746,-933,-4.99,17746,17746,1399-6-3
258,غبشهر,صنعتي‌ بهشهر,323,1902845,55336594520,30610,29080,29080,-1530,-5.0,29080,-1530,-5.0,29080,30000,1399-6-3
259,كيان,صندوق س. با درآمد ثابت كيان,317,4715144,118062975360,25190,25240,24910,-280,-1.11,25040,-150,-0.6,24900,25380,1399-6-3
260,وتوس,توسعه‌شهري‌توس‌گستر,316,373993,14851262030,41800,39710,39710,-2090,-5.0,41150,-650,-1.56,39710,39710,1399-6-3
261,ثنور,سرمايه گذاري كوه نور,313,3073990,27556652168,9113,9070,8840,-273,-3.0,8964,-149,-1.64,8840,9100,1399-6-3
262,سشمالح,ح . سيمان‌ شمال‌,313,13128858,122608906780,10360,10360,9320,-1040,-10.04,9340,-1020,-9.85,9320,10360,1399-6-3
263,ثفارس,عمران‌وتوسعه‌فارس‌,310,778001,10829773920,14650,13920,13920,-730,-4.98,14470,-180,-1.23,13920,13920,1399-6-3
264,سدبير,س. تدبيرگران فارس وخوزستان,307,2117174,49139608540,22105,23210,23210,1105,5.0,23084,979,4.43,23210,23210,1399-6-3
265,شسپا,نفت سپاهان,307,2891205,79594873650,28970,27530,27530,-1440,-4.97,27530,-1440,-4.97,27530,27530,1399-6-3
266,مرقام,ايران‌ارقام‌,306,486967,16230610110,35080,33330,33330,-1750,-4.99,34430,-650,-1.85,33330,33330,1399-6-3
267,كالا,بورس كالاي ايران,306,295966,14703590880,52290,49680,49680,-2610,-4.99,51520,-770,-1.47,49680,49680,1399-6-3
268,دحاوي,الحاوي,305,718940,23881890278,34212,33187,33186,-1026,-3.0,33218,-994,-2.91,33186,34138,1399-6-3
269,دالبر,البرزدارو,305,620351,13693611880,23230,22070,22070,-1160,-4.99,22890,-340,-1.46,22070,22200,1399-6-3
270,گنجين,صندوق س. گنجينه يكم آويد-د,304,13850968,154310708706,11140,11150,11140,0,0.0,11141,1,0.01,11140,11154,1399-6-3
271,سلار,شركت سيمان لارستان,303,718318,19499673160,26762,26000,27564,802,3.0,27121,359,1.34,26000,27564,1399-6-3
272,خزاميا,زامياد,303,465396,9880357080,22340,21230,21230,-1110,-4.97,22110,-230,-1.03,21230,21230,1399-6-3
273,وكار,بانك‌ كارآفرين‌,301,908495,12970610170,14970,14750,14230,-740,-4.94,14780,-190,-1.27,14230,14800,1399-6-3
274,بالبر,كابل‌ البرز,300,373871,10483320310,29430,27970,27960,-1470,-4.99,29130,-300,-1.02,27960,29500,1399-6-3
275,وملي,گروه‌ صنعتي‌ ملي‌ (هلدينگ‌,300,21037,14894616740,745280,708020,708020,-37260,-5.0,737360,-7920,-1.06,708020,708020,1399-6-3
276,خديزل,بهمن  ديزل,300,597466,29075012553,50564,50499,48036,-2528,-5.0,49358,-1206,-2.39,48036,50500,1399-6-3
277,سرود,سيمان‌شاهرود,296,1747001,30137909430,18150,17250,17250,-900,-4.96,17570,-580,-3.2,17250,17400,1399-6-3
278,آسيا,بيمه آسيا,296,422198,14519389220,36200,34390,34390,-1810,-5.0,35610,-590,-1.63,34390,34390,1399-6-3
279,بكهنوج,توليد برق ماهتاب كهنوج,295,239767,15206982208,66762,63424,63424,-3338,-5.0,65601,-1161,-1.74,63424,63424,1399-6-3
280,سكرد,سيمان كردستان,291,708162,8271332160,12290,11680,11680,-610,-4.96,12180,-110,-0.9,11680,11680,1399-6-3
281,تشتاد,صنايع توليدي اشتاد ايران‌,288,602104,8389737995,14148,14572,13724,-424,-3.0,14056,-92,-0.65,13724,14572,1399-6-3
282,گوهر,صندوق سكه طلاي كيان,288,431727,26073072675,59976,59000,60299,323,0.54,60392,416,0.69,58253,61999,1399-6-3
283,غدام,خوراك‌  دام‌ پارس‌,284,352041,39458200080,117940,112050,112050,-5890,-4.99,112760,-5180,-4.39,112050,117000,1399-6-3
284,شپلي,پلي اكريل ايران,284,1347047,14845804987,11361,11021,11021,-340,-2.99,11099,-262,-2.31,11021,11021,1399-6-3
285,كفرا,فراورده‌ هاي‌ نسوزايران‌,282,722456,31875451720,46420,44100,44100,-2320,-5.0,44850,-1570,-3.38,44100,46000,1399-6-3
286,سخوز,سيمان خوزستان,279,2008838,40927568910,21440,20370,20370,-1070,-4.99,20450,-990,-4.62,20370,20990,1399-6-3
287,شراز,پالايش نفت شيراز,278,305029,30126836254,103928,98740,98732,-5196,-5.0,100352,-3576,-3.44,98732,103000,1399-6-3
288,اپرداز,آتيه داده پرداز,276,1264473,41696040190,34710,32975,32975,-1735,-5.0,33058,-1652,-4.76,32975,32980,1399-6-3
289,سمگا,گروه سرمايه گذاري ميراث فرهنگي,274,1897791,33930605289,18819,17879,17879,-940,-4.99,18094,-725,-3.85,17879,17879,1399-6-3
290,دامين,داروسازي‌ امين‌,271,899720,14054972350,16440,15620,15620,-820,-4.99,16190,-250,-1.52,15620,15750,1399-6-3
291,غديس,پاكديس,269,436354,19414033073,46819,44479,44479,-2340,-5.0,45806,-1013,-2.16,44479,45720,1399-6-3
292,پلوله,گازلوله‌,268,2829695,50122352949,17540,17715,17715,175,1.0,17713,173,0.99,17660,17715,1399-6-3
293,كماسه,تامين‌ ماسه‌ ريخته‌گري‌,265,268528,21441960800,84050,79850,79850,-4200,-5.0,82070,-1980,-2.36,79850,79850,1399-6-3
294,وبهمن,سرمايه‌گذاري‌بهمن‌,262,632220,14092423880,23460,22290,22290,-1170,-4.99,23080,-380,-1.62,22290,22300,1399-6-3
295,ثقزوي,شركت عمران و سازندگي قزوين,261,884075,14979962712,17412,17412,17412,0,0.0,17065,-347,-1.99,16890,17412,1399-6-3
296,ولراز,ليزينگ رازي,258,736453,16509778017,22474,23147,21800,-674,-3.0,22428,-46,-0.2,21800,23148,1399-6-3
297,بذر,صندوق س بذر اميد آفرين-سهام,257,193737,23259273210,123020,124000,119000,-4020,-3.27,120060,-2960,-2.41,118500,128900,1399-6-3
298,ثنظام,س. ساختماني نظام مهندسي ايران,257,582798,26794720848,44637,45976,45976,1339,3.0,45976,1339,3.0,45976,45976,1399-6-3
299,سهرمز,سيمان‌هرمزگان‌,254,975323,17096583830,18420,17500,17500,-920,-4.99,18100,-320,-1.74,17500,18000,1399-6-3
300,شلعاب,لعابيران‌,250,215486,7766115440,37930,36040,36040,-1890,-4.98,37630,-300,-0.79,36040,36040,1399-6-3
301,تسه9901,امتياز تسهيلات مسكن فروردين99,250,3245,2630396622,793054,793320,832706,39652,5.0,810600,17546,2.21,771000,832706,1399-6-3
302,حفارس,حمل و نقل بين المللي خليج فارس,246,1282980,8403519000,6890,6550,6550,-340,-4.93,6820,-70,-1.02,6550,6550,1399-6-3
303,تسه9812,امتياز تسهيلات مسكن اسفند98,241,4401,3516457263,773962,773222,812600,38638,4.99,799013,25051,3.24,773222,812660,1399-6-3
304,سدور,سيمان‌ دورود,240,895519,8498718440,9980,9490,9490,-490,-4.91,9890,-90,-0.9,9490,9500,1399-6-3
305,دتوليد,داروسازي توليد دارو,238,356402,18517935116,54692,51958,51958,-2734,-5.0,53531,-1161,-2.12,51958,51958,1399-6-3
306,سفارس,سيمان فارس و خوزستان,237,834508,18033717880,22740,21610,21610,-1130,-4.97,22320,-420,-1.85,21610,21610,1399-6-3
307,سكه0012پ01,سكه تمام بهارتحويلي 1روزه رفاه,236,155000,164706450400,1073571,1064111,1062365,-11206,-1.04,1062622,-10949,-1.02,1062365,1069999,1399-6-3
308,تسه9707,امتياز تسهيلات مسكن مهر97,236,4554,3569385771,779889,745000,773050,-6839,-0.88,783791,3902,0.5,742500,795000,1399-6-3
309,بخاور,بيمه زندگي خاورميانه,234,1039787,8195523477,8255,7843,7843,-412,-4.99,8189,-66,-0.8,7843,8400,1399-6-3
310,ثمسكن,سرمايه‌گذاري‌ مسكن‌,227,3130792,30806993280,10350,9840,9840,-510,-4.93,10000,-350,-3.38,9840,9840,1399-6-3
311,قثابت,قند ثابت‌ خراسان‌,225,172060,16915218600,103480,98310,98310,-5170,-5.0,101490,-1990,-1.92,98310,98310,1399-6-3
312,حآسا,آسيا سير ارس,224,932146,13576974952,15325,14559,14559,-766,-5.0,15098,-227,-1.48,14559,14827,1399-6-3
313,دارو,كارخانجات‌داروپخش‌,224,263685,14534461860,58020,55120,55120,-2900,-5.0,57120,-900,-1.55,55120,55290,1399-6-3
314,سبهان,سيمان‌ بهبهان‌,218,329450,20261175000,64730,61500,61500,-3230,-4.99,63320,-1410,-2.18,61500,61500,1399-6-3
315,قجام,فرآوردههاي غذايي وقندتربت‌جام‌,214,753551,16970373718,23072,22381,22380,-692,-3.0,22587,-485,-2.1,22380,23400,1399-6-3
316,واحيا,م .صنايع و معادن احياء سپاهان,214,413816,80346508315,200158,194154,194154,-6004,-3.0,194160,-5998,-3.0,194154,198033,1399-6-3
317,سفانو,سيمان فارس نو,213,460347,14355391380,32750,31200,31120,-1630,-4.98,32270,-480,-1.47,31120,32600,1399-6-3
318,لپارس,پارس‌ الكتريك‌,213,30135,14410557000,503360,478200,478200,-25160,-5.0,497040,-6320,-1.26,478200,478200,1399-6-3
319,نوين,بيمه نوين,212,2913150,18658725750,6742,6405,6405,-337,-5.0,6601,-141,-2.09,6405,6405,1399-6-3
320,ركيش,كارت اعتباري ايران كيش,206,2215889,48975335740,23260,22100,22100,-1160,-4.99,22100,-1160,-4.99,22100,22220,1399-6-3
321,قمرو,قند مرودشت‌,206,339216,12394952640,38460,36540,36540,-1920,-4.99,37960,-500,-1.3,36540,36540,1399-6-3
322,ومعلم,بيمه معلم,205,810036,13716135854,17811,16921,16921,-890,-5.0,17563,-248,-1.39,16921,17370,1399-6-3
323,پكوير,كوير تاير,204,318609,5617076670,18550,17630,17630,-920,-4.96,18440,-110,-0.59,17630,17630,1399-6-3
324,صايند,صندوق س. گنجينه آينده روشن-د,204,2599750,26204427070,10074,10050,10090,16,0.16,10080,6,0.06,10015,10100,1399-6-3
325,ونفت,سرمايه‌گذاري‌ صنعت‌ نفت‌,204,2499966,47299356720,19910,18920,18920,-990,-4.97,18920,-990,-4.97,18920,18920,1399-6-3
326,دپارس,پارس‌ دارو,202,283277,27874456800,103570,98400,98400,-5170,-4.99,100460,-3110,-3.0,98400,98400,1399-6-3
327,تكشا,گسترش‌صنايع‌وخدمات‌كشاورزي‌,199,730732,51326615680,66900,70240,70240,3340,4.99,69990,3090,4.62,70240,70240,1399-6-3
328,ضجار7022,اختيارخ وتجارت-2800-1399/07/22,197,5228,2870173000,572,900,629,57,9.97,549,-23,-4.02,490,900,1399-6-3
329,تسه9706,امتياز تسهيلات مسكن شهريور97,194,3246,2485604508,757720,747656,765000,7280,0.96,765744,8024,1.06,720000,784400,1399-6-3
330,كوير,توليدي فولاد سپيد فراب كوير,194,876215,15587864850,18720,17790,17790,-930,-4.97,18530,-190,-1.01,17790,17790,1399-6-3
331,داوه,داروسازي آوه سينا,194,338297,7651939843,23809,22619,22619,-1190,-5.0,23611,-198,-0.83,22619,22619,1399-6-3
332,ورنا,سرمايه‌گذاري‌ رنا(هلدينگ‌,191,360094,4944090620,14450,13730,13730,-720,-4.98,14370,-80,-0.55,13730,13730,1399-6-3
333,سپاها,سيمان‌سپاهان‌,191,638975,7373771500,12140,11540,11540,-600,-4.94,12040,-100,-0.82,11540,11540,1399-6-3
334,سبجنو,سيمان‌ بجنورد,191,755214,26410535990,36760,35000,34930,-1830,-4.98,35720,-1040,-2.83,34930,36990,1399-6-3
335,تصميم,صندوق س با درآمد ثابت تصميم,190,3955323,57839678590,14670,14680,14610,-60,-0.41,14620,-50,-0.34,14600,14770,1399-6-3
336,شفا,سرمايه گذاري شفادارو,187,280287,17450279700,64750,61520,61520,-3230,-4.99,63820,-930,-1.44,61520,67980,1399-6-3
337,غنوش,نوش‌ مازندران‌,186,177854,20403410880,120750,114720,114720,-6030,-4.99,118000,-2750,-2.28,114720,114720,1399-6-3
338,سپاس,صندوق س. پاداش سهامداري توسعه1,183,4554091,46927894410,10270,10310,10260,-10,-0.1,10300,30,0.29,10260,10350,1399-6-3
339,زشگزا,شير و گوشت زاگرس شهركرد,179,202940,21074930978,109207,103749,103747,-5460,-5.0,106634,-2573,-2.36,103747,107534,1399-6-3
340,حسير,ريل سير كوثر,179,648718,18656480962,30272,28759,28759,-1513,-5.0,29715,-557,-1.84,28759,28759,1399-6-3
341,توريل,توکاريل,178,544517,11068941576,21397,20328,20328,-1069,-5.0,21129,-268,-1.25,20328,20328,1399-6-3
342,وگردش,بانك گردشگري,175,1573635,31914891435,20908,20281,20281,-627,-3.0,20692,-216,-1.03,20281,20281,1399-6-3
343,دابور,داروسازي‌ ابوريحان‌,173,306210,12218434180,42000,39900,39900,-2100,-5.0,41450,-550,-1.31,39900,40920,1399-6-3
344,وتعاون,بيمه  تعاون,172,1287267,8185620235,6554,6358,6358,-196,-2.99,6471,-83,-1.27,6358,6554,1399-6-3
345,ساوه,سيمان ساوه,170,30608,2568256064,88324,83908,83908,-4416,-5.0,88073,-251,-0.28,83908,83908,1399-6-3
346,پخش,پخش البرز,167,493934,20675730452,44058,41856,41856,-2202,-5.0,43051,-1007,-2.29,41856,42490,1399-6-3
347,خمهر,مهركام‌پارس‌,167,588723,5863681080,10480,9960,9960,-520,-4.96,10410,-70,-0.67,9960,9960,1399-6-3
348,بنو,بيمه تجارت نو,167,11178773,204906909090,22307,18330,18330,-3977,-17.83,18330,-3977,-17.83,18330,18330,1399-6-3
349,درهآور,دارويي ره آورد تامين,165,119081,4411233305,38991,37042,37042,-1949,-5.0,38804,-187,-0.48,37042,37490,1399-6-3
350,تسه9708,امتياز تسهيلات مسكن آبان97,165,2545,2001225387,782369,751000,790040,7671,0.98,786336,3967,0.51,745009,814153,1399-6-3
351,خريخت,صنايع‌ريخته‌گري‌ايران‌,164,1492407,9730493640,6860,6520,6520,-340,-4.96,6790,-70,-1.02,6520,6520,1399-6-3
352,تسه9811,امتياز تسهيلات مسكن بهمن98,163,2358,1880648233,775559,741500,814000,38441,4.96,797561,22002,2.84,741500,814336,1399-6-3
353,تايرا,تراكتورسازي‌ايران‌,159,299623,9151596560,32130,30530,30530,-1600,-4.98,31790,-340,-1.06,30530,31220,1399-6-3
354,ثنوسا,نوسازي‌وساختمان‌تهران‌,156,720165,11320993800,16540,15720,15720,-820,-4.96,16330,-210,-1.27,15720,15720,1399-6-3
355,پارسيان,بيمه پارسيان,155,1914650,29600605580,16270,15460,15460,-810,-4.98,15730,-540,-3.32,15460,15500,1399-6-3
356,سيستم,همكاران سيستم,155,1010550,28261938540,28360,26950,26950,-1410,-4.97,28130,-230,-0.81,26950,28350,1399-6-3
357,پرداخت,به پرداخت ملت,154,407700,17384699670,44880,42640,42640,-2240,-4.99,44020,-860,-1.92,42640,43400,1399-6-3
358,تسه9709,امتياز تسهيلات مسكن آذر97,153,1783,1409410121,787960,811000,790100,2140,0.27,790471,2511,0.32,750000,811000,1399-6-3
359,ثعمرا,عمران و توسعه شاهد,152,885220,27399329440,32581,30952,30952,-1629,-5.0,31583,-998,-3.06,30952,30952,1399-6-3
360,وسينا,بانك سينا,152,4122082,72919630580,18620,17690,17690,-930,-4.99,17690,-930,-4.99,17690,17690,1399-6-3
361,گنجين2,صندوق س. گنجينه يكم آويد-د,150,15000000,15000000,11140,1,1,-11139,-99.99,1,-11139,-99.99,1,1,1399-6-3
362,تسه9710,امتياز تسهيلات مسكن دي 97,149,2610,2060230428,773074,734421,799000,25926,3.35,789360,16286,2.11,734421,811727,1399-6-3
363,سكه9912پ04,سكه تمام بهارتحويل1روزه صادرات,148,157300,167111491500,1073095,1062365,1062365,-10730,-1.0,1062374,-10721,-1.0,1062365,1064000,1399-6-3
364,رتكو,كنترل‌خوردگي‌تكين‌كو,148,313728,6853409920,22950,21810,21810,-1140,-4.97,22790,-160,-0.7,21810,22900,1399-6-3
365,وسديد,گروه ‌صنعتي‌سديد,148,203296,5824836992,29538,28652,28652,-886,-3.0,29425,-113,-0.38,28652,28652,1399-6-3
366,اخزا815,اسنادخزانه-م15بودجه98-010406,147,242035,174860069095,722191,722602,722054,-137,-0.02,722458,267,0.04,720231,725000,1399-6-3
367,تسه9801,امتياز تسهيلات مسكن فروردين98,145,1837,1458874970,769538,808014,794000,24462,3.18,794162,24624,3.2,754309,808014,1399-6-3
368,تسه9809,امتياز تسهيلات مسكن آذر98,145,2281,1824524961,774370,813088,813088,38718,5.0,799879,25509,3.29,745666,813088,1399-6-3
369,تسه9803,امتياز تسهيلات مسكن خرداد98,143,1722,1367994711,778249,739347,777188,-1061,-0.14,794422,16173,2.08,739347,817161,1399-6-3
370,زماهان,مجتمع توليد گوشت مرغ ماهان,140,568085,16725558570,30991,29442,29442,-1549,-5.0,30421,-570,-1.84,29442,29442,1399-6-3
371,شگل,گلتاش‌,140,1269418,40519822560,33590,31920,31920,-1670,-4.97,32150,-1440,-4.29,31920,31920,1399-6-3
372,غبهنوش,بهنوش‌ ايران‌,139,57484,4560784000,83510,79340,79340,-4170,-4.99,83090,-420,-0.5,79340,79350,1399-6-3
373,سصوفي,سيمان‌ صوفيان‌,138,184689,4135186710,23560,22390,22390,-1170,-4.97,23450,-110,-0.47,22390,22390,1399-6-3
374,كمرجان,بازرگاني و توليدي مرجان كار,138,160308,6940489063,45517,43370,43242,-2275,-5.0,45187,-330,-0.73,43242,44200,1399-6-3
375,قشير,قند شيروان قوچان و بجنورد,138,687797,23061833410,35294,33530,33530,-1764,-5.0,34422,-872,-2.47,33530,33530,1399-6-3
376,صنوين,صندوق سرمايه‌گذاري صنوين-مختلط,137,160680,17946059540,113220,113220,110690,-2530,-2.23,111690,-1530,-1.35,110000,113220,1399-6-3
377,لخانه,لوازم‌ خانگي‌ پارس‌,136,121648,7246571360,62705,59570,59570,-3135,-5.0,61491,-1214,-1.94,59570,59570,1399-6-3
378,تسه9802,امتياز تسهيلات مسكن ارديبهشت98,135,1111,886908140,776622,740300,790000,13378,1.72,798297,21675,2.79,737795,815453,1399-6-3
379,فاسمين,كالسيمين‌,133,60683,4530592780,78580,74660,74660,-3920,-4.99,78280,-300,-0.38,74660,74660,1399-6-3
380,شپارس,بين‌ المللي‌ محصولات‌  پارس‌,132,242070,4204755900,18280,17370,17370,-910,-4.98,18200,-80,-0.44,17370,17370,1399-6-3
381,تسه9808,امتياز تسهيلات مسكن آبان98,130,1883,1502904359,773162,811820,811820,38658,5.0,798144,24982,3.23,760522,811820,1399-6-3
382,خاور,ايران خودرو ديزل,130,539889,4432488690,8642,8210,8210,-432,-5.0,8536,-106,-1.23,8210,8210,1399-6-3
383,دكپسول,توليد ژلاتين كپسول ايران,128,106264,4432486795,43894,41710,41700,-2194,-5.0,43687,-207,-0.47,41700,43479,1399-6-3
384,زمگسا,كشاورزي‌ ودامپروي‌ مگسال‌,127,285346,10423689380,38450,36530,36530,-1920,-4.99,38010,-440,-1.14,36530,36530,1399-6-3
385,وبوعلي,سرمايه‌گذاري‌بوعلي‌,127,418970,4617049400,11600,11020,11020,-580,-5.0,11540,-60,-0.52,11020,11020,1399-6-3
386,شسينا,صنايع‌شيميايي‌سينا,126,53299,23711659120,468290,444880,444880,-23410,-5.0,456110,-12180,-2.6,444880,444880,1399-6-3
387,دسبحا,گروه دارويي سبحان,125,1099995,22604897250,21630,20550,20550,-1080,-4.99,21100,-530,-2.45,20550,20550,1399-6-3
388,پسهند,صنايع‌ لاستيكي‌  سهند,125,345850,19790025430,60200,57190,57190,-3010,-5.0,58890,-1310,-2.18,57190,60070,1399-6-3
389,سجام,مجتمع سيمان غرب آسيا,124,3051865,45808493650,15474,15010,15010,-464,-3.0,15010,-464,-3.0,15010,15010,1399-6-3
390,زعف9908پ05,زعفران9908نگين زرين(پ),124,74935,7550682759,98976,96500,101416,2440,2.47,100763,1787,1.81,96500,101417,1399-6-3
391,لازما,كارخانه هاي صنعتي آزمايش,124,227124,7883712666,35419,34711,34711,-708,-2.0,34845,-574,-1.62,34711,34713,1399-6-3
392,اخزا817,اسنادخزانه-م17بودجه98-010512,124,295339,209572819876,709381,707023,708600,-781,-0.11,709601,220,0.03,704001,711630,1399-6-3
393,ددام,داروسازي زاگرس فارمد پارس,124,216799,3377728420,16400,15580,15580,-820,-5.0,16340,-60,-0.37,15580,15580,1399-6-3
394,دانا,بيمه دانا,123,493928,4460169840,9500,9030,9030,-470,-4.95,9450,-50,-0.53,9030,9030,1399-6-3
395,لكما,كارخانجات‌مخابراتي‌ايران‌,121,340113,4343923236,13167,12772,12772,-395,-3.0,13074,-93,-0.71,12772,12772,1399-6-3
396,دبالك,مواد اوليه دارويي البرز بالك,121,419253,9399233007,23598,22419,22419,-1179,-5.0,23355,-243,-1.03,22419,22419,1399-6-3
397,بالاس,مهندسي ساختمان تاسيسات راه آهن,120,146726,8043959498,57708,54823,54823,-2885,-5.0,57213,-495,-0.86,54823,54823,1399-6-3
398,نطرين,عطرين نخ قم,118,616679,13557071136,23141,21984,21984,-1157,-5.0,22780,-361,-1.56,21984,21984,1399-6-3
399,تبرك,گروه كارخانجات صنعتي تبرك,116,876840,31152371520,37397,35528,35528,-1869,-5.0,36171,-1226,-3.28,35528,35528,1399-6-3
400,وآفري,بيمه كارآفرين,116,6140480,67041760640,10600,10918,10918,318,3.0,10918,318,3.0,10918,10918,1399-6-3
401,ولتجار,واسپاري تجارت وسرمايه ايرانيان,116,518721,4440251760,8824,8560,8560,-264,-2.99,8764,-60,-0.68,8560,8560,1399-6-3
402,غپونه,نوش پونه مشهد,115,140294,2838428208,20857,20232,20232,-625,-3.0,20760,-97,-0.47,20232,20232,1399-6-3
403,خرينگ,رينگ‌سازي‌مشهد,115,182189,5972155420,34500,32780,32780,-1720,-4.99,34270,-230,-0.67,32780,32780,1399-6-3
404,سخند,صندوق س.سپهرخبرگان نفت-د,114,180430,1828167880,10113,10110,10141,28,0.28,10132,19,0.19,10101,10148,1399-6-3
405,كخاك,صنايع‌خاك‌چيني‌ايران‌,114,27204,3942675720,152550,144930,144930,-7620,-5.0,151920,-630,-0.41,144930,144930,1399-6-3
406,زفكا,كشت و دامداري فكا,114,71737,3284263334,48191,45782,45782,-2409,-5.0,48020,-171,-0.35,45782,45782,1399-6-3
407,غمينو,شركت صنايع غذايي مينو شرق,114,176611,3195952656,19048,18096,18096,-952,-5.0,18982,-66,-0.35,18096,18096,1399-6-3
408,ثروتم,صندوق س. ثروت آفرين پارسيان-س,112,66100,6697287800,103521,103000,101000,-2521,-2.44,101321,-2200,-2.13,100000,103200,1399-6-3
409,شساخت,مهندسي و ساختمان صنايع نفت,111,1037972,54416720072,55185,52426,52426,-2759,-5.0,52426,-2759,-5.0,52426,52426,1399-6-3
410,ثجوان,تامين مسكن جوانان,111,1035849,11441988054,11627,11046,11046,-581,-5.0,11253,-374,-3.22,11046,11046,1399-6-3
411,آسام,صندوق س.آرمان سپهر آشنا-م,111,39830,4769384350,122341,124000,119000,-3341,-2.73,119744,-2597,-2.12,118000,124000,1399-6-3
412,غشهد,شهد ايران ‌,108,279088,2567609600,9680,9200,9200,-480,-4.96,9650,-30,-0.31,9200,9200,1399-6-3
413,سهگمت,سيمان‌هگمتان‌,107,190599,4599153870,25390,24130,24130,-1260,-4.96,25270,-120,-0.47,24130,24130,1399-6-3
414,شتولي,تولي‌پرس‌,105,784101,13550833482,16618,17282,17282,664,4.0,17282,664,4.0,17282,17282,1399-6-3
415,اخزا808,اسنادخزانه-م8بودجه98-000817,105,72338,58451118697,807089,808000,808000,911,0.11,808028,939,0.12,805501,809000,1399-6-3
416,شبصير,توليدات پتروشيمي قائد بصير,104,45484,6187734328,143202,136042,136042,-7160,-5.0,142249,-953,-0.67,136042,136042,1399-6-3
417,فاهواز,نورد و لوله اهواز,104,150584,3714606112,25171,24668,24668,-503,-2.0,25137,-34,-0.14,24668,24668,1399-6-3
418,سمازن,سيمان‌مازندران‌,103,226892,2606989080,12090,11490,11490,-600,-4.96,12060,-30,-0.25,11490,11490,1399-6-3
419,خاهن,آهنگري‌ تراكتورسازي‌ ايران‌,103,124305,3841024500,32520,30900,30900,-1620,-4.98,32380,-140,-0.43,30900,30900,1399-6-3
420,ساروم,سيمان‌اروميه‌,102,186739,5435972290,30640,29110,29110,-1530,-4.99,30460,-180,-0.59,29110,29110,1399-6-3
421,تسه9711,امتياز تسهيلات مسكن بهمن 97,102,1131,883392383,759302,797267,790050,30748,4.05,781072,21770,2.87,721337,797267,1399-6-3
422,آبين,كشت و صنعت آبشيرين,101,489851,2564369985,5510,5235,5235,-275,-4.99,5472,-38,-0.69,5235,5235,1399-6-3
423,فروس,فروسيليس‌ ايران‌,101,162200,4729752000,30690,29160,29160,-1530,-4.99,30530,-160,-0.52,29160,29160,1399-6-3
424,تسه9712,امتياز تسهيلات مسكن اسفند97,100,838,662774798,773988,735580,785889,11901,1.54,790901,16913,2.19,735580,812687,1399-6-3
425,فخاس,فولاد خراسان,99,2217937,98964348940,46960,44620,44620,-2340,-4.98,44620,-2340,-4.98,44620,44620,1399-6-3
426,افران,صندوق س افرا نماد پايدار-ثابت,99,2976030,33814974640,11570,10420,11580,10,0.09,11360,-210,-1.82,10420,11610,1399-6-3
427,وزمين,بانك ايران زمين,99,243085,4690081990,20097,19294,19294,-803,-4.0,19975,-122,-0.61,19294,19294,1399-6-3
428,وشهر,بانك شهر,98,251173,2488370911,10109,9907,9907,-202,-2.0,10101,-8,-0.08,9907,9907,1399-6-3
429,شفارا,پتروشيمي فارابي,96,449955,2605689405,5970,5791,5791,-179,-3.0,5945,-25,-0.42,5791,5791,1399-6-3
430,دسبحان,سبحان دارو,95,425862,11894325660,29400,27930,27930,-1470,-5.0,29030,-370,-1.26,27930,27930,1399-6-3
431,كيسون,شركت كيسون,95,211108,5426953356,26502,25707,25707,-795,-3.0,26419,-83,-0.31,25707,25707,1399-6-3
432,دسانكو,داروسازي سبحان انكولوژي,94,522526,12718282840,25621,24340,24340,-1281,-5.0,25270,-351,-1.37,24340,24340,1399-6-3
433,خاذين,سايپاآذين‌,93,405310,3899082200,10120,9620,9620,-500,-4.94,10080,-40,-0.4,9620,9620,1399-6-3
434,كپارس,كاشي‌ پارس‌,92,68624,5992933920,91920,87330,87330,-4590,-4.99,91320,-600,-0.65,87330,87330,1399-6-3
435,آ س پ,آ.س.پ,92,211976,3189814848,15840,15048,15048,-792,-5.0,15785,-55,-0.35,15048,15048,1399-6-3
436,خمحور,توليدمحورخودرو,90,209827,14008050520,70270,66760,66760,-3510,-5.0,69260,-1010,-1.44,66760,66760,1399-6-3
437,خزر,فنرسازي‌زر,90,329593,3286042210,10490,9970,9970,-520,-4.96,10450,-40,-0.38,9970,9970,1399-6-3
438,ثپرديسح,ح.سرمايه گذاري مسكن پرديس,90,209843,1935591832,9709,9224,9224,-485,-5.0,9224,-485,-5.0,9224,9224,1399-6-3
439,ضجار7031,اختيارخ وتجارت-4600-1399/07/22,89,5269,1080826000,266,250,201,-65,-24.44,205,-61,-22.93,177,290,1399-6-3
440,وپخش,داروپخش‌ (هلدينگ‌,88,75522,9132120240,127280,120920,120920,-6360,-5.0,126030,-1250,-0.98,120920,120920,1399-6-3
441,ثاصفا,شركت‌ ساختمان‌ اصفهان‌,88,104173,2573489792,25468,24704,24704,-764,-3.0,25369,-99,-0.39,24704,24704,1399-6-3
442,سيلامح,ح . سيمان‌ ايلام‌,88,311069,3078782760,7046,10000,9500,2454,34.83,9900,2854,40.51,9500,10000,1399-6-3
443,غصينو,صنعتي مينو,87,181843,7037324100,39896,38700,38700,-1196,-3.0,39770,-126,-0.32,38700,38700,1399-6-3
444,سنوين,سرمايه گذاري اقتصاد نوين,87,5029681,62408281848,12925,12408,12408,-517,-4.0,12408,-517,-4.0,12408,12408,1399-6-3
445,وتوصا,گروه س توسعه صنعتي ايران,86,164864,2847201280,18170,17270,17270,-900,-4.95,18110,-60,-0.33,17270,17270,1399-6-3
446,خلنت,لنت‌ ترمزايران‌,86,21414,2152749420,105820,100530,100530,-5290,-5.0,105580,-240,-0.23,100530,100530,1399-6-3
447,سغرب,سيمان‌غرب‌,86,151306,3699431700,25730,24450,24450,-1280,-4.97,25630,-100,-0.39,24450,24450,1399-6-3
448,پلاسك,پلاسكوكار,86,315989,3115651540,10370,9860,9860,-510,-4.92,10340,-30,-0.29,9860,9860,1399-6-3
449,ضجار7016,اختيارخ وتجارت-1800-1399/07/22,85,2065,2517043000,1225,1225,1222,-3,-0.24,1219,-6,-0.49,1101,1500,1399-6-3
450,نيرو,نيرو سرمايه,84,266812,18058903408,71246,67684,67684,-3562,-5.0,67731,-3515,-4.93,67684,67684,1399-6-3
451,درازك,دارويي‌ رازك‌,84,148989,7264703640,51320,48760,48760,-2560,-4.99,50920,-400,-0.78,48760,48760,1399-6-3
452,تسه9807,امتياز تسهيلات مسكن مهر98,83,1085,866639658,780161,741153,819000,38839,4.98,798746,18585,2.38,741153,819169,1399-6-3
453,ولشرق,ليزينگ ايران و شرق,82,754685,8945281305,12476,11853,11853,-623,-4.99,12358,-118,-0.95,11853,11853,1399-6-3
454,كترام,توليدي‌ كاشي‌ تكسرام‌,82,124781,2924866640,24670,23440,23440,-1230,-4.99,24590,-80,-0.32,23440,23440,1399-6-3
455,شاملا,معدني‌ املاح‌  ايران‌,82,21166,2993507380,148870,141430,141430,-7440,-5.0,148390,-480,-0.32,141430,141430,1399-6-3
456,خشرق,الكتريك‌ خودرو شرق‌,82,145119,3284042970,23820,22630,22630,-1190,-5.0,23740,-80,-0.34,22630,22630,1399-6-3
457,فيروزا,صندوق بادرآمد ثابت فيروزه آسيا,80,1079925,21972041710,20360,20250,20360,0,0.0,20350,-10,-0.05,20250,20360,1399-6-3
458,غدشت,دشت‌ مرغاب‌,79,11058,3606124380,343270,326110,326110,-17160,-5.0,341890,-1380,-0.4,326110,326110,1399-6-3
459,رنيك,جنرال مكانيك,79,95705,3178363050,34957,33210,33210,-1747,-5.0,34837,-120,-0.34,33210,33210,1399-6-3
460,اوصتا,صندوق انديشه ورزان صباتامين -د,79,3029188,49678911169,16421,16428,16203,-218,-1.33,16400,-21,-0.13,16203,16499,1399-6-3
461,ديران,ايران‌دارو,79,313933,9006737770,30200,28690,28690,-1510,-5.0,29900,-300,-0.99,28690,28690,1399-6-3
462,بشهاب,لامپ‌  پارس‌ شهاب‌,78,32309,2460774770,80150,76150,76150,-4000,-4.99,79950,-200,-0.25,76150,77000,1399-6-3
463,ميهن,بيمه ميهن,78,481790,3405291720,7439,7068,7068,-371,-4.99,7412,-27,-0.36,7068,7068,1399-6-3
464,وحكمت,بيمه حكمت صبا,78,335210,1999862860,6279,5966,5966,-313,-4.98,6245,-34,-0.54,5966,5966,1399-6-3
465,خكار,ايركا پارت صنعت,77,103157,4398614480,44880,42640,42640,-2240,-4.99,44670,-210,-0.47,42640,42640,1399-6-3
466,ياقوت,صندوق س ياقوت آگاه-ثابت,76,1150351,12496517530,10890,10970,10850,-40,-0.37,10860,-30,-0.28,10850,10990,1399-6-3
467,زشريف,كشت وصنعت شريف آباد,75,107402,3338376366,32718,31083,31083,-1635,-5.0,32601,-117,-0.36,31083,31083,1399-6-3
468,شپترو,پتروشيمي آبادان,74,123514,1178076532,9832,9538,9538,-294,-2.99,9816,-16,-0.16,9538,9538,1399-6-3
469,آكورد2,صندوق س. آرمان آتي كوثر-د,73,7300000,7300000,28465,1,1,-28464,-100.0,1,-28464,-100.0,1,1,1399-6-3
470,داناح,ح . بيمه دانا,73,637521,4072007780,7040,7040,7040,0,0.0,6390,-650,-9.23,6340,7040,1399-6-3
471,ضصاد8017,اختيارخ وبصادر-3800-1399/08/11,73,1677,876530000,486,700,510,24,4.94,523,37,7.61,458,700,1399-6-3
472,غفارس,شير پاستوريزه پگاه فارس,72,215347,2462708292,12037,11436,11436,-601,-4.99,12006,-31,-0.26,11436,11436,1399-6-3
473,تسه9806,امتياز تسهيلات مسكن شهريور98,72,822,656644974,773955,773977,812652,38697,5.0,798838,24883,3.22,773955,812652,1399-6-3
474,ميدكوح,ح.هلدينگ صنايع معدن خاورميانه,72,641031,11771893284,19330,18364,18364,-966,-5.0,18364,-966,-5.0,18364,18364,1399-6-3
475,فلوله,لوله‌وماشين‌سازي‌ايران‌,71,110371,3578227820,34120,32420,32420,-1700,-4.98,33990,-130,-0.38,32420,32420,1399-6-3
476,پاسا,ايران‌ياساتايرورابر,71,124492,3103585560,26240,24930,24930,-1310,-4.99,26150,-90,-0.34,24930,24930,1399-6-3
477,چدن,توليدي چدن سازان,71,50796,1751446080,36290,34480,34480,-1810,-4.99,36220,-70,-0.19,34480,34480,1399-6-3
478,نگين,ص.س. زمين و ساختمان نگين شهرري,70,92535,4718407650,50900,51000,51000,100,0.2,50990,90,0.18,50050,51000,1399-6-3
479,سفاسي,شركت فارسيت اهواز,70,230500,2770379500,12651,12019,12019,-632,-5.0,12556,-95,-0.75,12019,12019,1399-6-3
480,كهرام,توليدي گرانيت بهسرام,70,467194,21336749980,44340,45670,45670,1330,3.0,45667,1327,2.99,45670,45670,1399-6-3
481,حپارسا,توسعه حمل و نقل ريلي پارسيان,69,149560,6057479120,42633,40502,40502,-2131,-5.0,42353,-280,-0.66,40502,40502,1399-6-3
482,زعف9908پ09,زعفران9908نگين نوين(پ),69,22106,2197814607,94757,99400,100500,5743,6.06,99422,4665,4.92,97700,101417,1399-6-3
483,لابسا,آبسال‌,69,57281,2390908940,43930,41740,41740,-2190,-4.99,43820,-110,-0.25,41740,41740,1399-6-3
484,سايرا,ايرانيت‌,68,332922,11866628240,36369,35642,35642,-727,-2.0,35644,-725,-1.99,35642,35700,1399-6-3
485,وبرق,س.کارکنان صنعت برق زنجان وقزوي,68,17118,4351737960,267599,254220,254220,-13379,-5.0,264401,-3198,-1.2,254220,254220,1399-6-3
486,فوكا,فولاد كاويان,67,218223,4959772344,23191,22728,22728,-463,-2.0,23149,-42,-0.18,22728,22728,1399-6-3
487,وآرين,شركت توسعه اقتصادي آرين,67,272401,1723753528,6661,6328,6328,-333,-5.0,6630,-31,-0.47,6328,6328,1399-6-3
488,زدشت,كشت و صنعت دشت خرم دره,67,40967,2710622522,69648,66166,66166,-3482,-5.0,69437,-211,-0.3,66166,66166,1399-6-3
489,اتكام,شركت بيمه اتكايي امين,66,578601,4780401462,8696,8262,8262,-434,-4.99,8650,-46,-0.53,8262,8262,1399-6-3
490,قچار,فراوردههاي غذايي وقند چهارمحال,65,31620,5994740940,199565,189587,189587,-9978,-5.0,198227,-1338,-0.67,189587,189587,1399-6-3
491,شكربن,كربن‌ ايران‌,65,33011,2592023720,82650,78520,78520,-4130,-5.0,82420,-230,-0.28,78520,78520,1399-6-3
492,بزاگرس,نيروگاه زاگرس كوثر,65,268803,5054302809,19792,18803,18803,-989,-5.0,19684,-108,-0.55,18803,18803,1399-6-3
493,الماس,صندوق س.امين تدبيرگران فردا-س,65,32173,4198271738,134146,148000,127010,-7136,-5.32,130491,-3655,-2.72,125000,148000,1399-6-3
494,كسعدي,كاشي‌ سعدي‌,64,127566,9526628880,78610,74680,74680,-3930,-5.0,77810,-800,-1.02,74680,74680,1399-6-3
495,كوثر,بيمه كوثر,64,221155,3790817855,18043,17141,17141,-902,-5.0,17970,-73,-0.4,17141,17141,1399-6-3
496,ثتران,سرمايه گذاري مسكن تهران,63,147230,1555190490,11118,10563,10563,-555,-4.99,11099,-19,-0.17,10563,10563,1399-6-3
497,ولبهمن,شركت بهمن ليزينگ,63,647101,7689501183,12508,11883,11883,-625,-5.0,12400,-108,-0.86,11883,11883,1399-6-3
498,گپارس,امور رفاهي كارگزاران پارس,63,120197,9476932465,76549,78845,78845,2296,3.0,77564,1015,1.33,78845,78845,1399-6-3
499,اخزا811,اسنادخزانه-م11بودجه98-001013,62,169722,134188961497,787219,787219,787512,293,0.04,790640,3421,0.43,786101,793000,1399-6-3
500,تپولا,مهندسي مرآت پولاد,62,1024567,15307030980,13679,14940,14940,1261,9.22,14563,884,6.46,14940,14940,1399-6-3
501,دتماد,توليدمواداوليه‌داروپخش‌,62,39192,1660565040,44590,42370,42370,-2220,-4.98,44480,-110,-0.25,42370,42370,1399-6-3
502,آرمان,بيمه آرمان,62,3333912,13515679248,3975,4054,4054,79,1.99,4054,79,1.99,4054,4054,1399-6-3
503,اخزا816,اسنادخزانه-م16بودجه98-010503,62,234368,167051993339,713403,711232,713500,97,0.01,712776,-627,-0.09,710500,713864,1399-6-3
504,زگلدشت,كشت و دام گلدشت نمونه اصفهان,61,22191,991582644,47035,44684,44684,-2351,-5.0,46985,-50,-0.11,44684,44684,1399-6-3
505,غشاذر,پگاه‌آذربايجان‌غربي‌,61,61858,1508716620,25670,24390,24390,-1280,-4.99,25630,-40,-0.16,24390,24390,1399-6-3
506,لخزر,پارس‌ خزر,59,25226,5853047540,244140,231940,231940,-12200,-5.0,242560,-1580,-0.65,231940,239490,1399-6-3
507,وآذر,سرمايه‌گذاري‌توسعه‌آذربايجان‌,59,29435,4246587450,151860,144270,144270,-7590,-5.0,151160,-700,-0.46,144270,144270,1399-6-3
508,اخزا812,اسنادخزانه-م12بودجه98-001111,59,256368,199515389619,777910,773244,777000,-910,-0.12,778238,328,0.04,773244,780000,1399-6-3
509,حتوكا,حمل‌ونقل‌توكا,59,88437,1828877160,21760,20680,20680,-1080,-4.96,21720,-40,-0.18,20680,20680,1399-6-3
510,قشكر,شكرشاهرود,59,516621,32299144920,65810,62520,62520,-3290,-5.0,63420,-2390,-3.63,62520,62520,1399-6-3
511,خكاوه,سايپا ديزل,58,481964,3641719984,7789,7556,7556,-233,-2.99,7744,-45,-0.58,7556,7556,1399-6-3
512,قپيرا,فرآورده‌هاي‌غدايي‌وقندپيرانشهر,58,15964,1326030390,87100,82800,82750,-4350,-4.99,86990,-110,-0.13,82750,87900,1399-6-3
513,سمتاز,سيمان ممتازان كرمان,58,80934,1931813646,24607,23869,23869,-738,-3.0,24533,-74,-0.3,23869,23869,1399-6-3
514,غبهار,كشت وصنعت بهاران گلبهار خراسان,58,269458,12476174858,47732,46301,46301,-1431,-3.0,46793,-939,-1.97,46301,46301,1399-6-3
515,بايكا,كارخانجات كابلسازي ‌ايران‌,57,59398,2842075504,49327,47848,47848,-1479,-3.0,49114,-213,-0.43,47848,47848,1399-6-3
516,وسخراج,شركت س استان خراسان جنوبي,57,2279668,4035012360,1690,1770,1770,80,4.73,1700,10,0.59,1770,1770,1399-6-3
517,ساراب,سيمان‌ داراب‌,56,150510,1982216700,13860,13170,13170,-690,-4.98,13830,-30,-0.22,13170,13170,1399-6-3
518,ثامان,سامان‌ گستراصفهان‌,56,195703,4794723500,25780,24500,24500,-1280,-4.97,25660,-120,-0.47,24500,24500,1399-6-3
519,زبينا,كشاورزي و دامپروري بينالود,56,31913,2090078109,68940,65493,65493,-3447,-5.0,68787,-153,-0.22,65493,65493,1399-6-3
520,هجرت,پخش هجرت,55,118027,8238048546,73471,69798,69798,-3673,-5.0,72810,-661,-0.9,69798,69798,1399-6-3
521,اخزا821,اسنادخزانه-م21بودجه98-020906,54,30793,17883193669,583206,575003,580022,-3184,-0.55,580755,-2451,-0.42,575003,584000,1399-6-3
522,شجم,صنايع پتروشيمي تخت جمشيد,54,707341,7958293591,11843,11251,11251,-592,-5.0,11682,-161,-1.36,11251,11251,1399-6-3
523,وهنر,گروه توسعه هنر ايران,54,282422,1802417204,6717,6382,6382,-335,-4.99,6685,-32,-0.48,6382,6382,1399-6-3
524,فپنتا,سپنتا,53,22217,6483364940,277930,291820,291820,13890,5.0,279620,1690,0.61,291820,291820,1399-6-3
525,چفيبر,فيبر ايران‌,53,309873,3399306810,11540,10970,10970,-570,-4.94,11500,-40,-0.35,10970,10970,1399-6-3
526,فنرژي,گسترش صنايع انرژي آذرآب,53,169475,2001754646,12045,11820,11805,-240,-1.99,11998,-47,-0.39,11805,11821,1399-6-3
527,آريان,سرمايه گذاري پارس آريان,52,112663,2315675302,21189,20554,20554,-635,-3.0,21173,-16,-0.08,20554,20554,1399-6-3
528,زعف9908پ08,زعفران9908نگين روستا(پ),52,22301,2234948260,97421,96100,101417,3996,4.1,100217,2796,2.87,96100,101417,1399-6-3
529,سنير,سيمان‌ سفيد ني‌ريز,51,11994,1171573920,102820,97680,97680,-5140,-5.0,102700,-120,-0.12,97680,97680,1399-6-3
530,ختور,رادياتور ايران‌,51,18250,755367500,43560,41390,41390,-2170,-4.98,43520,-40,-0.09,41390,41390,1399-6-3
531,لسرما,سرما آفرين‌,50,84626,2432151240,30250,28740,28740,-1510,-4.99,30170,-80,-0.26,28740,28740,1399-6-3
532,فايرا,آلومينيوم‌ايران‌,50,55451,1206613760,22900,21760,21760,-1140,-4.98,22870,-30,-0.13,21760,21760,1399-6-3
533,اخزا814,اسنادخزانه-م14بودجه98-010318,50,34314,25002149289,728617,728999,728605,-12,0.0,728628,11,0.0,728099,729000,1399-6-3
534,زعف9908پ16,زعفران9908نگين بيرجند(پ),50,29829,2994846558,97691,98440,101417,3726,3.81,100400,2709,2.77,98000,101417,1399-6-3
535,فسا,پتروشيمي فسا,50,169489,536263196,3330,3164,3164,-166,-4.98,3325,-5,-0.15,3164,3164,1399-6-3
536,اخزا809,اسنادخزانه-م9بودجه98-000923,49,49633,39393039840,793423,792501,793513,90,0.01,793686,263,0.03,792501,795000,1399-6-3
537,تسه9804,امتياز تسهيلات مسكن تير98,49,793,637730698,783711,744526,822896,39185,5.0,804200,20489,2.61,744526,822896,1399-6-3
538,اخزا806,اسنادخزانه-م6بودجه98-000519,49,121830,104791926746,852341,850000,850010,-2331,-0.27,860149,7808,0.92,850000,865000,1399-6-3
539,كاذر,فرآورده‌هاي‌نسوزآذر,48,58447,2122210570,38220,36310,36310,-1910,-5.0,38130,-90,-0.24,36310,36310,1399-6-3
540,وثوق,سرمايه گذاري وثوق امين,48,118497,1948209177,17306,16441,16441,-865,-5.0,17216,-90,-0.52,16441,16441,1399-6-3
541,اوان,مبين وان كيش,48,22156,1379631964,65546,62269,62269,-3277,-5.0,65449,-97,-0.15,62269,62269,1399-6-3
542,خپويش,سازه‌ پويش‌,48,18107,2603424460,151340,143780,143780,-7560,-5.0,150920,-420,-0.28,143780,143780,1399-6-3
543,غالبر,لبنيات‌ كالبر,47,51551,734601750,14990,14250,14250,-740,-4.94,14980,-10,-0.07,14250,14250,1399-6-3
544,كاسپين,داروسازي كاسپين تامين,47,131267,4053787494,32507,30882,30882,-1625,-5.0,32368,-139,-0.43,30882,30882,1399-6-3
545,ضصاد8012,اختيارخ وبصادر-2800-1399/08/11,46,1022,921926000,1000,1000,949,-51,-5.1,902,-98,-9.8,870,1100,1399-6-3
546,بساما,بيمه سامان,46,48013,1535887857,33672,31989,31989,-1683,-5.0,33617,-55,-0.16,31989,31989,1399-6-3
547,كگاز,شيشه‌ و گاز,46,49152,1347256320,28850,27410,27410,-1440,-4.99,28810,-40,-0.14,27410,27410,1399-6-3
548,پتاير,ايران‌ تاير,45,16521,1717027530,109400,103930,103930,-5470,-5.0,109200,-200,-0.18,103930,103930,1399-6-3
549,سمايه,بانك سرمايه,45,869403,10849280037,12864,12479,12479,-385,-2.99,12655,-209,-1.62,12479,12479,1399-6-3
550,دجابر,داروسازي‌ جابرابن‌حيان‌,45,37118,1818410820,51560,48990,48990,-2570,-4.98,51450,-110,-0.21,48990,48990,1399-6-3
551,تسه9805,امتياز تسهيلات مسكن مرداد98,45,404,325733013,800561,800571,840000,39439,4.93,806270,5709,0.71,772222,840000,1399-6-3
552,بنيرو,نيروترانس‌,45,57395,4358576300,79930,75940,75940,-3990,-4.99,79560,-370,-0.46,75940,75940,1399-6-3
553,بميلا,توسعه بازرگاني آهن وفولادميلاد,44,64570,2682689790,43733,41547,41547,-2186,-5.0,43412,-321,-0.73,41547,41547,1399-6-3
554,وايرا,سرمايه گذاري صنايع ايران,44,154399,1476672036,9859,9564,9564,-295,-2.99,9837,-22,-0.22,9564,9564,1399-6-3
555,شجمح,ح. صنايع پتروشيمي تخت جمشيد,43,286899,2227483836,8172,7764,7764,-408,-4.99,7764,-408,-4.99,7764,7764,1399-6-3
556,ضچاد7024,اختيارخ كچاد-23300-1399/07/07,43,868,1173744000,1884,1500,1690,-194,-10.3,1352,-532,-28.24,1210,1690,1399-6-3
557,كشرق,صنعتي و معدني شمال شرق شاهرود,43,22126,2066767534,98325,93409,93409,-4916,-5.0,98103,-222,-0.23,93409,93409,1399-6-3
558,ثپرديس,سرمايه گذاري مسكن پرديس,43,109379,1613777766,15530,14754,14754,-776,-5.0,15503,-27,-0.17,14754,14754,1399-6-3
559,ارمغان,ص سرمايه گذاري ارمغان ايرانيان,42,1171782,11844718400,10090,10100,10110,20,0.2,10110,20,0.2,10080,10140,1399-6-3
560,ساروجح,ح . بين المللي ساروج بوشهر,42,95873,1595283174,17152,16638,16638,-514,-3.0,16640,-512,-2.99,16638,17132,1399-6-3
561,ثشرق,سرمايه گذاري مسكن شمال شرق,42,171701,1337550790,8200,7790,7790,-410,-5.0,8190,-10,-0.12,7790,7790,1399-6-3
562,ضجار7024,اختيارخ وتجارت-3200-1399/07/22,42,604,257949000,442,440,459,17,3.85,427,-15,-3.39,397,499,1399-6-3
563,اخزا807,اسنادخزانه-م7بودجه98-000719,41,131450,107875800845,819890,819890,821000,1110,0.14,820660,770,0.09,819890,821000,1399-6-3
564,ضجار7018,اختيارخ وتجارت-2000-1399/07/22,41,804,829162000,1131,1102,1150,19,1.68,1031,-100,-8.84,961,1150,1399-6-3
565,خفولا,خدمات فني فولاد يزد,41,46866,1418399490,31201,30265,30265,-936,-3.0,31132,-69,-0.22,30265,30265,1399-6-3
566,كپرور,فرآوري زغال سنگ پروده طبس,41,28038,1374619026,51607,49027,49027,-2580,-5.0,51530,-77,-0.15,49027,49027,1399-6-3
567,شرنگي,شيميايي رنگين,41,17315,2156964180,128424,124572,124572,-3852,-3.0,128050,-374,-0.29,124572,124572,1399-6-3
568,تكنار,مجتمع معادن مس تكنار,41,62895,3895464720,60133,61936,61936,1803,3.0,60469,336,0.56,61936,61936,1399-6-3
569,فبيرا,بسته‌ بندي‌ ايران‌,41,574287,3381976143,6071,5889,5889,-182,-3.0,6038,-33,-0.54,5889,5889,1399-6-3
570,فنوال,نورد آلومينيوم‌,40,18422,761197040,43490,41320,41320,-2170,-4.99,43460,-30,-0.07,41320,41320,1399-6-3
571,زعف9908پ14,زعفران9908پوشالمعمول نوين(پ),40,6800,456758645,66413,65000,66600,187,0.28,67170,757,1.14,64500,69733,1399-6-3
572,كقزوي,شيشه‌ قزوين‌,40,219674,2518562410,12068,11465,11465,-603,-5.0,11987,-81,-0.67,11465,11465,1399-6-3
573,سيلام,سيمان‌ ايلام‌,39,70082,785619220,11800,11210,11210,-590,-5.0,11790,-10,-0.08,11210,11210,1399-6-3
574,ثالوند,سرمايه گذاري مسكن الوند,38,146876,2545361080,18242,17330,17330,-912,-5.0,18193,-49,-0.27,17330,17330,1399-6-3
575,حپترو,حمل و نقل پتروشيمي( سهامي عام,38,27975,878694750,33060,31410,31410,-1650,-4.99,33030,-30,-0.09,31410,31410,1399-6-3
576,ثنام,س ساختماني ب نام آوران مهندسي,38,73482,1798692396,25235,24478,24478,-757,-3.0,25168,-67,-0.27,24478,24478,1399-6-3
577,آساميد,صندوق س.مشترك آسمان اميد -د,38,1204015,12736383190,10591,10590,10570,-21,-0.2,10578,-13,-0.12,10562,10590,1399-6-3
578,سكه0011پ02,سكه تمام بهارتحويلي 1روزه ملت,38,15400,16363583500,1073448,1062365,1063500,-9948,-0.93,1062570,-10878,-1.01,1062365,1071000,1399-6-3
579,سكه0112پ03,سكه تمام بهارتحويلي1روزه سامان,37,39300,41753499000,1073625,1062367,1062365,-11260,-1.05,1062430,-11195,-1.04,1062365,1069996,1399-6-3
580,سكارون,سيمان كارون,37,3776,499493056,136372,132281,132281,-4091,-3.0,136264,-108,-0.08,132281,132281,1399-6-3
581,ضصاد8020,اختيارخ وبصادر-4400-1399/08/11,36,813,293020000,335,320,450,115,34.33,360,25,7.46,310,450,1399-6-3
582,زكشت,كشاورزي مكانيزه اصفهان كشت,36,29724,1155074640,40905,38860,38860,-2045,-5.0,40855,-50,-0.12,38860,38860,1399-6-3
583,اخزا818,اسنادخزانه-م18بودجه98-010614,36,146954,102924526858,700092,697500,698000,-2092,-0.3,700386,294,0.04,697261,701000,1399-6-3
584,زعف9908پ06,زعفران 9908پوشالمعمول زرين(پ),36,9985,652830265,66019,65500,65500,-519,-0.79,65381,-638,-0.97,64293,65500,1399-6-3
585,دقاضي,داروسازي شهيد قاضي,35,28061,2963213539,108864,105599,105599,-3265,-3.0,108364,-500,-0.46,105599,105599,1399-6-3
586,داريك,صندوق س.اعتماد داريك-د,35,358903,3521583671,9889,9848,9810,-79,-0.8,9812,-77,-0.78,9810,9850,1399-6-3
587,زقيام,كشت و دام قيام اصفهان,35,36713,1505893834,43176,41018,41018,-2158,-5.0,43107,-69,-0.16,41018,41018,1399-6-3
588,شصفها,پتروشيمي‌ اصفهان‌,35,120973,12648815907,106692,104559,104559,-2133,-2.0,104559,-2133,-2.0,104559,104559,1399-6-3
589,اعتلا,شركت سرمايه گذاري اعتلاء البرز,35,297619,4424404054,15648,14866,14866,-782,-5.0,15574,-74,-0.47,14866,14866,1399-6-3
590,قشهد,شهد,35,32078,1200679540,39400,37430,37430,-1970,-5.0,39350,-50,-0.13,37430,37430,1399-6-3
591,كمينا,شيشه سازي مينا,34,178693,8302612859,47900,46463,46463,-1437,-3.0,47243,-657,-1.37,46463,46463,1399-6-3
592,واعتبار,سرمايه گذاري اعتبار ايران,34,590012,5115404040,9120,8670,8670,-450,-4.93,9070,-50,-0.55,8670,8670,1399-6-3
593,معيار,سرمايه گذاري معيار صنعت پارس,33,38463,1053886200,26863,27400,27400,537,2.0,26916,53,0.2,27400,27400,1399-6-3
594,شدوص,دوده‌ صنعتي‌ پارس‌,33,45923,1072761280,24580,23360,23360,-1220,-4.96,24550,-30,-0.12,23360,23360,1399-6-3
595,چكاوه,صنايع‌كاغذسازي‌كاوه‌,33,17578,700659080,41950,39860,39860,-2090,-4.98,41920,-30,-0.07,39860,39860,1399-6-3
596,زپارس,ملي كشت و صنعت و دامپروري پارس,32,11436,1112036640,102350,97240,97240,-5110,-4.99,102220,-130,-0.13,97240,97240,1399-6-3
597,فالوم,آلومتك‌,32,59635,2275254155,39332,38153,38153,-1179,-3.0,39192,-140,-0.36,38153,38153,1399-6-3
598,ساذري,آذريت‌,32,64159,10108956199,150059,157561,157561,7502,5.0,153647,3588,2.39,157561,157561,1399-6-3
599,اطلس2,صندوق س.توسعه اندوخته آينده-س,32,320000,320000,192667,1,1,-192666,-100.0,1,-192666,-100.0,1,1,1399-6-3
600,كتوكا,توليدي و خدمات صنايع نسوز توكا,31,14769,2419162200,172421,163800,163800,-8621,-5.0,171973,-448,-0.26,163800,163800,1399-6-3
601,فلات,گروه صنايع معادن فلات ايرانيان,31,272415,4714413990,18216,17306,17306,-910,-5.0,17984,-232,-1.27,17306,17306,1399-6-3
602,بسويچ,پارس‌سويچ‌,31,23660,1222748800,54390,51680,51680,-2710,-4.98,54320,-70,-0.13,51680,51680,1399-6-3
603,فنورد,نوردوقطعات‌ فولادي‌,31,38221,4440515780,110650,116180,116180,5530,5.0,111110,460,0.42,116180,116180,1399-6-3
604,لپيام,گسترش صنايع پيام,31,90566,2945478018,33878,32523,32523,-1355,-4.0,33459,-419,-1.24,32523,32523,1399-6-3
605,اخزا703,اسنادخزانه-م3بودجه97-990721,31,88893,86766684956,976453,976000,976621,168,0.02,976080,-373,-0.04,971502,978300,1399-6-3
606,چافست,افست‌,31,38147,1072693640,29600,28120,28120,-1480,-5.0,29570,-30,-0.1,28120,28120,1399-6-3
607,داراب,پتروشيمي داراب,31,214822,716646192,3439,3336,3336,-103,-3.0,3435,-4,-0.12,3336,3336,1399-6-3
608,نمرينو,ايران‌ مرينوس‌,30,37454,2939015380,74740,78470,78470,3730,4.99,74940,200,0.27,78470,78470,1399-6-3
609,ساربيل,سيمان آرتا اردبيل,30,21768,2729924880,132010,125410,125410,-6600,-5.0,131630,-380,-0.29,125410,125410,1399-6-3
610,زير0003پ04,زيره سبز0003شركت مينوبذر(پ),30,1074,455347956,434184,412741,413000,-21184,-4.88,423974,-10210,-2.35,412741,456187,1399-6-3
611,وسين,بيمه سينا,30,768685,17531398795,23512,22807,22807,-705,-3.0,22844,-668,-2.84,22807,22807,1399-6-3
612,غپآذر,شير پگاه آذربايجان شرقي,30,26896,1556175664,60904,57859,57859,-3045,-5.0,60804,-100,-0.16,57859,57859,1399-6-3
613,شكف,كف,30,138192,4503124512,31948,32586,32586,638,2.0,32218,270,0.85,32586,32586,1399-6-3
614,اخزا704,اسنادخزانه-م4بودجه97-991022,29,109702,103397027027,940122,937012,945900,5778,0.61,942526,2404,0.26,936037,945900,1399-6-3
615,ثتوسا,س.توسعه و عمران استان اردبيل,29,7780,623115760,84307,80092,80092,-4215,-5.0,84167,-140,-0.17,80092,80092,1399-6-3
616,جهرم,پتروشيمي جهرم,29,271325,945838950,3593,3486,3486,-107,-2.98,3588,-5,-0.14,3486,3486,1399-6-3
617,زعف9908پ17,زعفران9908پوشالمعمول بيرجند(پ),29,3039,195531309,66684,65000,65500,-1184,-1.78,64341,-2343,-3.51,64093,65500,1399-6-3
618,اخزا723,اسنادخزانه-م23بودجه97-000824,29,9902,7985001097,804519,804521,804523,4,0.0,806403,1884,0.23,804521,808000,1399-6-3
619,اخزا804,اسنادخزانه-م4بودجه98-000421,29,3829,3286494366,857107,858001,858500,1393,0.16,858317,1210,0.14,858000,858500,1399-6-3
620,دكوثر,داروسازي‌ كوثر,29,36877,1114791710,31820,30230,30230,-1590,-5.0,31780,-40,-0.13,30230,30230,1399-6-3
621,كصدف,كاشي صدف سرام استقلال آباده,28,94819,1240327339,12825,13081,13081,256,2.0,12856,31,0.24,13081,13081,1399-6-3
622,غپاك,لبنيات‌ پاك‌,28,21737,414524590,20070,19070,19070,-1000,-4.98,20060,-10,-0.05,19070,19070,1399-6-3
623,قهكمت,قندهكمتان‌,28,16446,920976000,58940,56000,56000,-2940,-4.99,58880,-60,-0.1,56000,56000,1399-6-3
624,وثنو,سرمايه گذاري ساختماني نوين,27,65453,1312659915,20675,20055,20055,-620,-3.0,20632,-43,-0.21,20055,20055,1399-6-3
625,وآرينح,ح. شركت توسعه اقتصادي آرين,27,187484,838803416,4612,4474,4474,-138,-2.99,4474,-138,-2.99,4474,4474,1399-6-3
626,قلرست,قند لرستان‌,27,53737,1652412750,32360,30750,30750,-1610,-4.98,32300,-60,-0.19,30750,30750,1399-6-3
627,شكبير,پتروشيمي اميركبير,27,116830,8014538000,66586,68600,68600,2014,3.02,66749,163,0.24,68600,68600,1399-6-3
628,لبوتان,گروه‌صنعتي‌بوتان‌,26,16451,1411824820,90330,85820,85820,-4510,-4.99,90190,-140,-0.15,85820,85820,1399-6-3
629,فمراد,آلومراد,26,5919,916793910,163040,154890,154890,-8150,-5.0,162880,-160,-0.1,154890,154890,1399-6-3
630,ختراك,ريخته‌گري‌ تراكتورسازي‌ ايران‌,26,28318,628376420,23350,22190,22190,-1160,-4.97,23330,-20,-0.09,22190,22190,1399-6-3
631,سكرما,سيمان‌ كرمان‌,25,23724,451230480,20020,19020,19020,-1000,-5.0,20010,-10,-0.05,19020,19020,1399-6-3
632,بمپنا,توليد برق عسلويه  مپنا,25,10347,1252452615,127415,121045,121045,-6370,-5.0,127246,-169,-0.13,121045,121045,1399-6-3
633,وسرمد,بيمه  سرمد,24,92242,911904412,10191,9886,9886,-305,-2.99,10177,-14,-0.14,9886,9886,1399-6-3
634,تمحركه,ماشين‌سازي‌نيرومحركه‌,24,38651,925691450,25210,23950,23950,-1260,-5.0,25180,-30,-0.12,23950,23950,1399-6-3
635,سصفها,سيمان‌اصفهان‌,24,4845,653687400,142020,134920,134920,-7100,-5.0,141920,-100,-0.07,134920,134920,1399-6-3
636,وارس,سرمايه گذاري ارس صبا,24,53465,7928271385,156093,148289,148289,-7804,-5.0,152683,-3410,-2.18,148289,148289,1399-6-3
637,شزنگ,تجهيزنيروي‌زنگان‌,24,102484,9382307716,93417,91549,91549,-1868,-2.0,91591,-1826,-1.95,91549,91549,1399-6-3
638,پارتا,مجتمع‌صنعتي‌آرتاويل‌تاير,24,12436,864824312,73202,69542,69542,-3660,-5.0,73107,-95,-0.13,69542,69542,1399-6-3
639,كپشير,پشم‌شيشه‌ايران‌,23,11255,647500150,60550,57530,57530,-3020,-4.99,60510,-40,-0.07,57530,57530,1399-6-3
640,كطبس,ذغال‌سنگ‌ نگين‌ ط‌بس‌,23,13714,825171380,63330,60170,60170,-3160,-4.99,63270,-60,-0.09,60170,60170,1399-6-3
641,غگلپا,شير پاستوريزه پگاه گلپايگان,23,8442,661185882,82443,78321,78321,-4122,-5.0,82385,-58,-0.07,78321,78321,1399-6-3
642,خكمك,كمك‌فنرايندامين‌,23,18300,1175043000,67580,64210,64210,-3370,-4.99,67490,-90,-0.13,64210,64210,1399-6-3
643,خفنر,فنرسازي‌خاور,23,51742,1131080120,23010,21860,21860,-1150,-5.0,22980,-30,-0.13,21860,21860,1399-6-3
644,وآتوس,س.آرين توسكا قيمت اسمي 350ريال,22,223620,4969283640,22600,22222,22222,-378,-1.67,22506,-94,-0.42,22222,22222,1399-6-3
645,اخزا722,اسنادخزانه-م22بودجه97-000428,22,211358,184118850025,880000,880000,859000,-21000,-2.39,871123,-8877,-1.01,859000,884000,1399-6-3
646,وتوشه,سرمايه‌ گذاري‌ پارس‌ توشه‌,22,40981,1112634150,28570,27150,27150,-1420,-4.97,28540,-30,-0.11,27150,27150,1399-6-3
647,سخزر,سيمان‌ خزر,21,9066,345323940,40090,38090,38090,-2000,-4.99,40080,-10,-0.02,38090,38090,1399-6-3
648,تكنو,تكنوتار,21,51858,813652020,16510,15690,15690,-820,-4.97,16500,-10,-0.06,15690,15690,1399-6-3
649,فسديد,لوله‌وتجهيزات‌ سديد - ورشكسته,21,181735,19027836235,103665,104701,104701,1036,1.0,104701,1036,1.0,104701,104701,1399-6-3
650,ثغرب,شركت سرمايه گذاري مسكن شمالغرب,20,18170,263828400,15284,14520,14520,-764,-5.0,15280,-4,-0.03,14520,14520,1399-6-3
651,زعف9908پ13,زعفران9908پوشالمعمول روستا(پ),20,3245,216568090,67015,68994,66442,-573,-0.86,66739,-276,-0.41,65000,68994,1399-6-3
652,اخزا820,اسنادخزانه-م20بودجه98-020806,20,54655,31712664292,580205,579000,581001,796,0.14,580234,29,0.0,579000,590500,1399-6-3
653,ضملي8077,اختيارخ فملي -29750-1399/08/06,20,95,532443000,4283,5000,6000,1717,40.09,5605,1322,30.87,5000,6060,1399-6-3
654,سشمال,سيمان‌ شمال‌,20,40121,540028660,14160,13460,13460,-700,-4.94,14150,-10,-0.07,13460,13460,1399-6-3
655,اراد41,مرابحه عام دولت4-ش.خ 0006,20,500000,479160000000,970800,970800,950000,-20800,-2.14,958320,-12480,-1.29,950000,970800,1399-6-3
656,دلقما,دارويي‌ لقمان‌,20,9085,320973050,37180,35330,35330,-1850,-4.98,37170,-10,-0.03,35330,35330,1399-6-3
657,ضجار7023,اختيارخ وتجارت-3000-1399/07/22,20,234,126701000,904,501,549,-355,-39.27,541,-363,-40.15,470,600,1399-6-3
658,فيروزه2,صندوق شاخص30 شركت فيروزه- سهام,20,200000,200000,191370,1,1,-191369,-100.0,1,-191369,-100.0,1,1,1399-6-3
659,ثباغ,شهر سازي و خانه سازي باغميشه,19,95212,2004117388,22156,21049,21049,-1107,-5.0,22109,-47,-0.21,21049,21049,1399-6-3
660,ثزاگرس,سرمايه گذاري توسعه عمران زاگرس,19,16074,404116434,25918,25141,25141,-777,-3.0,25902,-16,-0.06,25141,25141,1399-6-3
661,دشيمي,شيمي‌ داروئي‌ داروپخش‌,19,51663,3099263370,63140,59990,59990,-3150,-4.99,62930,-210,-0.33,59990,59990,1399-6-3
662,كلوند,كاشي‌ الوند,18,45112,1247346800,29100,27650,27650,-1450,-4.98,29060,-40,-0.14,27650,27650,1399-6-3
663,داسوه,داروسازي‌ اسوه‌,18,20022,823104420,43270,41110,41110,-2160,-4.99,43230,-40,-0.09,41110,41110,1399-6-3
664,ثرود,سرمايه‌گذاري مسكن زاينده رود,17,145887,1935774603,13967,13269,13269,-698,-5.0,13938,-29,-0.21,13269,13269,1399-6-3
665,دكيمي,كيميدارو,17,19077,604931670,33370,31710,31710,-1660,-4.97,33350,-20,-0.06,31710,31710,1399-6-3
666,وسنا,سرمايه گذاري نيروگاهي ايران,17,40205,1190791690,30533,29618,29618,-915,-3.0,30495,-38,-0.12,29618,29618,1399-6-3
667,وثخوز,سرمايه گذاري و توسعه خوزستان,17,21198,864857202,42060,40799,40799,-1261,-3.0,42004,-56,-0.13,40799,40799,1399-6-3
668,ضجار7025,اختيارخ وتجارت-3400-1399/07/22,17,888,275992000,404,301,350,-54,-13.37,311,-93,-23.02,300,450,1399-6-3
669,زعف9908پ15,زعفران9908پوشالمعمول طلاسرخ(پ),17,1463,95330284,67503,65000,65490,-2013,-2.98,65161,-2342,-3.47,65000,65490,1399-6-3
670,افرا,افرانت,17,12856,936662448,76692,72858,72858,-3834,-5.0,76613,-79,-0.1,72858,72858,1399-6-3
671,شسم,توليد سموم‌ علف‌ كش,17,4536,337637160,72976,74435,74435,1459,2.0,73024,48,0.07,74435,74435,1399-6-3
672,پدرخش,درخشان‌ تهران‌,16,2196,488851560,234320,222610,222610,-11710,-5.0,234200,-120,-0.05,222610,222610,1399-6-3
673,زير0003پ01,زيره سبز0003كيميابذر(پ),16,438,191982812,434464,412742,449960,15496,3.57,438317,3853,0.89,412741,449960,1399-6-3
674,وپسا,س. پتروشيمي ساختمان  خليج فارس,16,262737,1544893560,6061,5880,5880,-181,-2.99,6046,-15,-0.25,5880,5880,1399-6-3
675,ضصاد8013,اختيارخ وبصادر-3000-1399/08/11,15,504,353266000,946,700,799,-147,-15.54,701,-245,-25.9,700,799,1399-6-3
676,پست9908-04,پسته فندقي32-30سبزدانه9908,15,120,168200046,1407121,1400000,1400000,-7121,-0.51,1401667,-5454,-0.39,1400000,1440000,1399-6-3
677,آينده,بازرگاني آينده سازان بهشت پارس,15,18287,461911333,26040,25259,25259,-781,-3.0,26021,-19,-0.07,25259,25259,1399-6-3
678,دالبرح,ح . البرزدارو,15,14540,289135400,19010,20910,19010,0,0.0,19890,880,4.63,19010,20910,1399-6-3
679,اخزا805,اسنادخزانه-م5بودجه98-000422,15,43534,37330660570,857081,850253,857607,526,0.06,857506,425,0.05,850253,857700,1399-6-3
680,تپمپي,پمپ‌ سازي‌ ايران‌,15,7863,401091630,53690,51010,51010,-2680,-4.99,53670,-20,-0.04,51010,51010,1399-6-3
681,صايپا012,صكوك مرابحه سايپا012-3ماهه 16%,15,72,72521944,986709,937374,941600,-45109,-4.57,1007249,20540,2.08,937374,1036044,1399-6-3
682,كرونا2,تامين مالي جمعي صرفا اهداي سود,15,3334,33340000,10000,10000,10000,0,0.0,10000,0,0.0,10000,10000,1399-6-3
683,فن آوا,گروه فن آوا,14,209952,3128284800,15204,14900,14900,-304,-2.0,15107,-97,-0.64,14900,14900,1399-6-3
684,فافزا,فولاد افزا سپاهان,14,7367,355789265,49788,48295,48295,-1493,-3.0,49760,-28,-0.06,48295,48295,1399-6-3
685,وحافظ,بيمه حافظ,14,14320,847543520,62301,59186,59186,-3115,-5.0,62162,-139,-0.22,59186,59186,1399-6-3
686,قنقش,قند نقش جهان,14,40672,3377118176,84727,83033,83033,-1694,-2.0,84107,-620,-0.73,83033,83033,1399-6-3
687,ضگل8057,اختيارخ كگل-13100-1399/08/21,14,127,749821000,12490,6000,5920,-6570,-52.6,5904,-6586,-52.73,5000,6000,1399-6-3
688,دسينا,داروسازي‌ سينا,14,36744,1317639840,37740,35860,35860,-1880,-4.98,37690,-50,-0.13,35860,35860,1399-6-3
689,ضخوز7023,اختيارخ فخوز-31470-1399/07/20,13,55,655565000,14091,12601,11200,-2891,-20.52,11919,-2172,-15.41,11200,13000,1399-6-3
690,وگردشح,ح . بانك گردشگري,13,96978,1916576214,20374,19763,19763,-611,-3.0,19763,-611,-3.0,19763,19763,1399-6-3
691,دروز,داروسازي‌ روزدارو,13,22043,450999780,21530,20460,20460,-1070,-4.97,21520,-10,-0.05,20460,20460,1399-6-3
692,سفار,سيمان‌فارس‌,13,2725,310868000,120080,114080,114080,-6000,-5.0,120040,-40,-0.03,114080,114080,1399-6-3
693,سرو2,صندوق س سروسودمند مدبران-سهام,13,1300000,1300000,62890,1,1,-62889,-100.0,1,-62889,-100.0,1,1,1399-6-3
694,اتكاي,بيمه اتكايي ايرانيان,13,225667,2932316998,13677,12994,12994,-683,-4.99,13634,-43,-0.31,12994,12994,1399-6-3
695,ضصاد8010,اختيارخ وبصادر-2400-1399/08/11,13,429,584800000,2000,1900,1300,-700,-35.0,1363,-637,-31.85,1100,1900,1399-6-3
696,گكيشح,ح.توريستي ورفاهي آبادگران كيش,13,28880,1494511120,53349,51749,51749,-1600,-3.0,51749,-1600,-3.0,51749,51749,1399-6-3
697,سقاين,سيمان‌ قائن‌,13,5517,264098790,50380,47870,47870,-2510,-4.98,50370,-10,-0.02,47870,47870,1399-6-3
698,اخزا721,اسنادخزانه-م21بودجه97-000728,13,22105,18067313670,814529,816105,818001,3472,0.43,817341,2812,0.35,814537,818001,1399-6-3
699,سخواف,سيمان مجد خواف,12,10633,203877142,19767,19174,19174,-593,-3.0,19761,-6,-0.03,19174,19174,1399-6-3
700,خفناور,مهندسي صنعتي روان فن آور,12,19958,529645404,27358,26538,26538,-820,-3.0,27335,-23,-0.08,26538,26538,1399-6-3
701,ثعتما,س. ساختماني اعتماد گستر,12,169869,4918726764,29851,28956,28956,-895,-3.0,29619,-232,-0.78,28956,28956,1399-6-3
702,زنگان,صنعت روي زنگان,12,858,138664812,170120,161614,161614,-8506,-5.0,170095,-25,-0.01,161614,161614,1399-6-3
703,ضفلا8086,اختيارخ فولاد-17775-1399/08/28,12,78,205845000,2814,3000,3300,486,17.27,2639,-175,-6.22,2225,3333,1399-6-3
704,ضغدر8038,اختيارخ وغدير-11000-1399/08/26,12,102,695245000,7183,6900,6900,-283,-3.94,6816,-367,-5.11,6600,6915,1399-6-3
705,خنصير,مهندسي‌نصيرماشين‌,12,4524,257189400,59840,56850,56850,-2990,-5.0,59820,-20,-0.03,56850,56850,1399-6-3
706,ضجار7010,اختيارخ وتجارت-1200-1399/07/22,12,97,176407000,1771,1700,1800,29,1.64,1819,48,2.71,1700,2100,1399-6-3
707,صايپا908,صكوك مرابحه سايپا908-3ماهه 18%,12,653,655803000,999267,997001,1015000,15733,1.57,1004292,5025,0.5,997001,1019000,1399-6-3
708,ضفلا8079,اختيارخ فولاد-10775-1399/08/28,11,186,1285550000,7038,7000,7500,462,6.56,6912,-126,-1.79,6600,8000,1399-6-3
709,كساوه,صنايع‌ كاشي‌ و سراميك‌ سينا,11,28503,1236460140,45660,43380,43380,-2280,-4.99,45600,-60,-0.13,43380,43380,1399-6-3
710,شستا993,اجاره ت.اجتماعي-كاردان991226,11,197,203068130,1018793,1014713,1034000,15207,1.49,1030803,12010,1.18,1014713,1035000,1399-6-3
711,گكيش,توريستي ورفاهي آبادگران كيش,11,4755,340063335,73728,71517,71517,-2211,-3.0,73689,-39,-0.05,71517,71517,1399-6-3
712,ثقزويح,ح.شركت عمران و سازندگي قزوين,11,114945,1605551760,14859,13968,13968,-891,-6.0,13968,-891,-6.0,13968,13968,1399-6-3
713,اخزا810,اسنادخزانه-م10بودجه98-001006,11,13442,10615311792,789775,790000,789000,-775,-0.1,789712,-63,-0.01,789000,795000,1399-6-3
714,زعف9908پ12,زعفران9908پوشالمعمول سحرخيز(پ),11,2130,148531290,67998,69733,69733,1735,2.55,69733,1735,2.55,69733,69733,1399-6-3
715,واحصا,احياء صنايع خراسان,11,27444,493992000,18556,18000,18000,-556,-3.0,18542,-14,-0.08,18000,18000,1399-6-3
716,خموتور,موتورسازان‌تراكتورسازي‌ايران‌,10,13828,199399760,15170,14420,14420,-750,-4.94,15170,0,0.0,14420,14420,1399-6-3
717,مداران,داده‌پردازي‌ايران‌,10,5415,216654150,42110,40010,40010,-2100,-4.99,42100,-10,-0.02,40010,40010,1399-6-3
718,ومشان,س. فني و مهندسي مشانير,10,1500,86757000,59626,57838,57838,-1788,-3.0,59618,-8,-0.01,57838,57838,1399-6-3
719,ضشنا7048,اختيارخ شپنا-2685-1399/07/28,10,11,318500000,29167,29500,29500,333,1.14,28955,-212,-0.73,28000,29500,1399-6-3
720,اخزا624,اسنادخزانه-م24بودجه96-990625,10,648,640859518,986513,989001,990000,3487,0.35,988981,2468,0.25,987021,991500,1399-6-3
721,ضخود7053,اختيارخ خودرو-3200-1399/07/09,10,168,202355000,1340,1100,1105,-235,-17.54,1204,-136,-10.15,1100,1230,1399-6-3
722,اعتماد2,صندوق س.اعتماد آفرين پارسيان-د,10,95000000,95000000,32014,1,1,-32013,-100.0,1,-32013,-100.0,1,1,1399-6-3
723,ضخود7054,اختيارخ خودرو-3400-1399/07/09,10,57,50860000,924,900,860,-64,-6.93,892,-32,-3.46,600,2800,1399-6-3
724,ضشنا7082,اختيارخ شپنا-29258-1399/07/28,10,29,90000000,2000,3000,4000,2000,100.0,3103,1103,55.15,3000,4000,1399-6-3
725,ضفلا8093,اختيارخ فولاد-29775-1399/08/28,10,59,113450000,2011,3000,1700,-311,-15.46,1923,-88,-4.38,1500,3000,1399-6-3
726,قزوين,كارخانجات‌ قند قزوين‌,10,1500,79725000,55940,53150,53150,-2790,-4.99,55940,0,0.0,53150,53150,1399-6-3
727,ضغدر8039,اختيارخ وغدير-12000-1399/08/26,9,50,300000000,6995,6000,6000,-995,-14.22,6000,-995,-14.22,6000,6000,1399-6-3
728,ضفلا8084,اختيارخ فولاد-15775-1399/08/28,9,104,470850000,4800,5900,4350,-450,-9.38,4527,-273,-5.69,3400,5900,1399-6-3
729,خچرخش,چرخشگر,9,8521,205270890,25350,24090,24090,-1260,-4.97,25340,-10,-0.04,24090,24090,1399-6-3
730,ضسپا8018,اختيارخ خساپا-2400-1399/08/26,9,169,251300000,10000,2000,1800,-8200,-82.0,1487,-8513,-85.13,1300,2000,1399-6-3
731,ضترا8040,اختيارخ شتران-16326-1399/08/11,9,43,408500000,10349,9500,9500,-849,-8.2,9500,-849,-8.2,9500,9500,1399-6-3
732,ساروج,بين المللي ساروج بوشهر,9,4243,107912219,26219,25433,25433,-786,-3.0,26215,-4,-0.02,25433,25433,1399-6-3
733,دشيري,شيرين دارو,9,1118,240839560,222082,215420,215420,-6662,-3.0,221998,-84,-0.04,215420,215420,1399-6-3
734,ضصاد8015,اختيارخ وبصادر-3400-1399/08/11,9,255,163400000,811,850,600,-211,-26.02,641,-170,-20.96,600,850,1399-6-3
735,اخزا713,اسنادخزانه-م13بودجه97-000518,9,3076,2628517278,847773,860000,845000,-2773,-0.33,854524,6751,0.8,842231,860000,1399-6-3
736,غشوكو,شوكو پارس,9,3901,174983256,46243,44856,44856,-1387,-3.0,46230,-13,-0.03,44856,44856,1399-6-3
737,اخزا718,اسنادخزانه-م18بودجه97-000525,9,100300,87262299010,866970,868500,843005,-23965,-2.76,870013,3043,0.35,843005,872000,1399-6-3
738,پلاست,كارخانجات توليدي پلاستيران,8,4786,202337722,44502,42277,42277,-2225,-5.0,44478,-24,-0.05,42277,42277,1399-6-3
739,ضپار8019,اختيارخ خپارس-3800-1399/08/18,8,9,68050000,8847,8000,6200,-2647,-29.92,7561,-1286,-14.54,6200,8200,1399-6-3
740,ثاباد,توريستي ورفاهي آبادگران ايران,8,12718,455558760,37700,35820,35820,-1880,-4.99,37680,-20,-0.05,35820,35820,1399-6-3
741,بزاگرسح,ح . نيروگاه زاگرس كوثر,8,19524,265409256,14309,13594,13594,-715,-5.0,13594,-715,-5.0,13594,13594,1399-6-3
742,زعف9908پ11,زعفران9908نگين سحرخيز(پ),8,660,66820370,99588,101417,101417,1829,1.84,101243,1655,1.66,99120,101417,1399-6-3
743,حرهشا,رهشاد سپاهان (سهامي عام,8,18328,1113499312,62632,60754,60754,-1878,-3.0,62522,-110,-0.18,60754,60754,1399-6-3
744,حخزر,كشتيراني درياي خزر,7,2160,76764240,37409,35539,35539,-1870,-5.0,37406,-3,-0.01,35539,35539,1399-6-3
745,ضصاد8008,اختيارخ وبصادر-2000-1399/08/11,7,114,138800000,1963,300,1250,-713,-36.32,1218,-745,-37.95,300,1250,1399-6-3
746,ضبدر8060,اختيارخ شبندر-29580-1399/08/18,7,12,137500000,14959,10000,12500,-2459,-16.44,11458,-3501,-23.4,10000,12500,1399-6-3
747,ضشنا7071,اختيارخ شپنا-13153-1399/07/28,7,48,787000000,34000,16000,16800,-17200,-50.59,16396,-17604,-51.78,15000,16800,1399-6-3
748,ضشنا7053,اختيارخ شپنا-3758-1399/07/28,7,26,688500000,29013,28000,26000,-3013,-10.38,26481,-2532,-8.73,26000,28500,1399-6-3
749,ضفلا8076,اختيارخ فولاد-8775-1399/08/28,7,105,908800000,9009,8450,9000,-9,-0.1,8655,-354,-3.93,8450,9000,1399-6-3
750,ضفلا8082,اختيارخ فولاد-13775-1399/08/28,7,113,583932000,5171,5750,5750,579,11.2,5168,-3,-0.06,5100,5750,1399-6-3
751,اخزا813,اسنادخزانه-م13بودجه98-010219,7,2445,1805635341,738501,737889,738892,391,0.05,738501,0,0.0,737888,738893,1399-6-3
752,ضپيك7030,اختيارخ تاپيكو-17370-99/07/20,7,92,367260000,4218,4000,3990,-228,-5.41,3992,-226,-5.36,3990,4000,1399-6-3
753,ضفلا8085,اختيارخ فولاد-16775-1399/08/28,6,98,350840000,4336,4900,4100,-236,-5.44,3580,-756,-17.44,3100,4900,1399-6-3
754,ضصاد8000,اختيارخ وبصادر-1200-1399/08/11,6,31,65350000,1890,2100,2100,210,11.11,2108,218,11.53,2100,2150,1399-6-3
755,دفرا,فرآورده‌هاي‌ تزريقي‌ ايران‌,6,2648,79466480,31580,30010,30010,-1570,-4.97,31580,0,0.0,30010,30010,1399-6-3
756,سفارود,كارخانه فارسيت درود,6,7367,52003653,7203,7059,7059,-144,-2.0,7202,-1,-0.01,7059,7059,1399-6-3
757,ضشنا7075,اختيارخ شپنا-18522-1399/07/28,6,38,390041000,11521,11521,10500,-1021,-8.86,10264,-1257,-10.91,10000,11521,1399-6-3
758,ضگل8058,اختيارخ كگل-14100-1399/08/21,6,15,79199000,5743,5300,5200,-543,-9.45,5280,-463,-8.06,5200,5300,1399-6-3
759,غمهرا,توليدي‌مهرام‌,6,1413,156956040,116920,111080,111080,-5840,-4.99,116900,-20,-0.02,111080,111080,1399-6-3
760,ضفلا8080,اختيارخ فولاد-11775-1399/08/28,6,83,533500000,7400,6500,6200,-1200,-16.22,6428,-972,-13.14,6200,6500,1399-6-3
761,ضگل8059,اختيارخ كگل-15100-1399/08/21,6,34,166600000,10100,4900,4900,-5200,-51.49,4900,-5200,-51.49,4900,4900,1399-6-3
762,ضصاد8021,اختيارخ وبصادر-4600-1399/08/11,6,146,53394000,430,200,400,-30,-6.98,366,-64,-14.88,200,400,1399-6-3
763,فلامي,لاميران‌,5,1628,218331080,141160,134110,134110,-7050,-4.99,141130,-30,-0.02,134110,134110,1399-6-3
764,ضجار7027,اختيارخ وتجارت-3800-1399/07/22,5,236,59750000,392,250,350,-42,-10.71,253,-139,-35.46,250,350,1399-6-3
765,ثاژن,سخت آژند,5,62078,747853666,12292,12047,12047,-245,-1.99,12273,-19,-0.15,12047,12047,1399-6-3
766,حكمت01,مشاركت حكمت ايرانيان 140107,5,86049,84759000000,985000,1000000,985000,0,0.0,985009,9,0.0,985000,1000000,1399-6-3
767,شرق1400,مشاركت ليزينگ ايران وشرق140010,5,133,132774000,998312,998000,1000000,1688,0.17,998301,-11,0.0,998000,1000000,1399-6-3
768,ضصاد8009,اختيارخ وبصادر-2200-1399/08/11,5,66,104200000,1746,1700,1200,-546,-31.27,1579,-167,-9.56,1200,1700,1399-6-3
769,ضمخا7032,اختيارخ اخابر-4750-1399/07/30,5,6,88000000,17271,15000,14000,-3271,-18.94,14667,-2604,-15.08,14000,15000,1399-6-3
770,ضفلا8091,اختيارخ فولاد-25775-1399/08/28,5,15,30800000,3953,2600,1800,-2153,-54.46,2053,-1900,-48.06,1800,2600,1399-6-3
771,عسناسنگ,سلف كنستانتره سنگ آهن سناباد,5,6,40220888,6718116,6742966,6620000,-98116,-1.46,6703481,-14635,-0.22,6620000,6742966,1399-6-3
772,ضصاد8014,اختيارخ وبصادر-3200-1399/08/11,5,121,105610000,1168,1402,850,-318,-27.23,873,-295,-25.26,850,1402,1399-6-3
773,ضفلا8088,اختيارخ فولاد-19775-1399/08/28,5,15,42810000,2633,3000,2500,-133,-5.05,2854,221,8.39,2500,3000,1399-6-3
774,كمند2,صندوق س. با درآمد ثابت كمند,5,75000000,75000000,10190,1,1,-10189,-99.99,1,-10189,-99.99,1,1,1399-6-3
775,صايپا203,صكوك مرابحه سايپا203-3ماهه 16%,4,41,37764252,936272,921020,923750,-12522,-1.34,921079,-15193,-1.62,921002,923750,1399-6-3
776,تملي701,تسهيلات مسكن ب. ملي-فروردين97,4,150,34320150,217906,228801,228801,10895,5.0,228801,10895,5.0,228801,228801,1399-6-3
777,پست9908-02,پسته فندقي32-30طلاسبززرند9908,4,25,35759998,1450692,1420000,1449999,-693,-0.05,1430400,-20292,-1.4,1420000,1449999,1399-6-3
778,پست9908-08,پسته فندقي32-30زرينمه ولات9908,4,52,71664216,1378569,1378158,1378158,-411,-0.03,1378158,-411,-0.03,1378158,1378158,1399-6-3
779,ثغربح,ح.شركت سرمايه گذاري مسكن شمالغ,4,24300,315900000,5248,13000,13000,7752,147.71,13000,7752,147.71,13000,13000,1399-6-3
780,اخزا819,اسنادخزانه-م19بودجه98-020322,4,376,230904119,607380,612111,630000,22620,3.72,614107,6727,1.11,612111,637738,1399-6-3
781,خعمرا,توسعه و عمران شهرستان نائين,4,20024,277472568,13198,13857,13857,659,4.99,13207,9,0.07,13857,13857,1399-6-3
782,كابگن,توليدي و صنعتي آبگينه‌,4,19523,85354556,4329,4372,4372,43,0.99,4330,1,0.02,4372,4372,1399-6-3
783,ضشنا7056,اختيارخ شپنا-4765-1399/07/28,4,7,145000000,42500,22500,20000,-22500,-52.94,20714,-21786,-51.26,20000,22500,1399-6-3
784,وسالت,بانك قرض الحسنه رسالت,4,5200,22016800,4151,4234,4234,83,2.0,4151,0,0.0,4234,4234,1399-6-3
785,ضملي8082,اختيارخ فملي-39750-1399/08/06,4,7,23996000,1268,2999,4000,2732,215.46,3428,2160,170.35,2999,4000,1399-6-3
786,ضخوز7022,اختيارخ فخوز-29470-1399/07/20,4,10,125000000,16200,12500,12500,-3700,-22.84,12500,-3700,-22.84,12500,12500,1399-6-3
787,اشاد10,مشاركت دولتي10-شرايط خاص001226,4,5000,4725507500,947778,945102,945101,-2677,-0.28,945101,-2677,-0.28,945101,945102,1399-6-3
788,ضخود7068,اختيارخ خودرو-8000-1399/07/09,4,6,4645000,300,1250,777,477,159.0,774,474,158.0,760,777,1399-6-3
789,ضغدر8049,اختيارخ وغدير-24000-1399/08/26,4,9,21400000,1000,2800,1500,500,50.0,2378,1378,137.8,1500,2800,1399-6-3
790,ضجار7020,اختيارخ وتجارت-2400-1399/07/22,4,143,116050000,850,800,950,100,11.76,812,-38,-4.47,800,950,1399-6-3
791,تملي704,تسهيلات مسكن ب. ملي-تير97,4,35,16814875,505710,480425,480425,-25285,-5.0,480425,-25285,-5.0,480425,480425,1399-6-3
792,كساپا,سايپاشيشه‌,4,4057,91485350,23730,22550,22550,-1180,-4.97,23730,0,0.0,22550,22550,1399-6-3
793,ضخوز7021,اختيارخ فخوز-27470-1399/07/20,3,31,433002000,17225,14000,7002,-10223,-59.35,13968,-3257,-18.91,7002,14300,1399-6-3
794,ضفلا8078,اختيارخ فولاد-9775-1399/08/28,3,50,375000000,10800,7500,7500,-3300,-30.56,7500,-3300,-30.56,7500,7500,1399-6-3
795,پرند,صندوق س. پروژه آرمان پرند مپنا,3,262000,1476742500,5650,5655,5655,5,0.09,5636,-14,-0.25,5600,5655,1399-6-3
796,ضفار8029,اختيارخ فارس-7326-1399/08/06,3,15,179009000,12651,12609,11600,-1051,-8.31,11934,-717,-5.67,11600,12609,1399-6-3
797,ضفار8027,اختيارخ فارس-6326-1399/08/06,3,15,207600000,17000,14010,13500,-3500,-20.59,13840,-3160,-18.59,13500,14010,1399-6-3
798,ضغدر8030,اختيارخ وغدير-6510-1399/08/26,3,22,199000000,9973,9000,10000,27,0.27,9045,-928,-9.31,9000,10000,1399-6-3
799,ضفلا8071,اختيارخ فولاد-6275-1399/08/28,3,20,150500000,13750,8000,7500,-6250,-45.45,7525,-6225,-45.27,7500,8000,1399-6-3
800,ضصاد8019,اختيارخ وبصادر-4200-1399/08/11,3,201,56549000,1050,280,549,-501,-47.71,281,-769,-73.24,280,549,1399-6-3
801,ضملي8087,اختيارخ فملي-59750-1399/08/06,3,90,96950000,1080,1099,1050,-30,-2.78,1077,-3,-0.28,1050,1099,1399-6-3
802,ضفلا8083,اختيارخ فولاد-14775-1399/08/28,3,50,240000000,4958,4800,4800,-158,-3.19,4800,-158,-3.19,4800,4800,1399-6-3
803,ضفلا8060,اختيارخ فولاد-3507-1399/08/28,3,18,401993568,13921,12998,14000,79,0.57,13889,-32,-0.23,12998,14000,1399-6-3
804,دمعيار2,صندوق س. توازن معيار-د,3,10600000,10600000,10008,1,1,-10007,-99.99,1,-10007,-99.99,1,1,1399-6-3
805,ضصاد8018,اختيارخ وبصادر-4000-1399/08/11,3,170,78000000,575,500,360,-215,-37.39,459,-116,-20.17,360,500,1399-6-3
806,ضخود7057,اختيارخ خودرو-4000-1399/07/09,3,103,86303000,886,501,880,-6,-0.68,838,-48,-5.42,501,880,1399-6-3
807,ضغدر8040,اختيارخ وغدير-13000-1399/08/26,3,38,215200000,6427,5700,5400,-1027,-15.98,5663,-764,-11.89,5400,5700,1399-6-3
808,صايپا998,صكوك مرابحه سايپا998-3ماهه 18%,3,29,28902800,1004800,994950,994950,-9850,-0.98,996648,-8152,-0.81,994950,1004800,1399-6-3
809,تابا,تابان نيرو سپاهان,3,700,22474200,33098,32106,32106,-992,-3.0,33097,-1,0.0,32106,32106,1399-6-3
810,ضملي8076,اختيارخ فملي -27750-1399/08/06,3,6,43497000,5116,6999,7500,2384,46.6,7249,2133,41.69,6999,7500,1399-6-3
811,صخود412,ص مرابحه خودرو412- 3ماهه 18%,3,61,59613110,973389,975002,998000,24611,2.53,977264,3875,0.4,975002,998000,1399-6-3
812,ضترا8018,اختيارخ شتران-3421-1399/08/11,3,3,81000000,45000,27000,27000,-18000,-40.0,27000,-18000,-40.0,27000,27000,1399-6-3
813,ضخود7039,اختيارخ خودرو-1500-1399/07/09,3,37,93000000,2991,2750,2350,-641,-21.43,2514,-477,-15.95,2350,2750,1399-6-3
814,ضملي8067,اختيارخ فملي -14750-1399/08/06,2,11,176900000,13805,16000,16900,3095,22.42,16082,2277,16.49,16000,16900,1399-6-3
815,ضگل8060,اختيارخ كگل-16100-1399/08/21,2,2,9400000,5900,4700,4700,-1200,-20.34,4700,-1200,-20.34,4700,4700,1399-6-3
816,غگز,گز سكه,2,44273,1571691500,35500,35500,35500,0,0.0,35500,0,0.0,35500,35500,1399-6-3
817,ضگل8061,اختيارخ كگل-17100-1399/08/21,2,30,147000000,5010,4900,4900,-110,-2.2,4900,-110,-2.2,4900,4900,1399-6-3
818,تملي702,تسهيلات مسكن ب. ملي-ارديبهشت97,2,126,31921596,253346,253346,253346,0,0.0,253346,0,0.0,253346,253346,1399-6-3
819,ضبدر8071,اختيارخ شبندر-65580-1399/08/18,2,6,24001000,5357,4001,4000,-1357,-25.33,4000,-1357,-25.33,4000,4001,1399-6-3
820,ضترا8031,اختيارخ شتران-8701-1399/08/11,2,4,60004000,10000,15001,15001,5001,50.01,15001,5001,50.01,15001,15001,1399-6-3
821,صمسكن912,ص دين مسكن جنوب-ماهانه16درصد,2,354,63187728,187512,178162,190000,2488,1.33,178496,-9016,-4.81,178162,190000,1399-6-3
822,آگاس2,صندوق س.هستي بخش آگاه-س,2,1000000,1000000,292696,1,1,-292695,-100.0,1,-292695,-100.0,1,1,1399-6-3
823,ضملي8079,اختيارخ فملي-33750-1399/08/06,2,13,56000000,3300,4100,5000,1700,51.52,4308,1008,30.55,4100,5000,1399-6-3
824,ضملي8080,اختيارخ فملي-35750-1399/08/06,2,13,41606000,3000,3202,3200,200,6.67,3200,200,6.67,3200,3202,1399-6-3
825,تملي705,تسهيلات مسكن ب. ملي-مرداد97,2,37,5104304,142328,137635,149444,7116,5.0,137954,-4374,-3.07,137635,149444,1399-6-3
826,ضصاد8002,اختيارخ وبصادر-1400-1399/08/11,2,2,1702000,1,2,1700,1699,169900.0,851,850,85000.0,2,1700,1399-6-3
827,ضترا8035,اختيارخ شتران-11046-1399/08/11,2,6,66100000,32333,11000,11100,-21233,-65.67,11017,-21316,-65.93,11000,11100,1399-6-3
828,ضچاد7014,اختيارخ كچاد-11300-1399/07/07,2,2,12000000,6900,6000,6000,-900,-13.04,6000,-900,-13.04,6000,6000,1399-6-3
829,تملي801,تسهيلات مسكن ب. ملي-فروردين98,2,15,2399370,152341,159958,159958,7617,5.0,159958,7617,5.0,159958,159958,1399-6-3
830,اشاد1,مشاركت دولتي1-شرايط خاص001026,2,50000,49050000000,981000,981000,981000,0,0.0,981000,0,0.0,981000,981000,1399-6-3
831,رايان911,مشاركت رايان سايپا-3ماهه18%,2,3001,3001000000,1000000,1000000,1000000,0,0.0,1000000,0,0.0,1000000,1000000,1399-6-3
832,تملي710,تسهيلات مسكن ب. ملي-دي97,2,35,7223370,196555,206382,206382,9827,5.0,206382,9827,5.0,206382,206382,1399-6-3
833,ضچاد7012,اختيارخ كچاد-9300-1399/07/07,2,6,23900000,7889,4000,3900,-3989,-50.56,3983,-3906,-49.51,3900,4000,1399-6-3
834,ضبدر8056,اختيارخ شبندر-21580-1399/08/18,2,8,160000000,20125,20000,20000,-125,-0.62,20000,-125,-0.62,20000,20000,1399-6-3
835,سپرمي,پرميت‌,2,1212,10064448,8473,8304,8304,-169,-1.99,8473,0,0.0,8304,8304,1399-6-3
836,صخود0004,صكوك رهني خودرو0004- 3ماهه 16%,2,5,4850000,970000,970000,970000,0,0.0,970000,0,0.0,970000,970000,1399-6-3
837,ضخود7055,اختيارخ خودرو-3600-1399/07/09,2,4,3920000,888,980,980,92,10.36,980,92,10.36,980,980,1399-6-3
838,طفلا8060,اختيارف فولاد-3507-1399/08/28,2,2,321600,624,100,100,-524,-83.97,100,-524,-83.97,100,100,1399-6-3
839,ضترا8017,اختيارخ شتران-3126-1399/08/11,2,2,55000000,1,27500,27500,27499,2749900.0,27500,27499,2749900.0,27500,27500,1399-6-3
840,ضفلا8090,اختيارخ فولاد-23775-1399/08/28,2,20,59900000,4562,3000,2990,-1572,-34.46,2995,-1567,-34.35,2990,3000,1399-6-3
841,ضملي8069,اختيارخ فملي -16750-1399/08/06,2,11,157000000,15000,14000,15000,0,0.0,14273,-727,-4.85,14000,15000,1399-6-3
842,ضغدر8042,اختيارخ وغدير-15000-1399/08/26,1,4,19200000,6750,4800,4800,-1950,-28.89,4800,-1950,-28.89,4800,4800,1399-6-3
843,ضپيك7024,اختيارخ تاپيكو-11370-99/07/20,1,50,360000000,1,7200,7200,7199,719900.0,7200,7199,719900.0,7200,7200,1399-6-3
844,اخزا7184,اسنادخزانه-م18بودجه97-000525,1,2,1695720,866970,847860,847860,-19110,-2.2,847860,-19110,-2.2,847860,847860,1399-6-3
845,ضفار8036,اختيارخ فارس-11826-1399/08/06,1,1,11500000,15000,11500,11500,-3500,-23.33,11500,-3500,-23.33,11500,11500,1399-6-3
846,اشاد102,مشاركت دولتي10-شرايط خاص001226,1,12,11112000,947778,926000,926000,-21778,-2.3,926000,-21778,-2.3,926000,926000,1399-6-3
847,ضملي8058,اختيارخ فملي -7750-1399/08/06,1,4,88000000,30000,22000,22000,-8000,-26.67,22000,-8000,-26.67,22000,22000,1399-6-3
848,ضترا8037,اختيارخ شتران-12806-1399/08/11,1,8,104000000,15000,13000,13000,-2000,-13.33,13000,-2000,-13.33,13000,13000,1399-6-3
849,ضپنا7047,اختيارخ رمپنا-48507-1399/07/13,1,1,2500000,1032,2500,2500,1468,142.25,2500,1468,142.25,2500,2500,1399-6-3
850,ضغدر8033,اختيارخ وغدير-8010-1399/08/26,1,1,9500000,10000,9500,9500,-500,-5.0,9500,-500,-5.0,9500,9500,1399-6-3
851,ضشنا7073,اختيارخ شپنا-15837-1399/07/28,1,4,54000000,16934,13500,13500,-3434,-20.28,13500,-3434,-20.28,13500,13500,1399-6-3
852,اشاد2,مشاركت دولتي2-شرايط خاص001227,1,200,174600000,873000,873000,873000,0,0.0,873000,0,0.0,873000,873000,1399-6-3
853,ضخود7058,اختيارخ خودرو-4200-1399/07/09,1,2,1800000,1001,900,900,-101,-10.09,900,-101,-10.09,900,900,1399-6-3
854,تفيرو,مهندسي فيروزا,1,484,9422996,19088,19469,19469,381,2.0,19088,0,0.0,19469,19469,1399-6-3
855,تسه99012,امتياز تسهيلات مسكن فروردين99,1,200,2000,793054,10,10,-793044,-100.0,10,-793044,-100.0,10,10,1399-6-3
856,عفولاد2,اوراق سلف ورق گرم فولاد مباركه,1,96500,52320563000,541934,542182,542182,248,0.05,542182,248,0.05,542182,542182,1399-6-3
857,اخزا720,اسنادخزانه-م20بودجه97-000324,1,10000,8800000000,880000,880000,880000,0,0.0,880000,0,0.0,880000,880000,1399-6-3
858,ضخوز7030,اختيارخ فخوز-51470-1399/07/20,1,1,5000000,4001,5000,5000,999,24.97,5000,999,24.97,5000,5000,1399-6-3
859,اخزا716,اسنادخزانه-م16بودجه97-000407,1,1000,875000000,865000,875000,875000,10000,1.16,875000,10000,1.16,875000,875000,1399-6-3
860,تملي711,تسهيلات مسكن ب. ملي-بهمن97,1,2,431308,205385,215654,215654,10269,5.0,215654,10269,5.0,215654,215654,1399-6-3
861,ضپيك7033,اختيارخ تاپيكو-21370-99/07/20,1,20,56000000,3700,2800,2800,-900,-24.32,2800,-900,-24.32,2800,2800,1399-6-3
862,ضفلا8068,اختيارخ فولاد-4751-1399/08/28,1,3,65124000,11500,13500,13500,2000,17.39,13500,2000,17.39,13500,13500,1399-6-3
863,ضترا8039,اختيارخ شتران-15153-1399/08/11,1,4,36000000,13009,9000,9000,-4009,-30.82,9000,-4009,-30.82,9000,9000,1399-6-3
864,شپديس2,پتروشيمي پرديس,1,2500000,222500000000,90500,89000,89000,-1500,-1.66,89000,-1500,-1.66,89000,89000,1399-6-3
865,تملي612,تسهيلات مسكن بانك ملي-اسفند96,1,1,1074764,1023585,1074764,1074764,51179,5.0,1074764,51179,5.0,1074764,1074764,1399-6-3
866,تملي712,تسهيلات مسكن ب. ملي-اسفند97,1,2,414956,197599,207478,207478,9879,5.0,207478,9879,5.0,207478,207478,1399-6-3
867,واميد2,گروه مديريت سرمايه گذاري اميد,1,4230816,157640204160,38420,37260,37260,-1160,-3.02,37260,-1160,-3.02,37260,37260,1399-6-3
868,ضجار7030,اختيارخ وتجارت-4400-1399/07/22,1,3,1200000,386,400,400,14,3.63,400,14,3.63,400,400,1399-6-3
869,ضخود7041,اختيارخ خودرو-1700-1399/07/09,1,14,32200000,2400,2300,2300,-100,-4.17,2300,-100,-4.17,2300,2300,1399-6-3
870,وصندوق2,سرمايه‌گذاري‌صندوق‌بازنشستگي‌,1,20000000,361000000000,18990,18050,18050,-940,-4.95,18050,-940,-4.95,18050,18050,1399-6-3
871,افران2,صندوق س افرا نماد پايدار-ثابت,1,2300000,2300000,11570,1,1,-11569,-99.99,1,-11569,-99.99,1,1,1399-6-3
872,شستا9912,اجاره تامين اجتماعي-امين991226,1,400000,400000000000,1001538,1000000,1000000,-1538,-0.15,1000000,-1538,-0.15,1000000,1000000,1399-6-3
873,ضجار7026,اختيارخ وتجارت-3600-1399/07/22,1,1,295000,405,295,295,-110,-27.16,295,-110,-27.16,295,295,1399-6-3
874,ضترا8027,اختيارخ شتران-6353-1399/08/11,1,6,120000000,38000,20000,20000,-18000,-47.37,20000,-18000,-47.37,20000,20000,1399-6-3
875,صخود1412,ص مرابحه خودرو1412- 3ماهه 18%,1,5,5025000,1015050,1005000,1005000,-10050,-0.99,1005000,-10050,-0.99,1005000,1005000,1399-6-3
876,ضسپا8016,اختيارخ خساپا-2000-1399/08/26,1,5,12500000,2500,2500,2500,0,0.0,2500,0,0.0,2500,2500,1399-6-3
877,ضفلا8087,اختيارخ فولاد-18775-1399/08/28,1,1,3000000,6661,3000,3000,-3661,-54.96,3000,-3661,-54.96,3000,3000,1399-6-3
878,ضفلا8081,اختيارخ فولاد-12775-1399/08/28,1,22,198000000,9992,9000,9000,-992,-9.93,9000,-992,-9.93,9000,9000,1399-6-3
879,اراد46,مرابحه عام دولت4-ش.خ 0302,1,2000,2000000000,1000000,1000000,1000000,0,0.0,1000000,0,0.0,1000000,1000000,1399-6-3
880,كايتا,ايتالران‌,1,2000,227572000,110472,113786,113786,3314,3.0,110508,36,0.03,113786,113786,1399-6-3
881,آساس2,صندوق س.آسمان آرماني سهام-س,1,100000,100000,164458,1,1,-164457,-100.0,1,-164457,-100.0,1,1,1399-6-3
882,ضشنا7085,اختيارخ شپنا-37311-1399/07/28,1,1,5000000,6000,5000,5000,-1000,-16.67,5000,-1000,-16.67,5000,5000,1399-6-3
883,افاد83,منفعت دولت8-ش.خاص تمدن0205,1,500,347750000,725500,695500,695500,-30000,-4.14,695500,-30000,-4.14,695500,695500,1399-6-3
884,ضغدر8035,اختيارخ وغدير-9000-1399/08/26,1,2,16000000,14833,8000,8000,-6833,-46.07,8000,-6833,-46.07,8000,8000,1399-6-3
885,ضگل8062,اختيارخ كگل-18100-1399/08/21,1,15,72000000,8000,4800,4800,-3200,-40.0,4800,-3200,-40.0,4800,4800,1399-6-3
886,اراد23,مرابحه عام دولت2-ش.خ تمدن0212,1,500,342500000,705000,685000,685000,-20000,-2.84,685000,-20000,-2.84,685000,685000,1399-6-3
