,نماد,نام,تعداد,حجم,ارزش,دیروز,اولین,آخرین معامله - مقدار,آخرین معامله - تغییر,آخرین معامله - درصد,قیمت پایانی - مقدار,قیمت پایانی - تغییر,قیمت پایانی - درصد,کمترین,بیشترین,تاریخ
0,ثبهساز,بهساز كاشانه تهران,276164,622821469,2916859626120,4670,4570,4700,30,0.64,4680,10,0.21,4440,4900,1399-6-29
1,زملارد,كشاورزي و دامپروري ملارد شير,184586,10526991,426877122284,39579,40852,41557,1978,5.0,40551,972,2.46,37601,41557,1399-6-29
2,آريا,پليمر آريا ساسول,177347,29986676,5413828724458,174985,174980,183734,8749,5.0,180541,5556,3.18,166850,183734,1399-6-29
3,بپيوند,برق و انرژي پيوندگستر پارس,158165,39415551,1180453042908,28524,29950,29950,1426,5.0,29949,1425,5.0,29583,29950,1399-6-29
4,فملي,ملي‌ صنايع‌ مس‌ ايران‌,123678,266234377,9881348478240,36990,36900,36450,-540,-1.46,37120,130,0.35,35300,38630,1399-6-29
5,دارا يكم,صندوق واسطه گري مالي يكم-سهام,123429,46103199,10835748908650,245150,238000,227300,-17850,-7.28,235030,-10120,-4.13,222010,249900,1399-6-29
6,امين,تامين سرمايه امين,121624,42309184,632519421070,15660,14880,14880,-780,-4.98,14950,-710,-4.53,14880,15300,1399-6-29
7,سيتا,سرمايه گذاري سيمان تامين,95422,53620327,1128025749810,22060,21000,20960,-1100,-4.99,21040,-1020,-4.62,20960,21600,1399-6-29
8,فولاد,فولاد مباركه اصفهان,78858,441572984,9420821063580,20550,21380,21160,610,2.97,21330,780,3.8,20500,21570,1399-6-29
9,وتجارت,بانك تجارت,68673,1240331005,4408476592400,3590,3590,3480,-110,-3.06,3550,-40,-1.11,3420,3740,1399-6-29
10,رافزا,رايان هم افزا,60011,353331,10587563415,28539,29965,29965,1426,5.0,28827,288,1.01,29965,29965,1399-6-29
11,وبصادر,بانك صادرات ايران,55924,1552914761,6755957672470,4160,4360,4360,200,4.81,4350,190,4.57,4170,4360,1399-6-29
12,خودرو,ايران‌ خودرو,49549,1183742632,3969222876150,3510,3440,3340,-170,-4.84,3350,-160,-4.56,3340,3470,1399-6-29
13,ولپارس,ليزينگ پارسيان,47862,3543134,14314261360,3850,4040,4040,190,4.94,3890,40,1.04,4040,4040,1399-6-29
14,وبملت,بانك ملت,45528,725378618,4401472343550,6350,6110,6040,-310,-4.88,6070,-280,-4.41,6040,6270,1399-6-29
15,شگويا,پتروشيمي تندگويان,40751,165034800,2889411510291,16928,16900,17774,846,5.0,17508,580,3.43,16220,17774,1399-6-29
16,خساپا,سايپا,34856,834226489,2415580325120,3040,2910,2890,-150,-4.93,2900,-140,-4.61,2890,2970,1399-6-29
17,ذوب,سهامي ذوب آهن  اصفهان,33167,283832252,1948250861021,7021,6937,6700,-321,-4.57,6864,-157,-2.24,6670,7230,1399-6-29
18,ثاميد,توسعه و عمران اميد,30540,23359980,54195153600,2210,2320,2320,110,4.98,2320,110,4.98,2320,2320,1399-6-29
19,وغدير,سرمايه‌گذاري‌غدير(هلدينگ‌,30313,168820231,3086337894420,17700,17730,18470,770,4.35,18280,580,3.28,16990,18580,1399-6-29
20,دي,بانك دي,26660,80656245,3747766777363,44868,44800,47111,2243,5.0,46466,1598,3.56,43000,47111,1399-6-29
21,وپارس,بانك‌پارسيان‌,25820,543424722,2737472859210,5290,5030,5030,-260,-4.91,5040,-250,-4.73,5030,5160,1399-6-29
22,چكاپا,گروه صنايع كاغذ پارس,25762,166648451,1953375831910,11350,11350,11350,0,0.0,11720,370,3.26,10900,11910,1399-6-29
23,فارس,صنايع پتروشيمي خليج فارس,23217,64250353,2093635153170,31500,31500,33070,1570,4.98,32590,1090,3.46,30110,33070,1399-6-29
24,فخوز,فولاد  خوزستان,22396,44294132,2340180766580,53040,51500,51450,-1590,-3.0,52830,-210,-0.4,50390,55440,1399-6-29
25,بركت,گروه دارويي بركت,22158,68153557,1283472821150,19710,19440,18730,-980,-4.97,18830,-880,-4.46,18730,19590,1399-6-29
26,شصدفح,ح . صنعتي دوده فام,21378,3215982,60882375946,19592,19000,19270,-322,-1.64,18931,-661,-3.37,18613,19600,1399-6-29
27,شپنا,پالايش نفت اصفهان,20038,92854776,2978354460750,34610,32500,32800,-1810,-5.23,32080,-2530,-7.31,30880,33500,1399-6-29
28,غگيلا,شيرپاستوريزه پگاه گيلان,18732,293724,4721613300,15310,16075,16075,765,5.0,15379,69,0.45,16075,16075,1399-6-29
29,وخارزم,سرمايه گذاري خوارزمي,17743,131499001,1591958429340,11770,11680,12230,460,3.91,12110,340,2.89,11350,12350,1399-6-29
30,شتران,پالايش نفت تهران,15532,54767126,1647984854610,34020,30000,30990,-3030,-8.91,30090,-3930,-11.55,28500,31500,1399-6-29
31,كگل,معدني و صنعتي گل گهر,14517,113815694,2993840892600,25070,26320,26320,1250,4.99,26300,1230,4.91,25600,26320,1399-6-29
32,تاپيكو,س. نفت و گاز و پتروشيمي تأمين,14076,62400660,1266365033610,20820,20010,20060,-760,-3.65,20290,-530,-2.55,19780,21310,1399-6-29
33,غزر,صنعتي زر ماكارون,13839,719457,49930315800,73050,69400,69400,-3650,-5.0,69400,-3650,-5.0,69400,69400,1399-6-29
34,ومعادن,توسعه‌معادن‌وفلزات‌,13617,74214260,1419426181850,18550,18450,19000,450,2.43,19130,580,3.13,17740,19470,1399-6-29
35,بجهرم,توسعه مولد نيروگاهي جهرم,13044,86521233,417059432842,4968,4790,4721,-247,-4.97,4820,-148,-2.98,4720,5069,1399-6-29
36,شبندر,پالايش نفت بندرعباس,12428,40416505,1694694647420,41860,41500,43500,1640,3.92,41930,70,0.17,39430,43570,1399-6-29
37,كچاد,معدني‌وصنعتي‌چادرملو,10914,74215422,1602469268190,20630,21590,21660,1030,4.99,21590,960,4.65,20810,21660,1399-6-29
38,ونوين,بانك‌اقتصادنوين‌,9973,146692622,649308299150,4420,4300,4470,50,1.13,4430,10,0.23,4200,4600,1399-6-29
39,شصدف,صنعتي دوده فام,9295,263015,5225845035,18923,19869,19869,946,5.0,19017,94,0.5,19869,19869,1399-6-29
40,فروي,ذوب روي اصفهان,8609,5767525,363726827571,61256,61449,62200,944,1.54,63065,1809,2.95,58300,64318,1399-6-29
41,تملت,تامين سرمايه بانك ملت,8434,19234207,250038267910,13640,12970,12960,-680,-4.99,13000,-640,-4.69,12960,13340,1399-6-29
42,وبانك,سرمايه گذاري گروه توسعه ملي,8392,31154258,639763243930,20050,20370,20200,150,0.75,20540,490,2.44,19100,21050,1399-6-29
43,دماوند,توليد نيروي برق دماوند,8318,9106812,598756133784,67940,64850,64543,-3397,-5.0,65748,-2192,-3.23,64543,69331,1399-6-29
44,وگردش,بانك گردشگري,8241,236244325,4755178501479,19756,19800,20348,592,3.0,20128,372,1.88,19164,20348,1399-6-29
45,زكوثر,سرمايه گذاري كشاورزي كوثر,7491,7236391,162771714520,23340,22190,22180,-1160,-4.97,22490,-850,-3.64,22180,23690,1399-6-29
46,ختوقا,قطعات‌ اتومبيل‌ ايران‌,7332,69833949,304120809720,4540,4440,4320,-220,-4.85,4350,-190,-4.19,4320,4520,1399-6-29
47,كاما,باما,7243,3599273,652064543970,185360,176400,177000,-8360,-4.51,181170,-4190,-2.26,176100,191980,1399-6-29
48,نوري,پتروشيمي نوري,7218,3520618,680551018660,193490,192000,191300,-2190,-1.13,193300,-190,-0.1,185100,199600,1399-6-29
49,شپديس,پتروشيمي پرديس,7186,7984358,1011251097190,122290,123000,126800,4510,3.69,126650,4360,3.57,116190,128400,1399-6-29
50,كدماح,ح . معدني‌ دماوند,7100,6478361,657644423400,108570,104000,97710,-10860,-10.0,101510,-7060,-6.5,97710,108060,1399-6-29
51,آگاس,صندوق س.هستي بخش آگاه-س,6814,7875038,636342111129,82176,80100,80100,-2076,-2.53,80805,-1371,-1.67,77200,82900,1399-6-29
52,ومهان,گروه توسعه مالي مهر آيندگان,6651,32289400,632721062407,18772,18900,19560,788,4.2,19595,823,4.38,18100,19710,1399-6-29
53,اخابر,مخابرات ايران,6414,26672729,564915414000,22050,20950,20950,-1100,-4.99,21180,-870,-3.95,20950,21900,1399-6-29
54,پارسان,گسترش نفت و گاز پارسيان,6411,27150619,822309715850,28960,30400,30400,1440,4.97,30290,1330,4.59,29100,30400,1399-6-29
55,وپاسار,بانك  پاسارگاد,6306,51982669,582814915480,11250,11280,11390,140,1.24,11210,-40,-0.36,10690,11500,1399-6-29
56,غسالم,سالمين‌,5838,25106108,136016986640,5660,5620,5380,-280,-4.95,5420,-240,-4.24,5380,5730,1399-6-29
57,ضخود7057,اختيارخ خودرو-4000-1399/07/09,5327,269914,7087607000,15,50,33,18,120.0,26,11,73.33,10,95,1399-6-29
58,شيران,س. صنايع‌شيميايي‌ايران,5273,9689024,340092716150,36240,35900,34430,-1810,-4.99,35100,-1140,-3.15,34430,36750,1399-6-29
59,ارزش,صندوق س ارزش آفرين بيدار-سهام,5207,23556843,290482977680,12320,11700,12200,-120,-0.97,12330,10,0.08,11450,12700,1399-6-29
60,خكرمان,گروه اقتصادي كرمان خودرو,5162,76665819,558113178486,7227,7299,7443,216,2.99,7280,53,0.73,7011,7443,1399-6-29
61,شلرد,كود شيميايي اوره لردگان,5058,32737136,418782950435,13172,12790,12777,-395,-3.0,12792,-380,-2.88,12777,13020,1399-6-29
62,هرمز,فولاد هرمزگان جنوب,5008,34833006,506246396180,13942,14500,14639,697,5.0,14534,592,4.25,13942,14639,1399-6-29
63,وتوس,توسعه‌شهري‌توس‌گستر,4923,19936315,565005160630,29720,28240,28240,-1480,-4.98,28340,-1380,-4.64,28240,30000,1399-6-29
64,وسپه,سرمايه‌گذاري‌ سپه‌,4587,12925748,236171256350,18570,18000,17800,-770,-4.15,18270,-300,-1.62,17650,19290,1399-6-29
65,ختور,رادياتور ايران‌,4575,8808430,353671103420,38570,36680,40490,1920,4.98,40150,1580,4.1,36680,40490,1399-6-29
66,ونفت,سرمايه‌گذاري‌ صنعت‌ نفت‌,4474,23025756,353220238300,14930,15000,15500,570,3.82,15340,410,2.75,14280,15670,1399-6-29
67,وصنعت,سرمايه گذاري توسعه صنعت وتجارت,4376,19320079,200598498090,10830,10580,10290,-540,-4.99,10380,-450,-4.16,10290,10690,1399-6-29
68,سمگا,گروه سرمايه گذاري ميراث فرهنگي,4279,44745413,838147385967,19025,18690,18074,-951,-5.0,18731,-294,-1.55,18074,19050,1399-6-29
69,كمند,صندوق س. با درآمد ثابت كمند,4056,186316779,1881122834390,10070,10090,10090,20,0.2,10100,30,0.3,10080,10110,1399-6-29
70,كالا,بورس كالاي ايران,3977,16883023,841922764830,47500,49870,49870,2370,4.99,49870,2370,4.99,49080,49870,1399-6-29
71,قرن,پديده شيمي قرن,3955,2545826,143619192110,58990,58010,56050,-2940,-4.98,56410,-2580,-4.37,56050,58980,1399-6-29
72,پترول,گروه پتروشيمي س. ايرانيان,3879,25447690,365937782200,13700,14380,14380,680,4.96,14380,680,4.96,14380,14380,1399-6-29
73,تاصيكو,سرمايه گذاري صدرتامين,3824,30364008,416553447410,13470,13360,13000,-470,-3.49,13720,250,1.86,12800,14140,1399-6-29
74,شبريز,پالايش نفت تبريز,3820,7539191,304970418460,43300,41000,41200,-2100,-4.85,40450,-2850,-6.58,38950,43050,1399-6-29
75,وخاور,بانك خاورميانه,3747,49185124,556182003420,11810,11220,11220,-590,-5.0,11310,-500,-4.23,11220,11860,1399-6-29
76,سفارس,سيمان فارس و خوزستان,3672,15675406,289843245560,18580,18010,17770,-810,-4.36,18490,-90,-0.48,17700,19360,1399-6-29
77,حفاري,حفاري شمال,3667,21727566,272797555280,13210,12550,12550,-660,-5.0,12560,-650,-4.92,12550,12750,1399-6-29
78,وملل,اعتباري ملل,3615,25318211,383740595847,15696,15000,14912,-784,-4.99,15157,-539,-3.43,14912,15670,1399-6-29
79,دتوليد,داروسازي توليد دارو,3589,7471278,309561419973,39654,41636,41636,1982,5.0,41434,1780,4.49,39931,41636,1399-6-29
80,بپاس,بيمه پاسارگاد,3551,5727778,322231292050,54093,56797,56797,2704,5.0,56258,2165,4.0,54550,56797,1399-6-29
81,شسپا,نفت سپاهان,3550,8199140,186842892990,23100,22090,22600,-500,-2.16,22790,-310,-1.34,22000,23700,1399-6-29
82,شاراك,پتروشيمي شازند,3510,11310436,315575611770,27660,28000,27700,40,0.14,27900,240,0.87,26320,28990,1399-6-29
83,ثاخت,بين‌المللي‌توسعه‌ساختمان,3478,23993351,121398726870,5290,5150,5030,-260,-4.91,5060,-230,-4.35,5030,5380,1399-6-29
84,والبر,سرمايه‌ گذاري‌ البرز(هلدينگ‌,3396,8640270,177963925000,19920,20200,20850,930,4.67,20600,680,3.41,19000,20910,1399-6-29
85,فاسمين,كالسيمين‌,3369,4582801,270497582360,58820,59440,58290,-530,-0.9,59020,200,0.34,55880,61290,1399-6-29
86,ختورح,ح . رادياتور ايران‌,3354,6291512,187746824110,28540,28890,29650,1110,3.89,29840,1300,4.56,26000,31300,1399-6-29
87,وهور,مديريت انرژي اميد  تابان هور,3347,11761009,509760425776,43613,43613,44600,987,2.26,43343,-270,-0.62,41433,45000,1399-6-29
88,كويرح,ح. توليدي فولاد سپيد فراب كوير,3324,14137345,165823712820,12730,11980,11460,-1270,-9.98,11730,-1000,-7.86,11460,12290,1399-6-29
89,كرماشا,صنايع پتروشيمي كرمانشاه,3260,9908170,489088414990,48200,47900,48800,600,1.24,49360,1160,2.41,45790,50610,1399-6-29
90,آوا,صندوق س.سهام آواي معيار-س,3221,13501781,145860516545,11168,10700,10533,-635,-5.69,10803,-365,-3.27,10100,11403,1399-6-29
91,كحافظ,كاشي‌ وسراميك‌ حافظ‌,3211,9457623,150025807820,15330,15800,15800,470,3.07,15860,530,3.46,14700,16090,1399-6-29
92,خبهمن,گروه‌بهمن‌,3172,22566615,592479220560,27570,26740,26200,-1370,-4.97,26250,-1320,-4.79,26200,26900,1399-6-29
93,جم,پتروشيمي جم,3149,8516713,427938546360,48690,48500,50000,1310,2.69,50250,1560,3.2,46290,51120,1399-6-29
94,پاكشو,گروه صنعتي پاكشو,3093,7847709,596512838960,72890,75000,76530,3640,4.99,76010,3120,4.28,74020,76530,1399-6-29
95,پترولح,ح . گروه پتروشيمي س. ايرانيان,3084,9561351,125731765650,11950,13150,13150,1200,10.04,13150,1200,10.04,13150,13150,1399-6-29
96,افق,فروشگاههاي زنجيره اي افق كوروش,3079,2339676,164129638550,73490,71000,70050,-3440,-4.68,70150,-3340,-4.54,69820,73490,1399-6-29
97,كلر,كلر پارس,3060,838509,60045108729,73452,72990,69911,-3541,-4.82,71609,-1843,-2.51,69780,74120,1399-6-29
98,سرو,صندوق س سروسودمند مدبران-سهام,2971,2712130,191729744340,71820,68500,70300,-1520,-2.12,70690,-1130,-1.57,67620,72980,1399-6-29
99,بكهنوج,توليد برق ماهتاب كهنوج,2894,2259087,168239259188,75471,77490,71698,-3773,-5.0,74472,-999,-1.32,71698,77490,1399-6-29
100,چكارن,كارتن‌ ايران‌,2848,16776133,80318856440,5030,4780,4780,-250,-4.97,4790,-240,-4.77,4780,4910,1399-6-29
101,واحيا,م .صنايع و معادن احياء سپاهان,2828,8907569,2193523159599,235956,247753,247000,11044,4.68,246254,10298,4.36,235962,247753,1399-6-29
102,ونيكي,سرمايه‌گذاري‌ ملي‌ايران‌,2792,5024795,204551903420,42520,42000,40400,-2120,-4.99,40710,-1810,-4.26,40400,42000,1399-6-29
103,قثابت,قند ثابت‌ خراسان‌,2769,2491738,243148481930,99700,100000,94720,-4980,-4.99,97580,-2120,-2.13,94720,102490,1399-6-29
104,وصندوق,سرمايه‌گذاري‌صندوق‌بازنشستگي‌,2716,16459625,304514771230,18850,17950,18290,-560,-2.97,18500,-350,-1.86,17910,19400,1399-6-29
105,فباهنر,مس‌ شهيدباهنر,2712,3615147,241266807380,68070,69000,64700,-3370,-4.95,66740,-1330,-1.95,64670,69000,1399-6-29
106,فروس,فروسيليس‌ ايران‌,2663,5412650,130539393240,23300,22700,24460,1160,4.98,24120,820,3.52,22160,24460,1399-6-29
107,طلا,صندوق س.پشتوانه طلاي لوتوس,2630,1683985,187272714886,118090,112341,110000,-8090,-6.85,111208,-6882,-5.83,107000,113000,1399-6-29
108,سيمرغ,سيمرغ,2616,7141089,134154485820,19630,19400,18700,-930,-4.74,18790,-840,-4.28,18650,19800,1399-6-29
109,رنيك,جنرال مكانيك,2615,5603094,156748577248,27422,28000,26980,-442,-1.61,27975,553,2.02,26150,28793,1399-6-29
110,وسينا,بانك سينا,2609,23993200,304194432340,13330,12800,12670,-660,-4.95,12680,-650,-4.88,12670,12990,1399-6-29
111,وسبحان,سرمايه گذاري سبحان,2562,16260496,158727296229,10085,9750,9659,-426,-4.22,9762,-323,-3.2,9581,10257,1399-6-29
112,كنور,توسعه معدني و صنعتي صبانور,2528,4828090,246453308060,49410,49410,50440,1030,2.08,51050,1640,3.32,47050,51880,1399-6-29
113,آسيا,بيمه آسيا,2520,5178734,143373378810,28750,28730,27410,-1340,-4.66,27690,-1060,-3.69,27320,29000,1399-6-29
114,پارس,پتروشيمي پارس,2500,1850912,318759004710,171560,163000,172300,740,0.43,172220,660,0.38,162990,180000,1399-6-29
115,غپينو,پارس‌ مينو,2489,19218126,120910215540,6610,6280,6280,-330,-4.99,6290,-320,-4.84,6280,6500,1399-6-29
116,حريل,ريل پردازسير,2487,19929850,91078889632,4792,4600,4553,-239,-4.99,4570,-222,-4.63,4553,4700,1399-6-29
117,خگستر,گسترش‌سرمايه‌گذاري‌ايران‌خودرو,2477,13302308,75424086360,5960,5670,5670,-290,-4.87,5720,-240,-4.03,5670,5670,1399-6-29
118,كهمدا,شيشه‌ همدان‌,2458,3993606,116606407050,28710,28690,29010,300,1.04,29200,490,1.71,27280,30140,1399-6-29
119,دزهراوي,داروسازي‌زهراوي‌,2444,6263960,82431261580,13800,13210,13110,-690,-5.0,13160,-640,-4.64,13110,13570,1399-6-29
120,فرآور,فرآوري‌موادمعدني‌ايران‌,2429,7945579,218595503520,26350,26980,27660,1310,4.97,27510,1160,4.4,25100,27660,1399-6-29
121,وتوكاح,ح . ‌توكافولاد(هلدينگ‌,2425,12873153,129523503588,10161,9900,9710,-451,-4.44,10062,-99,-0.97,9200,10680,1399-6-29
122,فجر,فولاد اميركبيركاشان,2414,8918887,570599239400,61590,63900,63200,1610,2.61,63980,2390,3.88,59000,64660,1399-6-29
123,وبشهر,توسعه‌ صنايع‌ بهشهر(هلدينگ,2397,11993265,207775867070,17440,17800,17430,-10,-0.06,17320,-120,-0.69,16570,18310,1399-6-29
124,امين يكم,صندوق درآمد ثابت امين يكم فردا,2370,83115088,872701429930,10420,10470,10490,70,0.67,10500,80,0.77,10470,10530,1399-6-29
125,وسكاب,س.ص.بازنشستگي كاركنان بانكها,2369,23708124,178936127320,7630,7430,7550,-80,-1.05,7550,-80,-1.05,7250,7800,1399-6-29
126,وآيند,بانك  آينده,2267,31226661,886993305705,27849,28405,28405,556,2.0,28405,556,2.0,28405,28405,1399-6-29
127,وزمين,بانك ايران زمين,2255,36054556,667605084216,18835,18520,18459,-376,-2.0,18517,-318,-1.69,18459,19200,1399-6-29
128,كگازح,ح . شيشه‌ و گاز,2242,6867411,131975084960,19520,19580,18070,-1450,-7.43,19220,-300,-1.54,17800,20700,1399-6-29
129,كبافق,معادن‌ بافق‌,2237,2397400,82689877660,36010,34210,34210,-1800,-5.0,34490,-1520,-4.22,34210,35900,1399-6-29
130,سرچشمه,سرمايه گذاري مس سرچشمه,2237,19745713,211784990165,10240,10650,10752,512,5.0,10726,486,4.75,10351,10752,1399-6-29
131,همراه,شركت ارتباطات سيار ايران,2237,4067419,181394602720,46300,44300,43990,-2310,-4.99,44600,-1700,-3.67,43990,46000,1399-6-29
132,ستران,سيمان‌ تهران‌,2230,3391624,136297429010,42190,40090,40090,-2100,-4.98,40190,-2000,-4.74,40090,41210,1399-6-29
133,تاصيكوح,ح . سرمايه گذاري صدرتامين,2217,13548699,154754356000,11530,10670,11300,-230,-1.99,11420,-110,-0.95,10380,11910,1399-6-29
134,عيار,صندوق س. پشتوانه طلاي مفيد,2210,2675521,101997178011,41644,39200,37519,-4125,-9.91,38122,-3522,-8.46,37495,39856,1399-6-29
135,رانفور,خدمات‌انفورماتيك‌,2203,4353710,135037309720,31040,31750,30300,-740,-2.38,31020,-20,-0.06,29900,32200,1399-6-29
136,ياقوت,صندوق س ياقوت آگاه-ثابت,2200,104913773,1160847180410,11020,11030,11060,40,0.36,11060,40,0.36,11030,11090,1399-6-29
137,غصينو,صنعتي مينو,2191,6289877,201491151028,32009,32969,31049,-960,-3.0,32034,25,0.08,31049,32969,1399-6-29
138,وتوكا,سرمايه‌گذاري‌توكافولاد(هلدينگ,2182,16500045,206553800820,12040,12300,12500,460,3.82,12520,480,3.99,11600,12640,1399-6-29
139,ريشمك,توليد و صادرات ريشمك,2166,7792562,321551826511,39695,41300,41679,1984,5.0,41264,1569,3.95,38077,41679,1399-6-29
140,كگهر,سنگ آهن گهرزمين,2134,4520185,232143836894,49351,51700,50999,1648,3.34,51357,2006,4.06,48000,51818,1399-6-29
141,فولاژ,فولاد آلياژي ايران,2096,3588767,109099378050,29400,29900,30450,1050,3.57,30400,1000,3.4,28010,30870,1399-6-29
142,خپارس,پارس‌ خودرو,2053,11215583,111595050850,10470,9950,9950,-520,-4.97,9950,-520,-4.97,9950,9950,1399-6-29
143,شيراز,پتروشيمي‌شيراز,2028,4995539,368407252110,71090,71900,73750,2660,3.74,73750,2660,3.74,71090,74640,1399-6-29
144,اتكام,شركت بيمه اتكايي امين,2011,10031510,74936976792,7548,7171,7850,302,4.0,7470,-78,-1.03,7171,7870,1399-6-29
145,وساخت,سرمايه‌ گذاري‌ ساختمان‌ايران‌,1944,4644121,209928253990,47530,45160,45160,-2370,-4.99,45200,-2330,-4.9,45160,46000,1399-6-29
146,ماديرا,صنايع ماشين هاي اداري ايران,1942,4036686,156235029935,40739,38703,38703,-2036,-5.0,38704,-2035,-5.0,38703,39000,1399-6-29
147,تنوين,تامين سرمايه نوين,1929,14986764,173830651100,12160,11700,11560,-600,-4.93,11600,-560,-4.61,11560,11900,1399-6-29
148,وبيمه,سرمايه‌ گذاري‌ صنعت‌ بيمه‌,1926,14656460,56986086680,4060,4010,3860,-200,-4.93,3890,-170,-4.19,3860,4070,1399-6-29
149,انرژي3,سايراشخاص بورس انرژي,1895,348457,146101050960,441340,419280,419280,-22060,-5.0,419280,-22060,-5.0,419280,419280,1399-6-29
150,واميد,گروه مديريت سرمايه گذاري اميد,1887,6616552,292987298450,45050,43000,45090,40,0.09,44280,-770,-1.71,42800,46000,1399-6-29
151,وتوسم,سرمايه‌گذاري‌توسعه‌ملي‌,1845,7082115,101212928980,13860,13860,13960,100,0.72,14290,430,3.1,13250,14550,1399-6-29
152,وپترو,سرمايه‌گذاري صنايع پتروشيمي‌,1838,8016734,143706079450,17240,17780,18100,860,4.99,17930,690,4.0,16510,18100,1399-6-29
153,كروي,توسعه‌ معادن‌ روي‌ ايران‌,1809,3718543,150472496270,42230,40120,40120,-2110,-5.0,40470,-1760,-4.17,40120,44240,1399-6-29
154,ميدكو,هلدينگ صنايع  معدني خاورميانه,1809,16814821,373471901364,22202,22410,22390,188,0.85,22211,9,0.04,21521,22410,1399-6-29
155,اعتماد,صندوق س.اعتماد آفرين پارسيان-د,1804,59721450,1936172014120,32371,32419,32420,49,0.15,32420,49,0.15,32419,32443,1399-6-29
156,شبهرن,نفت‌ بهران‌,1758,2119829,146428545490,72260,68650,68700,-3560,-4.93,69080,-3180,-4.4,68650,71100,1399-6-29
157,مارون,پتروشيمي مارون,1752,1226099,171266336135,140983,143000,136500,-4483,-3.18,139684,-1299,-0.92,133934,147000,1399-6-29
158,دانا,بيمه دانا,1749,9655362,75172815610,8150,8000,7750,-400,-4.91,7790,-360,-4.42,7750,8000,1399-6-29
159,آتيمس,صندوق س.آرمان آتيه درخشان مس-س,1737,602020,149779381596,255115,255500,246050,-9065,-3.55,248795,-6320,-2.48,243002,256000,1399-6-29
160,پرديس,سرمايه گذاري پرديس,1721,9367090,82763333870,9180,8990,8730,-450,-4.9,8840,-340,-3.7,8730,9270,1399-6-29
161,افقح,ح .فروشگاه زنجيره اي افق كوروش,1718,2669876,173689696800,67400,63060,63500,-3900,-5.79,65060,-2340,-3.47,62000,67600,1399-6-29
162,تيپيكو,سرمايه گذاري دارويي تامين,1717,5496941,318547060610,55250,58010,58010,2760,5.0,57950,2700,4.89,55920,58010,1399-6-29
163,وبوعلي,سرمايه‌گذاري‌بوعلي‌,1713,14668893,146231193120,9500,9970,9970,470,4.95,9970,470,4.95,9780,9970,1399-6-29
164,غويتا,ويتانا,1712,6151335,445421320352,69778,67000,71160,1382,1.98,72411,2633,3.77,66320,73200,1399-6-29
165,شرانل,نفت ايرانول,1708,4710015,139334514434,28296,29710,28990,694,2.45,29583,1287,4.55,28510,29710,1399-6-29
166,كوير,توليدي فولاد سپيد فراب كوير,1700,4651947,68481490620,15360,15330,14600,-760,-4.95,14720,-640,-4.17,14600,15330,1399-6-29
167,پارند,صندوق س. پارند پايدار سپهر,1649,65567337,763182173500,11700,11710,11710,10,0.09,11640,-60,-0.51,11600,11740,1399-6-29
168,فزرين,زرين معدن آسيا,1648,6030682,133485854989,21175,21520,22233,1058,5.0,22134,959,4.53,21200,22233,1399-6-29
169,رمپنا,گروه مپنا (سهامي عام),1596,9533490,293645237970,32280,31000,30670,-1610,-4.99,30800,-1480,-4.58,30670,32260,1399-6-29
170,ودي,بيمه  دي,1560,12098934,276682630493,23536,24290,22360,-1176,-5.0,22868,-668,-2.84,22360,24590,1399-6-29
171,تسه9905,امتياز تسهيلات مسكن مرداد99,1558,38976,31241894478,783553,822730,793000,9447,1.21,801567,18014,2.3,785000,822730,1399-6-29
172,سپ,پرداخت الكترونيك سامان كيش,1539,2698788,62008043610,23980,22950,22900,-1080,-4.5,22980,-1000,-4.17,22790,23970,1399-6-29
173,غگل,گلوكوزان‌,1507,8636388,53200150080,6480,6160,6160,-320,-4.94,6160,-320,-4.94,6160,6160,1399-6-29
174,گوهران,سرمايه گذاري توسعه گوهران اميد,1503,6380938,70492771129,10894,10910,10870,-24,-0.22,11047,153,1.4,10360,11380,1399-6-29
175,اطلس,صندوق س.توسعه اندوخته آينده-س,1499,536384,114676371225,215111,209000,211000,-4111,-1.91,213795,-1316,-0.61,208000,219494,1399-6-29
176,ثاصفا,شركت‌ ساختمان‌ اصفهان‌,1484,3403777,89881822287,25858,26633,26633,775,3.0,26406,548,2.12,25083,26633,1399-6-29
177,خراسان,پتروشيمي خراسان,1466,2433250,234547720660,93010,97000,94650,1640,1.76,96390,3380,3.63,90010,97660,1399-6-29
178,شكلر,نيروكلر,1460,2322821,111086408780,49640,49990,47500,-2140,-4.31,47820,-1820,-3.67,47500,49990,1399-6-29
179,شپاكسا,پاكسان‌,1438,3803962,111473394190,30670,29280,29140,-1530,-4.99,29300,-1370,-4.47,29140,30270,1399-6-29
180,آ س پ,آ.س.پ,1435,4432341,70936657832,16159,16733,15352,-807,-4.99,16004,-155,-0.96,15352,16733,1399-6-29
181,شاوان,پالايش نفت لاوان,1428,1286030,171677736908,140381,133362,133362,-7019,-5.0,133494,-6887,-4.91,133362,137000,1399-6-29
182,تماوند,تامين سرمايه دماوند,1419,23522148,297837437976,13053,12662,12662,-391,-3.0,12662,-391,-3.0,12662,12662,1399-6-29
183,فسازان,غلتك سازان سپاهان,1411,2144686,92671882060,41160,43210,43210,2050,4.98,43210,2050,4.98,43210,43210,1399-6-29
184,توريل,توکاريل,1388,4175365,70268199933,17553,17700,16676,-877,-5.0,16829,-724,-4.12,16676,17700,1399-6-29
185,كرازي,كارخانجات‌توليدي‌شيشه‌رازي‌,1369,4131533,74178815430,18890,17950,17950,-940,-4.98,17950,-940,-4.98,17950,18300,1399-6-29
186,فيروزه,صندوق شاخص30 شركت فيروزه- سهام,1368,1233830,266433526960,217290,206510,212480,-4810,-2.21,215940,-1350,-0.62,206500,221000,1399-6-29
187,كيان,صندوق س. با درآمد ثابت كيان,1346,58873431,1490181257940,25290,25290,25310,20,0.08,25310,20,0.08,25240,25360,1399-6-29
188,پكرمان,گروه‌ صنعتي‌ بارز,1327,5748240,121504934570,22030,21900,21070,-960,-4.36,21140,-890,-4.04,20930,22030,1399-6-29
189,جم پيلن,پلي پروپيلن جم - جم پيلن,1309,1233155,113493035530,94050,89360,92090,-1960,-2.08,92030,-2020,-2.15,89350,95100,1399-6-29
190,بزاگرسح,ح . نيروگاه زاگرس كوثر,1308,9890412,83847899878,8904,8470,8459,-445,-5.0,8478,-426,-4.78,8459,9050,1399-6-29
191,وپست,پست بانك ايران,1307,8548440,98354834990,11930,11440,11340,-590,-4.95,11510,-420,-3.52,11340,11900,1399-6-29
192,شوينده,مديريت صنعت شوينده ت.ص.بهشهر,1289,3515414,141740877960,39650,38500,39560,-90,-0.23,40320,670,1.69,37670,41470,1399-6-29
193,نطرين,عطرين نخ قم,1271,3103942,56859921586,19072,18710,18119,-953,-5.0,18319,-753,-3.95,18119,19500,1399-6-29
194,چدن,توليدي چدن سازان,1269,3286687,93282512220,29700,28290,28220,-1480,-4.98,28380,-1320,-4.44,28220,29700,1399-6-29
195,تسه9904,امتياز تسهيلات مسكن تير99,1265,26590,21220461616,833835,805222,800000,-33835,-4.06,798062,-35773,-4.29,792144,819999,1399-6-29
196,مبين,مبين انرژي خليج فارس,1236,4963137,138175986170,28770,27880,27510,-1260,-4.38,27840,-930,-3.23,27340,29490,1399-6-29
197,ثمسكن,سرمايه‌گذاري‌ مسكن‌,1234,10393835,79000504930,7990,7600,7600,-390,-4.88,7600,-390,-4.88,7600,7820,1399-6-29
198,كيميا,معدني كيمياي زنجان گستران,1225,2049367,60217076152,30034,29454,28533,-1501,-5.0,29383,-651,-2.17,28533,31535,1399-6-29
199,فايرا,آلومينيوم‌ايران‌,1222,3095045,60916444870,19750,19750,19100,-650,-3.29,19680,-70,-0.35,18770,20440,1399-6-29
200,واتي,سرمايه‌ گذاري‌ آتيه‌ دماوند,1220,12792640,173850767220,14140,13440,13740,-400,-2.83,13590,-550,-3.89,13440,14000,1399-6-29
201,فخاسح,ح . فولاد خراسان,1216,1728422,56818847740,34810,32010,32000,-2810,-8.07,32870,-1940,-5.57,31350,34790,1399-6-29
202,دتوزيع,توزيع دارو پخش,1215,760075,39942914422,55039,52288,52288,-2751,-5.0,52958,-2081,-3.78,52288,53990,1399-6-29
203,ارفع,شركت آهن و فولاد ارفع,1191,3571160,66091458120,17626,18507,18507,881,5.0,18281,655,3.72,18507,18507,1399-6-29
204,كاردان,صندوق س تجارت شاخصي كاردان,1169,498201,106423700770,218100,214780,210030,-8070,-3.7,213620,-4480,-2.05,204200,221000,1399-6-29
205,وصنا,گروه‌صنايع‌بهشهرايران‌,1169,4782347,50760906030,11150,10630,10600,-550,-4.93,10610,-540,-4.84,10600,10980,1399-6-29
206,سيدكو,سرمايه گذاري توسعه صنايع سيمان,1140,4369910,34562920520,8160,8200,7760,-400,-4.9,7980,-180,-2.21,7760,8200,1399-6-29
207,شپاس,نفت پاسارگاد,1136,4133093,97966945910,24535,23309,23315,-1220,-4.97,23703,-832,-3.39,23309,25480,1399-6-29
208,دجابر,داروسازي‌ جابرابن‌حيان‌,1135,946962,42645792130,44220,46000,45000,780,1.76,44900,680,1.54,43220,46420,1399-6-29
209,صبا,سرمايه گذاري صبا تامين,1105,10364173,111000292830,9959,10710,10710,751,7.54,10605,646,6.49,10710,10710,1399-6-29
210,دتمادح,ح . توليدمواداوليه‌داروپخش‌,1105,844292,31461396070,36820,35600,38140,1320,3.59,37260,440,1.2,34010,39000,1399-6-29
211,بفجر,فجر انرژي خليج فارس,1098,2904571,92406529990,31750,32780,30610,-1140,-3.59,31810,60,0.19,30380,32780,1399-6-29
212,دامين,داروسازي‌ امين‌,1098,2887901,43868201280,14670,14960,14810,140,0.95,15110,440,3.0,14030,15400,1399-6-29
213,شپارس,بين‌ المللي‌ محصولات‌  پارس‌,1083,4684485,71480232250,15930,15170,15400,-530,-3.33,15260,-670,-4.21,15140,15900,1399-6-29
214,قصفها,قنداصفهان‌,1065,279370,52516909620,196740,200000,186910,-9830,-5.0,187980,-8760,-4.45,186910,200000,1399-6-29
215,آريان,سرمايه گذاري پارس آريان,1055,23434121,360435817247,15827,15500,15353,-474,-2.99,15381,-446,-2.82,15353,15700,1399-6-29
216,زر,صندوق س.پشتوانه سكه طلاي زر,1052,833509,50370781775,64430,60010,60886,-3544,-5.5,60432,-3998,-6.21,59010,60889,1399-6-29
217,لوتوس,تامين سرمايه لوتوس پارسيان,1049,3204315,50610444500,16150,16200,15520,-630,-3.9,15830,-320,-1.98,15350,16450,1399-6-29
218,شراز,پالايش نفت شيراز,1044,1086489,122692850654,118494,112580,112570,-5924,-5.0,112926,-5568,-4.7,112570,115860,1399-6-29
219,افق ملت,صندوق س در سهام افق ملت,1034,462916,72219263310,161700,154000,154040,-7660,-4.74,156010,-5690,-3.52,151500,161700,1399-6-29
220,شگل,گلتاش‌,1021,1497896,46820496490,32280,31800,31640,-640,-1.98,31290,-990,-3.07,30670,32930,1399-6-29
221,ددام,داروسازي زاگرس فارمد پارس,1020,2508342,35327468350,14770,14040,14040,-730,-4.94,14260,-510,-3.45,14040,14990,1399-6-29
222,كاريس,صندوق س.سپهر كاريزما-س,1014,1331317,310874421209,232297,232297,233000,703,0.3,233509,1212,0.52,226500,239999,1399-6-29
223,ميهن,بيمه ميهن,1012,15745527,85739394271,5727,5441,5441,-286,-4.99,5445,-282,-4.92,5441,5590,1399-6-29
224,شكربن,كربن‌ ايران‌,1006,1524435,93672883870,63640,60470,60910,-2730,-4.29,61450,-2190,-3.44,60460,63000,1399-6-29
225,شبصير,توليدات پتروشيمي قائد بصير,1005,1204095,155303919024,124577,125000,127990,3413,2.74,128980,4403,3.53,118420,130805,1399-6-29
226,فسرب,ملي‌ سرب‌وروي‌ ايران‌,1001,595316,77717991040,129520,127050,127400,-2120,-1.64,130550,1030,0.8,127000,135950,1399-6-29
227,كاذر,فرآورده‌هاي‌نسوزآذر,979,2615246,85460275140,33390,31730,31750,-1640,-4.91,32680,-710,-2.13,31730,34000,1399-6-29
228,سخوز,سيمان خوزستان,970,9725469,193965662030,19720,19720,20700,980,4.97,19940,220,1.12,19130,20700,1399-6-29
229,ثنور,سرمايه گذاري كوه نور,942,5174732,42536256833,8470,8220,8216,-254,-3.0,8220,-250,-2.95,8216,8470,1399-6-29
230,داناح,ح . بيمه دانا,935,19000000,108110000000,5170,5690,5690,520,10.06,5690,520,10.06,5690,5690,1399-6-29
231,بموتو,موتوژن‌,923,1511238,71755602510,48630,46330,46240,-2390,-4.91,47480,-1150,-2.36,46200,48810,1399-6-29
232,فخاس,فولاد خراسان,917,1285290,51579701210,39920,40720,38300,-1620,-4.06,40030,110,0.28,37930,41500,1399-6-29
233,شسينا,صنايع‌شيميايي‌سينا,915,270289,152466151960,537910,563900,564800,26890,5.0,564090,26180,4.87,541240,564800,1399-6-29
234,آبادا,توليد نيروي برق آبادان,907,966857,24741870630,26930,25590,25590,-1340,-4.98,26230,-700,-2.6,25590,25590,1399-6-29
235,ارفعح,ح.شركت آهن و فولاد ارفع,900,1007917,14659144848,13852,14544,14544,692,5.0,14544,692,5.0,14544,14544,1399-6-29
236,ثقزوي,شركت عمران و سازندگي قزوين,894,7664564,158973963152,20198,20803,20803,605,3.0,20741,543,2.69,19593,20803,1399-6-29
237,دفارا,داروسازي‌ فارابي‌,893,1417665,107537046070,72350,75960,75960,3610,4.99,75860,3510,4.85,73000,75960,1399-6-29
238,شپارسح,ح . بين‌ المللي‌محصولات پارس‌,886,2925138,37450588595,13492,13180,12610,-882,-6.54,12803,-689,-5.11,12200,13200,1399-6-29
239,بگيلان,توسعه مسير برق گيلان,875,638806,22155708498,36508,34683,34683,-1825,-5.0,35830,-678,-1.86,34683,34683,1399-6-29
240,دتماد,توليدمواداوليه‌داروپخش‌,850,2119592,88330729600,40410,40210,42430,2020,5.0,41670,1260,3.12,39150,42430,1399-6-29
241,اوان,مبين وان كيش,825,1542545,74688582037,50519,47994,49800,-719,-1.42,48419,-2100,-4.16,47994,51000,1399-6-29
242,دبالك,مواد اوليه دارويي البرز بالك,812,2971168,54715129365,19246,18300,18284,-962,-5.0,18415,-831,-4.32,18284,19180,1399-6-29
243,فاما,صنعتي‌ آما,799,2097767,38813584750,19460,18490,18490,-970,-4.98,18680,-780,-4.01,18490,18990,1399-6-29
244,ساروم,سيمان‌اروميه‌,799,1078725,28029722780,25660,26690,25010,-650,-2.53,25840,180,0.7,24400,26930,1399-6-29
245,بميلا,توسعه بازرگاني آهن وفولادميلاد,782,2975393,112711194431,36957,38065,37000,43,0.12,37881,924,2.5,36000,38065,1399-6-29
246,زفكا,كشت و دامداري فكا,777,1037636,50374114439,46661,47400,48994,2333,5.0,48487,1826,3.91,47243,48994,1399-6-29
247,ولساپا,ليزينگ رايان‌ سايپا,769,10952581,50491398410,4850,4610,4610,-240,-4.95,4610,-240,-4.95,4610,4610,1399-6-29
248,بخاور,بيمه زندگي خاورميانه,764,7878760,60255090696,8026,7971,7625,-401,-5.0,7648,-378,-4.71,7625,7980,1399-6-29
249,مفاخر,توسعه فناوري اطلاعات خوارزمي,762,2033751,105896598642,52938,52938,50292,-2646,-5.0,52070,-868,-1.64,50292,53500,1399-6-29
250,شنفت,نفت‌ پارس‌,759,785073,51291985690,67690,64360,64310,-3380,-4.99,65840,-1850,-2.73,64310,69000,1399-6-29
251,دالبر,البرزدارو,750,924326,19493272200,21540,22500,21000,-540,-2.51,21360,-180,-0.84,20540,22500,1399-6-29
252,ثپرديسح,ح.سرمايه گذاري مسكن پرديس,743,1796384,15011210366,8707,8272,8272,-435,-5.0,8356,-351,-4.03,8272,9142,1399-6-29
253,تسه9902,امتياز تسهيلات مسكن ارديبهشت99,743,9619,7673930997,832423,800000,791000,-41423,-4.98,797789,-34634,-4.16,790802,816900,1399-6-29
254,شجم,صنايع پتروشيمي تخت جمشيد,742,3611927,35609887550,10146,9910,9842,-304,-3.0,9859,-287,-2.83,9842,10146,1399-6-29
255,دسبحان,سبحان دارو,730,1250551,23698378570,19770,18790,18790,-980,-4.96,19360,-410,-2.07,18790,19770,1399-6-29
256,سدبير,س. تدبيرگران فارس وخوزستان,728,2079170,52029118465,25787,25864,24498,-1289,-5.0,25024,-763,-2.96,24498,26980,1399-6-29
257,سقاين,سيمان‌ قائن‌,725,655696,28948424170,45110,45000,45000,-110,-0.24,44540,-570,-1.26,42860,46950,1399-6-29
258,لابسا,آبسال‌,723,1244032,41809476950,34920,33180,33180,-1740,-4.98,33780,-1140,-3.26,33180,36660,1399-6-29
259,فرابورس,فرابورس ايران,722,612696,33951323448,52775,55413,55413,2638,5.0,54218,1443,2.73,55413,55413,1399-6-29
260,كماسه,تامين‌ ماسه‌ ريخته‌گري‌,704,473765,29921517830,66490,66000,62700,-3790,-5.7,64390,-2100,-3.16,62700,66000,1399-6-29
261,دشيمي,شيمي‌ داروئي‌ داروپخش‌,688,985263,61149362050,60450,63470,60500,50,0.08,62060,1610,2.66,58000,63470,1399-6-29
262,كخاك,صنايع‌خاك‌چيني‌ايران‌,685,1103174,67290738880,58480,60000,59620,1140,1.95,61000,2520,4.31,59010,63000,1399-6-29
263,تسه9903,امتياز تسهيلات مسكن خرداد99,683,8623,6903988374,835799,800222,794010,-41789,-5.0,800648,-35151,-4.21,794010,819998,1399-6-29
264,فاراك,ماشين‌ سازي‌ اراك‌,672,4395943,47520143830,11370,10810,10810,-560,-4.93,10810,-560,-4.93,10810,10810,1399-6-29
265,ثشرقح,ح. سرمايه گذاري مسكن شمال شرق,668,2425889,11643431870,5170,4800,4650,-520,-10.06,4800,-370,-7.16,4650,5090,1399-6-29
266,شخارك,پتروشيمي‌ خارك‌,659,913767,46108682820,48060,50460,50460,2400,4.99,49110,1050,2.18,50460,50460,1399-6-29
267,تسه9810,امتياز تسهيلات مسكن دي98,656,11893,9500005330,828358,800000,786941,-41417,-5.0,798790,-29568,-3.57,786941,860000,1399-6-29
268,شغدير,پتروشيمي غدير,656,1077655,49489150565,43737,45923,45923,2186,5.0,45798,2061,4.71,45923,45923,1399-6-29
269,تليسه,دامداري تليسه نمونه,648,286405,19437422486,71436,67865,67865,-3571,-5.0,69976,-1460,-2.04,67865,69126,1399-6-29
270,پكوير,كوير تاير,643,1597494,23935698990,15760,14980,14980,-780,-4.95,15370,-390,-2.47,14980,15750,1399-6-29
271,دابور,داروسازي‌ ابوريحان‌,630,654213,27260005470,39920,41880,41910,1990,4.98,40830,910,2.28,39800,41910,1399-6-29
272,كي بي سي,شركت كي بي سي,629,1260009,47964674500,36328,38144,38144,1816,5.0,37920,1592,4.38,36487,38144,1399-6-29
273,فلات,گروه صنايع معادن فلات ايرانيان,624,3210509,48812549263,15334,15341,15170,-164,-1.07,15204,-130,-0.85,14874,15794,1399-6-29
274,زشگزا,شير و گوشت زاگرس شهركرد,616,336140,31056647049,97124,92410,92268,-4856,-5.0,94034,-3090,-3.18,92268,94000,1399-6-29
275,بكام,كارخانجات توليدي شهيد قندي,611,10034606,68034628680,7130,6780,6780,-350,-4.91,6780,-350,-4.91,6780,6780,1399-6-29
276,پتاير,ايران‌ تاير,610,338150,35821465570,111250,106010,105690,-5560,-5.0,107250,-4000,-3.6,105690,110000,1399-6-29
277,داوه,داروسازي آوه سينا,608,892225,16743378163,19750,18763,18763,-987,-5.0,19403,-347,-1.76,18763,19170,1399-6-29
278,دسانكو,داروسازي سبحان انكولوژي,593,1400289,24837108200,18626,17800,17695,-931,-5.0,18162,-464,-2.49,17695,18199,1399-6-29
279,وتوشه,سرمايه‌ گذاري‌ پارس‌ توشه‌,591,3858125,88609166440,24140,22940,22940,-1200,-4.97,22970,-1170,-4.85,22940,23430,1399-6-29
280,شجمح,ح. صنايع پتروشيمي تخت جمشيد,586,4636166,35438475869,7500,7700,7725,225,3.0,7644,144,1.92,7275,7725,1399-6-29
281,خديزل,بهمن  ديزل,584,849194,34012377421,41100,42000,39840,-1260,-3.07,40369,-731,-1.78,39045,42300,1399-6-29
282,وشمال,س. چشم انداز توسعه شمال,581,628365,79389519195,130250,126343,126343,-3907,-3.0,126343,-3907,-3.0,126343,126343,1399-6-29
283,آساس,صندوق س.آسمان آرماني سهام-س,579,297976,51414114670,174155,171200,173000,-1155,-0.66,172544,-1611,-0.93,168002,176000,1399-6-29
284,قنيشا,قند  نيشابور,573,1274401,132473983950,99000,103950,103950,4950,5.0,103950,4950,5.0,103950,103950,1399-6-29
285,كيان2,صندوق س. با درآمد ثابت كيان,559,55900000,55900000,25290,1,1,-25289,-100.0,1,-25289,-100.0,1,1,1399-6-29
286,بهپاك,صنعتي بهپاك,559,746367,28142418708,38373,38000,36455,-1918,-5.0,37991,-382,-1.0,36455,40291,1399-6-29
287,سجام,مجتمع سيمان غرب آسيا,558,2770179,37748225487,13723,13723,13312,-411,-2.99,13627,-96,-0.7,13312,13800,1399-6-29
288,شفا,سرمايه گذاري شفادارو,558,884871,53036930770,59610,61400,60000,390,0.65,59940,330,0.55,56670,61500,1399-6-29
289,دپارس,پارس‌ دارو,551,399335,40918239780,98420,103290,99000,580,0.59,101600,3180,3.23,98000,103340,1399-6-29
290,گوهر,صندوق سكه طلاي كيان,549,534499,37706062639,75882,70500,69699,-6183,-8.15,70545,-5337,-7.03,69003,72000,1399-6-29
291,اتكاي,بيمه اتكايي ايرانيان,546,1822975,28108494028,15614,15614,15598,-16,-0.1,15503,-111,-0.71,15000,15744,1399-6-29
292,نوين,بيمه نوين,540,3168663,20300281522,6708,6373,6373,-335,-4.99,6580,-128,-1.91,6373,6831,1399-6-29
293,اپرداز,آتيه داده پرداز,537,1537676,42162659281,28670,28983,27237,-1433,-5.0,27568,-1102,-3.84,27237,28983,1399-6-29
294,درهآور,دارويي ره آورد تامين,530,461227,14187448395,32340,30725,30723,-1617,-5.0,31869,-471,-1.46,30723,31850,1399-6-29
295,غفارس,شير پاستوريزه پگاه فارس,529,3448604,34648738689,10575,10047,10047,-528,-4.99,10190,-385,-3.64,10047,10100,1399-6-29
296,دسبحاح,ح .گروه دارويي سبحان,523,614379,9684684060,16920,15230,15230,-1690,-9.99,15760,-1160,-6.86,15230,16200,1399-6-29
297,كرمان,س. توسعه و عمران استان كرمان,518,487056,40628263296,87806,83416,83416,-4390,-5.0,84051,-3755,-4.28,83416,83416,1399-6-29
298,سفانو,سيمان فارس نو,517,535224,17963481850,34880,33150,34470,-410,-1.18,34390,-490,-1.4,33140,36500,1399-6-29
299,كسرا,سراميك‌هاي‌صنعتي‌اردكان‌,515,1226853,30221116140,25870,24590,24580,-1290,-4.99,25080,-790,-3.05,24580,25000,1399-6-29
300,دلر,داروسازي‌ اكسير,511,223740,23412807430,101160,106210,102700,1540,1.52,102740,1580,1.56,101160,106210,1399-6-29
301,قزوين,كارخانجات‌ قند قزوين‌,509,814731,30889905990,39820,37830,37830,-1990,-5.0,38580,-1240,-3.11,37830,39500,1399-6-29
302,دارو,كارخانجات‌داروپخش‌,507,888896,45404056700,53000,51300,52000,-1000,-1.89,51190,-1810,-3.42,50350,53000,1399-6-29
303,خمحركه,نيرو محركه‌,500,1194843,10908916590,9610,9130,9130,-480,-4.99,9500,-110,-1.14,9130,9130,1399-6-29
304,كفرا,فراورده‌ هاي‌ نسوزايران‌,499,318025,13502949660,43090,44690,41400,-1690,-3.92,42920,-170,-0.39,41000,44690,1399-6-29
305,كمنگنز,معادن‌منگنزايران‌,498,236494,19667885720,86630,84500,82300,-4330,-5.0,85210,-1420,-1.64,82300,85000,1399-6-29
306,زپارس,ملي كشت و صنعت و دامپروري پارس,491,433627,31436362340,76230,72820,72420,-3810,-5.0,73760,-2470,-3.24,72420,76230,1399-6-29
307,حتايد,تايدواترخاورميانه,491,1421144,28938154230,21430,20360,20360,-1070,-4.99,20780,-650,-3.03,20360,20620,1399-6-29
308,پخش,پخش البرز,489,862133,26787298621,32514,31000,30889,-1625,-5.0,31705,-809,-2.49,30889,32500,1399-6-29
309,درازك,دارويي‌ رازك‌,489,434815,18710207720,43270,42000,42400,-870,-2.01,43180,-90,-0.21,41120,44490,1399-6-29
310,قهكمت,قندهكمتان‌,487,852157,41387980360,46400,48720,48110,1710,3.69,48110,1710,3.69,44600,48720,1399-6-29
311,حسينا,توسعه خدمات دريايي وبندري سينا,481,1201127,66394001553,52690,55324,55324,2634,5.0,55276,2586,4.91,53539,55324,1399-6-29
312,سهرمز,سيمان‌هرمزگان‌,481,902791,15067969730,17170,17800,16320,-850,-4.95,17020,-150,-0.87,16320,17800,1399-6-29
313,ملت,بيمه ملت,478,1657851,22923467230,14490,13930,13770,-720,-4.97,14170,-320,-2.21,13770,14220,1399-6-29
314,آساميد2,صندوق س.مشترك آسمان اميد -د,467,46700000,46700000,10674,1,1,-10673,-99.99,1,-10673,-99.99,1,1,1399-6-29
315,فپنتا,سپنتا,461,152553,41715752250,264140,251000,277340,13200,5.0,271640,7500,2.84,251000,277340,1399-6-29
316,سمازن,سيمان‌مازندران‌,457,1773586,17474116460,10360,9850,9850,-510,-4.92,10170,-190,-1.83,9850,10000,1399-6-29
317,ثغربح,ح.شركت سرمايه گذاري مسكن شمالغ,451,23393800,194303808507,8307,8722,8305,-2,-0.02,8306,-1,-0.01,8305,8722,1399-6-29
318,غديس,پاكديس,449,489981,17131310506,36710,35210,34875,-1835,-5.0,36082,-628,-1.71,34875,36000,1399-6-29
319,ساينا,صنايع بهداشتي ساينا,447,97636,17959006026,177726,186612,183400,5674,3.19,179882,2156,1.21,180010,186612,1399-6-29
320,پرداخت,به پرداخت ملت,435,339996,14333684750,43680,42610,43680,0,0.0,43230,-450,-1.03,41500,43800,1399-6-29
321,سكارون,سيمان كارون,435,855394,93472077906,112646,109267,109267,-3379,-3.0,109274,-3372,-2.99,109267,112646,1399-6-29
322,دارا,صندوق س. دارا الگوريتم-د,427,9698606,98353036225,10109,10140,10130,21,0.21,10141,32,0.32,10121,10160,1399-6-29
323,تسه9812,امتياز تسهيلات مسكن اسفند98,426,4853,3865336546,835764,794000,793977,-41787,-5.0,796484,-39280,-4.7,793976,820010,1399-6-29
324,تسه9901,امتياز تسهيلات مسكن فروردين99,425,3995,3194787831,839073,820000,800000,-39073,-4.66,799697,-39376,-4.69,797120,820000,1399-6-29
325,غپونه,نوش پونه مشهد,413,1374924,24905514748,18673,18113,18113,-560,-3.0,18114,-559,-2.99,18113,18580,1399-6-29
326,سبهان,سيمان‌ بهبهان‌,413,202681,12207740180,62290,60000,60000,-2290,-3.68,61770,-520,-0.83,59190,62000,1399-6-29
327,شصفها,پتروشيمي‌ اصفهان‌,413,415028,37851726323,93000,91150,91140,-1860,-2.0,91203,-1797,-1.93,91140,94800,1399-6-29
328,بكاب,صنايع‌جوشكاب‌يزد,405,174963,21288128480,116170,121920,121970,5800,4.99,118410,2240,1.93,110550,121970,1399-6-29
329,ولصنم,ليزينگ‌صنعت‌ومعدن‌,395,1591138,16728810570,11060,10510,10510,-550,-4.97,10870,-190,-1.72,10510,10600,1399-6-29
330,هجرت,پخش هجرت,394,415177,25562032713,64809,61569,61569,-3240,-5.0,63065,-1744,-2.69,61569,61569,1399-6-29
331,بذر,صندوق س بذر اميد آفرين-سهام,394,300797,36886386320,124220,120000,122010,-2210,-1.78,122630,-1590,-1.28,119000,124100,1399-6-29
332,تسه9708,امتياز تسهيلات مسكن آبان97,392,4020,3188005977,810555,792010,782560,-27995,-3.45,793036,-17519,-2.16,771500,849995,1399-6-29
333,سشرق,سيمان‌ شرق‌,384,1522311,11797910250,8150,7750,7750,-400,-4.91,8050,-100,-1.23,7750,7750,1399-6-29
334,غشهداب,كشت و صنعت شهداب ناب خراسان,382,2001665,10821000990,5690,5406,5406,-284,-4.99,5625,-65,-1.14,5406,5406,1399-6-29
335,وپخش,داروپخش‌ (هلدينگ‌,378,117533,14786247900,127170,129300,123000,-4170,-3.28,126760,-410,-0.32,121500,129300,1399-6-29
336,ما,بيمه  ما,374,1576515,9934554400,6630,6300,6300,-330,-4.98,6560,-70,-1.06,6300,6400,1399-6-29
337,كوثر,بيمه كوثر,373,835549,12268694538,15431,14660,14660,-771,-5.0,15238,-193,-1.25,14660,15000,1399-6-29
338,دسبحا,گروه دارويي سبحان,372,562560,9711143820,17660,18530,17000,-660,-3.74,17580,-80,-0.45,16780,18530,1399-6-29
339,خزاميا,زامياد,367,923694,15444163680,17590,16720,16720,-870,-4.95,17310,-280,-1.59,16720,16720,1399-6-29
340,گپارس,امور رفاهي كارگزاران پارس,367,304705,32599229282,104604,107742,107742,3138,3.0,106986,2382,2.28,102180,107742,1399-6-29
341,ولراز,ليزينگ رازي,360,944188,23779616439,24833,25577,24089,-744,-3.0,25185,352,1.42,24089,25577,1399-6-29
342,غدام,خوراك‌  دام‌ پارس‌,354,151475,20998979250,132030,138630,138630,6600,5.0,134670,2640,2.0,138630,138630,1399-6-29
343,وجامي,سرمايه گذاري جامي,353,1702072,19180649368,11617,11269,11269,-348,-3.0,11273,-344,-2.96,11269,11269,1399-6-29
344,كفرآور,فرآورده هاي سيمان شرق,351,1167991,22542785631,18789,19290,19352,563,3.0,19300,511,2.72,19002,19352,1399-6-29
345,زاگرس,پتروشيمي زاگرس,348,355998,59893815516,160231,168242,168242,8011,5.0,164801,4570,2.85,168242,168242,1399-6-29
346,وهنر,گروه توسعه هنر ايران,347,2613706,13732204151,5414,5252,5252,-162,-2.99,5301,-113,-2.09,5252,5372,1399-6-29
347,تسه9707,امتياز تسهيلات مسكن مهر97,346,4260,3359025802,799908,785000,773550,-26358,-3.3,788504,-11404,-1.43,770150,819900,1399-6-29
348,تسه9709,امتياز تسهيلات مسكن آذر97,346,2827,2235528487,819008,786000,782110,-36898,-4.51,790778,-28230,-3.45,778058,799000,1399-6-29
349,وساپا,سرمايه‌گذاري‌ سايپا,344,732772,8624726440,12380,11770,11770,-610,-4.93,12280,-100,-0.81,11770,11770,1399-6-29
350,تسه9712,امتياز تسهيلات مسكن اسفند97,341,3012,2379174487,819023,779000,780000,-39023,-4.76,789899,-29124,-3.56,778072,809990,1399-6-29
351,تسه9811,امتياز تسهيلات مسكن بهمن98,337,3064,2434218918,832854,825000,791212,-41642,-5.0,794458,-38396,-4.61,791212,830000,1399-6-29
352,مداران,داده‌پردازي‌ايران‌,333,1441929,44123330650,32210,30600,30600,-1610,-5.0,30710,-1500,-4.66,30600,30800,1399-6-29
353,سبجنو,سيمان‌ بجنورد,329,632048,20940453810,33080,34400,32200,-880,-2.66,33100,20,0.06,31430,34400,1399-6-29
354,تسه9801,امتياز تسهيلات مسكن فروردين98,327,2875,2272712987,815716,774931,790000,-25716,-3.15,790509,-25207,-3.09,774931,810000,1399-6-29
355,دكپسول,توليد ژلاتين كپسول ايران,326,216984,8494721551,41201,39142,39141,-2060,-5.0,40834,-367,-0.89,39141,39500,1399-6-29
356,سيستم,همكاران سيستم,326,484773,13474584280,26700,28030,27900,1200,4.49,26980,280,1.05,27000,28030,1399-6-29
357,تسه9710,امتياز تسهيلات مسكن دي 97,325,3225,2555755079,816133,790000,790000,-26133,-3.2,792482,-23651,-2.9,775555,800000,1399-6-29
358,قچار,فراوردههاي غذايي وقند چهارمحال,323,170592,30294239136,169127,177583,177583,8456,5.0,174006,4879,2.88,177583,177583,1399-6-29
359,ثشاهد,سرمايه‌ گذاري‌ شاهد,322,235315,11215112900,50160,47660,47660,-2500,-4.98,49790,-370,-0.74,47660,47660,1399-6-29
360,تسه9803,امتياز تسهيلات مسكن خرداد98,321,2509,1982175285,820860,779855,800000,-20860,-2.54,790026,-30834,-3.76,779817,800000,1399-6-29
361,شاملا,معدني‌ املاح‌  ايران‌,321,163397,12090917180,74700,77890,70970,-3730,-4.99,74530,-170,-0.23,70970,77890,1399-6-29
362,تپولا,مهندسي مرآت پولاد,319,1461986,24563531228,17207,16691,16691,-516,-3.0,16801,-406,-2.36,16691,17488,1399-6-29
363,حخزر,كشتيراني درياي خزر,317,887100,22999563378,27290,25926,25926,-1364,-5.0,26630,-660,-2.42,25926,26440,1399-6-29
364,تكشا,گسترش‌صنايع‌وخدمات‌كشاورزي‌,316,530188,40925211720,73520,77190,77190,3670,4.99,76380,2860,3.89,77190,77190,1399-6-29
365,كاسپينح,ح .داروسازي كاسپين تامين,315,464187,9918995146,22479,21356,21356,-1123,-5.0,21369,-1110,-4.94,21356,21950,1399-6-29
366,تسه9711,امتياز تسهيلات مسكن بهمن 97,307,2593,2050469973,789517,750042,760000,-29517,-3.74,790771,1254,0.16,750042,820000,1399-6-29
367,غپآذر,شير پگاه آذربايجان شرقي,306,281123,16646511738,59800,57010,57150,-2650,-4.43,59603,-197,-0.33,56810,61480,1399-6-29
368,ثفارس,عمران‌وتوسعه‌فارس‌,294,853895,8923202750,10990,10450,10450,-540,-4.91,10890,-100,-0.91,10450,10450,1399-6-29
369,خرينگ,رينگ‌سازي‌مشهد,294,667888,18507176480,29160,27710,27710,-1450,-4.97,28600,-560,-1.92,27710,27710,1399-6-29
370,ونيرو,سرمايه‌گذاري‌نيرو,293,3266229,29200087260,9410,8940,8940,-470,-4.99,9120,-290,-3.08,8940,8940,1399-6-29
371,تسه9802,امتياز تسهيلات مسكن ارديبهشت98,293,1928,1535638950,833910,792215,793000,-40910,-4.91,796493,-37417,-4.49,792215,860000,1399-6-29
372,شتوكا,توكا رنگ فولاد سپاهان,292,480665,15515163554,33846,32200,32154,-1692,-5.0,33336,-510,-1.51,32154,33400,1399-6-29
373,پسهند,صنايع‌ لاستيكي‌  سهند,288,335894,16428565150,51460,48890,48890,-2570,-4.99,50580,-880,-1.71,48890,49990,1399-6-29
374,ومعلم,بيمه معلم,287,1620256,26946520610,17506,16631,16631,-875,-5.0,17010,-496,-2.83,16631,16640,1399-6-29
375,تسه9809,امتياز تسهيلات مسكن آذر98,285,3150,2507708287,836675,794842,794842,-41833,-5.0,796098,-40577,-4.85,794842,801000,1399-6-29
376,بنو,بيمه تجارت نو,285,1929525,53783579850,26547,27874,27874,1327,5.0,27874,1327,5.0,27874,27874,1399-6-29
377,ثباغ,شهر سازي و خانه سازي باغميشه,283,3854679,60237068733,14883,15627,15627,744,5.0,15627,744,5.0,15627,15627,1399-6-29
378,سغرب,سيمان‌غرب‌,281,489897,10224219160,21960,20870,20870,-1090,-4.96,21730,-230,-1.05,20870,21000,1399-6-29
379,زگلدشت,كشت و دام گلدشت نمونه اصفهان,269,348004,13804622672,41755,39668,39668,-2087,-5.0,41148,-607,-1.45,39668,39668,1399-6-29
380,حپارسا,توسعه حمل و نقل ريلي پارسيان,269,495354,17077686760,36282,34469,34468,-1814,-5.0,35633,-649,-1.79,34468,35350,1399-6-29
381,تسه9808,امتياز تسهيلات مسكن آبان98,269,3154,2493152242,810836,790000,800000,-10836,-1.34,790473,-20363,-2.51,770295,839837,1399-6-29
382,وپويا,سرمايه گذاري پويا,269,321573,3918367005,12826,12185,12185,-641,-5.0,12773,-53,-0.41,12185,12185,1399-6-29
383,ساوه,سيمان ساوه,256,101758,7272338986,75228,71467,71467,-3761,-5.0,74652,-576,-0.77,71467,71467,1399-6-29
384,تايرا,تراكتورسازي‌ايران‌,256,1486428,35585086320,25190,23940,23940,-1250,-4.96,24250,-940,-3.73,23940,23940,1399-6-29
385,مرقام,ايران‌ارقام‌,252,358565,10068505200,29550,28080,28080,-1470,-4.97,29240,-310,-1.05,28080,28080,1399-6-29
386,سرود,سيمان‌شاهرود,249,446651,6785146240,15980,15190,15190,-790,-4.94,15870,-110,-0.69,15190,15600,1399-6-29
387,زعف9908پ10,زعفران9908نگين طلاي سرخ(پ),241,155810,13953830009,86343,86812,90660,4317,5.0,89557,3214,3.72,84960,90660,1399-6-29
388,غنوش,نوش‌ مازندران‌,241,276901,24998622280,95030,90280,90280,-4750,-5.0,92530,-2500,-2.63,90280,90280,1399-6-29
389,سپاها,سيمان‌سپاهان‌,227,682054,6636385420,10240,9730,9730,-510,-4.98,10170,-70,-0.68,9730,9730,1399-6-29
390,غچين,كشت‌ و صنعت‌ چين‌ چين,227,859252,46511310760,56970,54130,54130,-2840,-4.99,54190,-2780,-4.88,54130,54130,1399-6-29
391,ثجوان,تامين مسكن جوانان,225,1146913,9963158552,9132,8686,8676,-456,-4.99,8899,-233,-2.55,8676,8876,1399-6-29
392,ضصاد8024,اختيارخ وبصادر-5500-1399/08/11,225,6667,2019219000,263,275,289,26,9.89,303,40,15.21,238,355,1399-6-29
393,سامان,بانك سامان,222,2386640,34384322480,14852,14407,14407,-445,-3.0,14520,-332,-2.24,14407,14407,1399-6-29
394,سهگمت,سيمان‌هگمتان‌,221,396932,7597278480,18230,19140,19140,910,4.99,18360,130,0.71,19140,19140,1399-6-29
395,تصميم,صندوق س با درآمد ثابت تصميم,214,4533022,65756115210,14410,14500,14540,130,0.9,14510,100,0.69,14500,14580,1399-6-29
396,صنوين,صندوق سرمايه‌گذاري صنوين-مختلط,214,59101,6752767280,117920,115000,114000,-3920,-3.32,114260,-3660,-3.1,111250,116980,1399-6-29
397,غمارگ,مارگارين‌,207,263253,7821246630,31270,29710,29710,-1560,-4.99,31010,-260,-0.83,29710,29710,1399-6-29
398,وارس,سرمايه گذاري ارس صبا,203,504543,57568860843,120106,114101,114101,-6005,-5.0,114101,-6005,-5.0,114101,114101,1399-6-29
399,وآرين,شركت توسعه اقتصادي آرين,201,1539889,8438805005,5648,5479,5479,-169,-2.99,5575,-73,-1.29,5479,5599,1399-6-29
400,تسه9806,امتياز تسهيلات مسكن شهريور98,198,2669,2109839269,814360,782000,775501,-38859,-4.77,790498,-23862,-2.93,773658,800000,1399-6-29
401,ورنا,سرمايه‌گذاري‌ رنا(هلدينگ‌,194,436232,4890160720,11800,11210,11210,-590,-5.0,11740,-60,-0.51,11210,11210,1399-6-29
402,آكورد,صندوق س. آرمان آتي كوثر-د,192,2912200,82995686074,28500,28500,28530,30,0.11,28499,-1,0.0,28450,28560,1399-6-29
403,سكرما,سيمان‌ كرمان‌,183,599228,9936289460,17380,17000,16520,-860,-4.95,17210,-170,-0.98,16520,17390,1399-6-29
404,قنقش,قند نقش جهان,178,465301,35106591620,76981,75442,75442,-1539,-2.0,75449,-1532,-1.99,75442,76981,1399-6-29
405,ضجار7036,اختيارخ وتجارت-6500-1399/07/22,173,8585,332281000,52,34,30,-22,-42.31,39,-13,-25.0,30,50,1399-6-29
406,پيزد,مجتمع صنايع لاستيك يزد,165,22457,2374131583,111283,105719,105719,-5564,-5.0,111005,-278,-0.25,105719,105719,1399-6-29
407,بسويچ,پارس‌سويچ‌,162,363457,16838962810,48760,46330,46330,-2430,-4.98,47900,-860,-1.76,46330,46330,1399-6-29
408,وسخراج,شركت س استان خراسان جنوبي,159,6042273,12386659650,1960,2050,2050,90,4.59,1980,20,1.02,2050,2050,1399-6-29
409,سمتاز,سيمان ممتازان كرمان,158,211994,4534401054,22016,21456,21356,-660,-3.0,21870,-146,-0.66,21356,21556,1399-6-29
410,صايند,صندوق س. گنجينه آينده روشن-د,156,1511780,15017759590,9946,9950,9950,4,0.04,9934,-12,-0.12,9886,9987,1399-6-29
411,شدوص,دوده‌ صنعتي‌ پارس‌,155,221297,4441430790,21120,20070,20070,-1050,-4.97,21020,-100,-0.47,20070,20070,1399-6-29
412,دسينا,داروسازي‌ سينا,155,542487,17506055490,33960,32270,32270,-1690,-4.98,33340,-620,-1.83,32270,32270,1399-6-29
413,سخاش,سيمان‌خاش‌,154,92178,6896944740,78720,75000,74790,-3930,-4.99,78150,-570,-0.72,74790,75000,1399-6-29
414,تسه9807,امتياز تسهيلات مسكن مهر98,150,1464,1171101021,840044,800000,798042,-42002,-5.0,799932,-40112,-4.77,798042,810000,1399-6-29
415,ساروج,بين المللي ساروج بوشهر,148,91578,2196665702,24727,23993,23986,-741,-3.0,24643,-84,-0.34,23986,23993,1399-6-29
416,اعتلاح,ح سرمايه گذاري اعتلاء البرز,147,923663,8142335820,9278,8815,8815,-463,-4.99,8815,-463,-4.99,8815,8825,1399-6-29
417,خمهر,مهركام‌پارس‌,147,844075,7031144750,8760,8330,8330,-430,-4.91,8700,-60,-0.68,8330,8330,1399-6-29
418,اميد,تامين سرمايه اميد,147,1203826,20091855940,17560,16690,16690,-870,-4.95,17280,-280,-1.59,16690,16690,1399-6-29
419,بساما,بيمه سامان,144,324943,7886580224,25532,24256,24256,-1276,-5.0,25323,-209,-0.82,24256,25200,1399-6-29
420,فنفت,صنايع تجهيزات نفت,143,350078,5488617846,16162,15678,15678,-484,-2.99,16025,-137,-0.85,15678,15950,1399-6-29
421,بمپنا,توليد برق عسلويه  مپنا,141,543429,54408111480,105389,100120,100120,-5269,-5.0,100120,-5269,-5.0,100120,100120,1399-6-29
422,الماس,صندوق س.امين تدبيرگران فردا-س,140,59622,7662140316,132435,129000,126100,-6335,-4.78,128512,-3923,-2.96,126000,132599,1399-6-29
423,نمرينو,ايران‌ مرينوس‌,139,121659,7934947640,68630,65210,65200,-3430,-5.0,68060,-570,-0.83,65200,67200,1399-6-29
424,شپترو,پتروشيمي آبادان,139,569603,3893806108,7047,6836,6836,-211,-2.99,7005,-42,-0.6,6836,6836,1399-6-29
425,وبهمن,سرمايه‌گذاري‌بهمن‌,138,3189997,60609943000,19990,19000,19000,-990,-4.95,19000,-990,-4.95,19000,19000,1399-6-29
426,وگردشح,ح . بانك گردشگري,136,2229947,37068408981,17137,16623,16623,-514,-3.0,16623,-514,-3.0,16623,16623,1399-6-29
427,شزنگ,تجهيزنيروي‌زنگان‌,134,562073,49704634952,86058,89497,88350,2292,2.66,88431,2373,2.76,85000,89497,1399-6-29
428,غشهد,شهد ايران ‌,133,373842,2844937620,8010,7610,7610,-400,-4.99,7990,-20,-0.25,7610,7610,1399-6-29
429,كيسون,شركت كيسون,132,1015795,22621754650,22958,22270,22270,-688,-3.0,22611,-347,-1.51,22270,22270,1399-6-29
430,سپاس,صندوق س. پاداش سهامداري توسعه1,131,3141682,31670469710,10050,10080,10090,40,0.4,10080,30,0.3,10050,10100,1399-6-29
431,داسوه,داروسازي‌ اسوه‌,129,498250,16841011350,35570,33800,33800,-1770,-4.98,34940,-630,-1.77,33800,33830,1399-6-29
432,كتوكا,توليدي و خدمات صنايع نسوز توكا,129,45419,6578033770,152452,144830,144830,-7622,-5.0,151396,-1056,-0.69,144830,144830,1399-6-29
433,شپلي,پلي اكريل ايران,124,560774,4642087172,8533,8278,8278,-255,-2.99,8472,-61,-0.71,8278,8278,1399-6-29
434,حاريا,كشتيراني آريا,122,809598,20474733420,24554,25290,25290,736,3.0,25286,732,2.98,25290,25290,1399-6-29
435,اخزا815,اسنادخزانه-م15بودجه98-010406,121,87176,64034333440,734833,732480,735000,167,0.02,734541,-292,-0.04,732480,738076,1399-6-29
436,وگستر,گسترش سرمايه گذاري ايرانيان,121,276959,5885101791,22367,21249,21249,-1118,-5.0,22228,-139,-0.62,21249,21249,1399-6-29
437,اعتلا,شركت سرمايه گذاري اعتلاء البرز,120,858645,10392180435,12739,12103,12103,-636,-4.99,12600,-139,-1.09,12103,12103,1399-6-29
438,ثعتما,س. ساختماني اعتماد گستر,118,273342,8693642310,30879,31805,31805,926,3.0,31270,391,1.27,31805,31805,1399-6-29
439,ضجار7022,اختيارخ وتجارت-2800-1399/07/22,117,2271,1853651000,902,900,839,-63,-6.98,816,-86,-9.53,501,950,1399-6-29
440,تسه9805,امتياز تسهيلات مسكن مرداد98,112,1486,1183398355,827025,785674,785700,-41325,-5.0,796365,-30660,-3.71,785674,868376,1399-6-29
441,ديران,ايران‌دارو,111,249377,5655870360,23870,22680,22680,-1190,-4.99,23730,-140,-0.59,22680,22680,1399-6-29
442,دمعيار,صندوق س. توازن معيار-د,111,2745006,27790158557,10083,10109,10133,50,0.5,10124,41,0.41,10093,10133,1399-6-29
443,فسپا,گروه‌صنعتي‌سپاهان‌,110,713353,33606059830,49580,47110,47110,-2470,-4.98,47830,-1750,-3.53,47110,47110,1399-6-29
444,زمگسا,كشاورزي‌ ودامپروي‌ مگسال‌,108,103964,2917249840,29530,28060,28060,-1470,-4.98,29440,-90,-0.3,28060,28070,1399-6-29
445,كمرجان,بازرگاني و توليدي مرجان كار,108,76188,2917013210,40300,38300,38285,-2015,-5.0,40176,-124,-0.31,38285,38300,1399-6-29
446,خفولا,خدمات فني فولاد يزد,107,152375,4452245125,30756,29219,29219,-1537,-5.0,30396,-360,-1.17,29219,29219,1399-6-29
447,همپنا912,اختيارف ت مپنا-23410-99/12/11,102,570000,570000,1,1,1,0,0.0,1,0,0.0,1,1,1399-6-29
448,سمايه,بانك سرمايه,101,495712,4668119904,9708,9417,9417,-291,-3.0,9638,-70,-0.72,9417,9417,1399-6-29
449,گكوثر,هتل پارسيان كوثر اصفهان,101,52595,9763683205,195409,185639,185639,-9770,-5.0,193401,-2008,-1.03,185639,185639,1399-6-29
450,ثروتم,صندوق س. ثروت آفرين پارسيان-س,99,27030,2746570440,101395,101100,101000,-395,-0.39,101612,217,0.21,101000,103190,1399-6-29
451,ساربيل,سيمان آرتا اردبيل,99,28343,3119714010,115860,110070,110070,-5790,-5.0,115480,-380,-0.33,110070,110070,1399-6-29
452,سدشت,صنايع سيمان دشتستان,99,54730,2123524000,36960,38800,38800,1840,4.98,37030,70,0.19,38800,38800,1399-6-29
453,وآذر,سرمايه‌گذاري‌توسعه‌آذربايجان‌,99,32237,3852321500,125780,119500,119500,-6280,-4.99,125270,-510,-0.41,119500,119500,1399-6-29
454,بزاگرس,نيروگاه زاگرس كوثر,98,777827,12159769491,16455,15633,15633,-822,-5.0,16245,-210,-1.28,15633,15633,1399-6-29
455,آسام,صندوق س.آرمان سپهر آشنا-م,98,40630,4499247600,112020,112000,110000,-2020,-1.8,110737,-1283,-1.15,109000,112000,1399-6-29
456,وملي,گروه‌ صنعتي‌ ملي‌ (هلدينگ‌,98,5553,3142387170,595670,565890,565890,-29780,-5.0,594000,-1670,-0.28,565890,565890,1399-6-29
457,هبركت912,اختيارف ت بركت-22100-99/12/17,97,1331000,1331000,1,1,1,0,0.0,1,0,0.0,1,1,1399-6-29
458,هپارس912,اختيارف ت وپارس-5920-99/12/10,97,3700000,3700000,1,1,1,0,0.0,1,0,0.0,1,1,1399-6-29
459,شكف,كف,97,248318,10134602534,40013,40813,40813,800,2.0,40808,795,1.99,40813,40813,1399-6-29
460,خاذين,سايپاآذين‌,96,622734,4956962640,8370,7960,7960,-410,-4.9,8330,-40,-0.48,7960,7960,1399-6-29
461,قپيرا,فرآورده‌هاي‌غدايي‌وقندپيرانشهر,94,36059,2779984230,80680,76850,76650,-4030,-5.0,80470,-210,-0.26,76650,79970,1399-6-29
462,وليز,ليزينگ‌ايران‌,92,304238,2978490020,10300,9790,9790,-510,-4.95,10270,-30,-0.29,9790,9790,1399-6-29
463,اخزا808,اسنادخزانه-م8بودجه98-000817,90,58313,47878292120,821194,820101,820654,-540,-0.07,821057,-137,-0.02,820101,823000,1399-6-29
464,آساميد,صندوق س.مشترك آسمان اميد -د,90,2401174,25665526756,10674,10680,10680,6,0.06,10689,15,0.14,10671,10705,1399-6-29
465,غبهنوش,بهنوش‌ ايران‌,89,113662,7155022900,66260,62950,62950,-3310,-5.0,65760,-500,-0.75,62950,62950,1399-6-29
466,دكيمي,كيميدارو,87,135238,3597330800,28000,26600,26600,-1400,-5.0,27890,-110,-0.39,26600,26600,1399-6-29
467,حآسا,آسيا سير ارس,87,66954,805925298,12670,12037,12037,-633,-5.0,12659,-11,-0.09,12037,12037,1399-6-29
468,زقيام,كشت و دام قيام اصفهان,87,127359,3755434833,31038,29487,29487,-1551,-5.0,30915,-123,-0.4,29487,29487,1399-6-29
469,سكرد,سيمان كردستان,86,249609,2660831940,11220,10660,10660,-560,-4.99,11190,-30,-0.27,10660,10660,1399-6-29
470,خريخت,صنايع‌ريخته‌گري‌ايران‌,86,293445,1775342250,6360,6050,6050,-310,-4.87,6350,-10,-0.16,6050,6050,1399-6-29
471,قشهد,شهد,85,96110,3041028400,33300,31640,31640,-1660,-4.98,33190,-110,-0.33,31640,32000,1399-6-29
472,كاسپين,داروسازي كاسپين تامين,83,120999,3183846687,27697,26313,26313,-1384,-5.0,27604,-93,-0.34,26313,26313,1399-6-29
473,سصوفي,سيمان‌ صوفيان‌,83,172268,3316159000,20260,19250,19250,-1010,-4.99,20190,-70,-0.35,19250,19250,1399-6-29
474,كدما,معدني‌ دماوند,83,47710,6724724500,134240,140950,140950,6710,5.0,135100,860,0.64,140950,140950,1399-6-29
475,وايران,ليزينگ ايرانيان,82,293117,3197906470,11480,10910,10910,-570,-4.97,11440,-40,-0.35,10910,10910,1399-6-29
476,ضچاد7024,اختيارخ كچاد-23300-1399/07/07,79,1598,1373537000,721,850,900,179,24.83,860,139,19.28,500,995,1399-6-29
477,قشكر,شكرشاهرود,79,221341,10071015500,47890,45500,45500,-2390,-4.99,47380,-510,-1.06,45500,45500,1399-6-29
478,ضجار7026,اختيارخ وتجارت-3600-1399/07/22,78,1738,575368000,388,250,399,11,2.84,331,-57,-14.69,250,469,1399-6-29
479,هغدير912,اختيارف ت غدير-17380-99/12/16,78,1704249,1704249,1,1,1,0,0.0,1,0,0.0,1,1,1399-6-29
480,افران,صندوق س افرا نماد پايدار-ثابت,76,1701162,19887921960,11700,11710,11700,0,0.0,11690,-10,-0.09,11620,11710,1399-6-29
481,غمينو,شركت صنايع غذايي مينو شرق,76,142915,2101422160,15477,14704,14704,-773,-4.99,15443,-34,-0.22,14704,14704,1399-6-29
482,قشرين,قند شيرين خراسان,73,223747,4732472797,21805,21151,21151,-654,-3.0,21645,-160,-0.73,21151,21151,1399-6-29
483,هملت911,اختيارف ت ملت-6770-99/11/25,73,2240000,2240000,1,1,1,0,0.0,1,0,0.0,1,1,1399-6-29
484,وآفري,بيمه كارآفرين,71,1453464,20870289576,13941,14359,14359,418,3.0,14359,418,3.0,14359,14359,1399-6-29
485,رتكو,كنترل‌خوردگي‌تكين‌كو,70,166786,3095548160,19530,18560,18560,-970,-4.97,19470,-60,-0.31,18560,18560,1399-6-29
486,فيروزا,صندوق بادرآمد ثابت فيروزه آسيا,69,2347867,48272548800,20600,20650,20560,-40,-0.19,20560,-40,-0.19,20540,20650,1399-6-29
487,وشهر,بانك شهر,69,368186,3491876024,9677,9484,9484,-193,-1.99,9666,-11,-0.11,9484,9484,1399-6-29
488,اخزا817,اسنادخزانه-م17بودجه98-010512,68,112418,80986591161,721149,722000,720214,-935,-0.13,720406,-743,-0.1,719500,722000,1399-6-29
489,شكبير,پتروشيمي اميركبير,67,59211,3628094814,63169,61274,61274,-1895,-3.0,63091,-78,-0.12,61274,61274,1399-6-29
490,واحصا,احياء صنايع خراسان,67,202375,3137014875,15980,15501,15501,-479,-3.0,15903,-77,-0.48,15501,15501,1399-6-29
491,لكما,كارخانجات‌مخابراتي‌ايران‌,67,186639,2154747255,12152,11545,11545,-607,-5.0,12083,-69,-0.57,11545,11545,1399-6-29
492,وتوصا,گروه س توسعه صنعتي ايران,67,78799,1154405350,15420,14650,14650,-770,-4.99,15400,-20,-0.13,14650,14650,1399-6-29
493,زنجان,صنايع كشاورزي وكود زنجان,67,218395,1517626855,7163,6949,6949,-214,-2.99,7146,-17,-0.24,6949,6949,1399-6-29
494,زكشت,كشاورزي مكانيزه اصفهان كشت,65,228788,7395114524,34024,32323,32323,-1701,-5.0,33759,-265,-0.78,32323,32323,1399-6-29
495,ضخود7056,اختيارخ خودرو-3800-1399/07/09,64,3072,347594000,200,190,110,-90,-45.0,113,-87,-43.5,81,190,1399-6-29
496,فلوله,لوله‌وماشين‌سازي‌ايران‌,63,109517,2836490300,27260,25900,25900,-1360,-4.99,27180,-80,-0.29,25900,25900,1399-6-29
497,حتوكا,حمل‌ونقل‌توكا,63,249591,3796279110,16010,15210,15210,-800,-5.0,15950,-60,-0.37,15210,15210,1399-6-29
498,ولملت,واسپاري ملت,62,301951,3632470530,12660,12030,12030,-630,-4.98,12610,-50,-0.39,12030,12030,1399-6-29
499,اخزا903,اسنادخزانه-م3بودجه99-011110,62,77793,51214555844,660764,658599,659000,-1764,-0.27,658344,-2420,-0.37,628058,664000,1399-6-29
500,خشرق,الكتريك‌ خودرو شرق‌,60,45692,861294200,19840,18850,18850,-990,-4.99,19820,-20,-0.1,18850,18850,1399-6-29
501,داريك,صندوق س.اعتماد داريك-د,60,273615,2760560125,10079,10100,10090,11,0.11,10089,10,0.1,10060,10100,1399-6-29
502,ولانا,شركت ليزينگ آريا دانا,58,149886,3688844346,25372,24611,24611,-761,-3.0,25227,-145,-0.57,24611,24611,1399-6-29
503,اخزا811,اسنادخزانه-م11بودجه98-001013,57,132166,105931486490,801466,800090,801552,86,0.01,801503,37,0.0,800090,802000,1399-6-29
504,لپارس,پارس‌ الكتريك‌,56,4390,1636153000,392310,372700,372700,-19610,-5.0,391630,-680,-0.17,372700,372700,1399-6-29
505,اخزا816,اسنادخزانه-م16بودجه98-010503,56,81327,58863364088,724134,725300,723700,-434,-0.06,723786,-348,-0.05,723300,725300,1399-6-29
506,فاهواز,نورد و لوله اهواز,55,204323,4112409021,20537,20127,20127,-410,-2.0,20500,-37,-0.18,20127,20127,1399-6-29
507,سدور,سيمان‌ دورود,55,149607,1243234170,8740,8310,8310,-430,-4.92,8730,-10,-0.11,8310,8310,1399-6-29
508,بالاس,مهندسي ساختمان تاسيسات راه آهن,54,31397,1562785675,52394,49775,49775,-2619,-5.0,52308,-86,-0.16,49775,49775,1399-6-29
509,دكوثر,داروسازي‌ كوثر,53,89854,2335305460,27350,25990,25990,-1360,-4.97,27280,-70,-0.26,25990,25990,1399-6-29
510,بالبر,كابل‌ البرز,53,49856,1297253120,27380,26020,26020,-1360,-4.97,27340,-40,-0.15,26020,26020,1399-6-29
511,ضخود7068,اختيارخ خودرو-8000-1399/07/09,52,2540,12857000,3,3,4,1,33.33,5,2,66.67,3,10,1399-6-29
512,ثنوسا,نوسازي‌وساختمان‌تهران‌,51,325069,3946337660,12770,12140,12140,-630,-4.93,12720,-50,-0.39,12140,12140,1399-6-29
513,اخزا809,اسنادخزانه-م9بودجه98-000923,51,72949,59020385197,809257,805071,810000,743,0.09,809064,-193,-0.02,804009,810000,1399-6-29
514,فولاي,صنايع فولاد آلياژي يزد,51,32509,1657406347,53666,50983,50983,-2683,-5.0,53572,-94,-0.18,50983,50983,1399-6-29
515,اخزا821,اسنادخزانه-م21بودجه98-020906,50,61467,35787906375,581475,582999,582200,725,0.12,582230,755,0.13,582200,583900,1399-6-29
516,تكمبا,كمباين‌ سازي‌ ايران‌,49,246899,2567749600,10940,10400,10400,-540,-4.94,10910,-30,-0.27,10400,10400,1399-6-29
517,خكاوه,سايپا ديزل,49,120899,798658794,6810,6606,6606,-204,-3.0,6802,-8,-0.12,6606,6606,1399-6-29
518,اخزا818,اسنادخزانه-م18بودجه98-010614,48,46766,33149095748,708935,708061,709000,65,0.01,708829,-106,-0.01,707019,709800,1399-6-29
519,زعف9908پ16,زعفران9908نگين بيرجند(پ),48,16208,1460280118,86204,88000,90660,4456,5.17,90096,3892,4.51,88000,90660,1399-6-29
520,خاور,ايران خودرو ديزل,48,247570,1773096340,7383,7162,7162,-221,-2.99,7363,-20,-0.27,7162,7162,1399-6-29
521,هبهرن912,اختيارف ت شبهرن-74590-99/12/02,47,140000,140000,1,1,1,0,0.0,1,0,0.0,1,1,1399-6-29
522,زبينا,كشاورزي و دامپروري بينالود,47,48378,2483387874,54034,51333,51333,-2701,-5.0,53893,-141,-0.26,51333,51333,1399-6-29
523,هاباد912,اختيارف ت آبادا-30100-99/12/12,46,612866,612866,1,1,1,0,0.0,1,0,0.0,1,1,1399-6-29
524,آبين,كشت و صنعت آبشيرين,45,282202,1230118518,4493,4359,4359,-134,-2.98,4485,-8,-0.18,4359,4359,1399-6-29
525,هرانف912,اختيارف ت رانفور32120-99/12/03,45,320000,320000,1,1,1,0,0.0,1,0,0.0,1,1,1399-6-29
526,غگلستا,شير پاستوريزه پگاه گلستان,45,82290,1261670280,16138,15332,15332,-806,-4.99,16117,-21,-0.13,15332,15332,1399-6-29
527,وبرق,س.کارکنان صنعت برق زنجان وقزوي,45,37386,7809785856,219890,208896,208896,-10994,-5.0,215371,-4519,-2.06,208896,208896,1399-6-29
528,اخزا721,اسنادخزانه-م21بودجه97-000728,44,28331,23544876674,833984,832000,831200,-2784,-0.33,831064,-2920,-0.35,830500,836000,1399-6-29
529,قشير,قند شيروان قوچان و بجنورد,43,100117,2604143287,27380,26011,26011,-1369,-5.0,27305,-75,-0.27,26011,26011,1399-6-29
530,غاذر,كشت‌وصنعت‌پياذر,43,31296,2800992000,94210,89500,89500,-4710,-5.0,93930,-280,-0.3,89500,89500,1399-6-29
531,اوصتا,صندوق انديشه ورزان صباتامين -د,42,582740,9729153475,16690,16700,16696,6,0.04,16696,6,0.04,16695,16729,1399-6-29
532,كپشير,پشم‌شيشه‌ايران‌,41,21880,1158764800,55740,52960,52960,-2780,-4.99,55670,-70,-0.13,52960,52960,1399-6-29
533,ولشرق,ليزينگ ايران و شرق,41,340841,2934981851,9064,8611,8611,-453,-5.0,9036,-28,-0.31,8611,8611,1399-6-29
534,زماهان,مجتمع توليد گوشت مرغ ماهان,41,59399,1521505385,26963,25615,25615,-1348,-5.0,26920,-43,-0.16,25615,25615,1399-6-29
535,شفارا,پتروشيمي فارابي,40,485748,2627410932,5576,5409,5409,-167,-2.99,5553,-23,-0.41,5409,5409,1399-6-29
536,زعف9908پ06,زعفران 9908پوشالمعمول زرين(پ),40,12430,837398770,64722,65110,66500,1778,2.75,67369,2647,4.09,65100,68000,1399-6-29
537,دقاضي,داروسازي شهيد قاضي,39,46443,4442551608,98614,95656,95656,-2958,-3.0,97937,-677,-0.69,95656,95656,1399-6-29
538,اخزا814,اسنادخزانه-م14بودجه98-010318,39,76250,56570465498,741001,740000,741700,699,0.09,741908,907,0.12,738412,742600,1399-6-29
539,خزر,فنرسازي‌زر,39,180922,1590304380,9250,8790,8790,-460,-4.97,9230,-20,-0.22,8790,8790,1399-6-29
540,ركيش,كارت اعتباري ايران كيش,38,80050,1340037000,17620,16740,16740,-880,-4.99,17600,-20,-0.11,16740,16740,1399-6-29
541,هشير911,اختيارف ت شيراز-73480-99/11/27,38,144000,144000,1,1,1,0,0.0,1,0,0.0,1,1,1399-6-29
542,زعف9908پ08,زعفران9908نگين روستا(پ),38,13787,1206221825,87131,86800,90660,3529,4.05,87490,359,0.41,85010,90660,1399-6-29
543,كگاز,شيشه‌ و گاز,38,34767,869870340,26330,25020,25020,-1310,-4.98,26310,-20,-0.08,25020,25020,1399-6-29
544,اخزا806,اسنادخزانه-م6بودجه98-000519,38,31757,27289326805,860435,858716,859171,-1264,-0.15,859317,-1118,-0.13,858010,861000,1399-6-29
545,سخزر,سيمان‌ خزر,37,49452,1479109320,31480,29910,29910,-1570,-4.99,31430,-50,-0.16,29910,29910,1399-6-29
546,زعف9908پ05,زعفران9908نگين زرين(پ),37,5413,482570140,86510,87500,90660,4150,4.8,89150,2640,3.05,86500,90660,1399-6-29
547,وآرينح,ح. شركت توسعه اقتصادي آرين,36,164440,613854520,3848,3733,3733,-115,-2.99,3733,-115,-2.99,3733,3733,1399-6-29
548,تكنار,مجتمع معادن مس تكنار,36,72781,5369127151,71623,73771,73771,2148,3.0,72183,560,0.78,73771,73771,1399-6-29
549,كمينا,شيشه سازي مينا,35,40319,1358064877,34724,33683,33683,-1041,-3.0,34651,-73,-0.21,33683,33683,1399-6-29
550,شتولي,تولي‌پرس‌,35,61816,1031214512,17022,16682,16682,-340,-2.0,16986,-36,-0.21,16682,16682,1399-6-29
551,شفارس,صنايع‌ شيميايي‌ فارس‌,35,28131,940700640,35200,33440,33440,-1760,-5.0,35170,-30,-0.09,33440,33440,1399-6-29
552,ضچاد7020,اختيارخ كچاد-17300-1399/07/07,35,274,1260220000,4279,4100,4790,511,11.94,4599,320,7.48,4000,5000,1399-6-29
553,اخزا902,اسنادخزانه-م2بودجه99-011019,34,55141,36749819235,667603,667000,663100,-4503,-0.67,666470,-1133,-0.17,663030,671000,1399-6-29
554,ولغدر,ليزينگ‌خودروغدير,34,308071,5671587110,19370,18410,18410,-960,-4.96,19260,-110,-0.57,18410,18410,1399-6-29
555,ارمغان,ص سرمايه گذاري ارمغان ايرانيان,34,260201,2621375520,10060,10070,10070,10,0.1,10070,10,0.1,10070,10080,1399-6-29
556,نگين,ص.س. زمين و ساختمان نگين شهرري,34,12949,660399000,51000,51000,51000,0,0.0,51000,0,0.0,51000,51000,1399-6-29
557,خوساز,محورسازان‌ايران‌خودرو,33,146939,1417961350,10150,9650,9650,-500,-4.93,10140,-10,-0.1,9650,9650,1399-6-29
558,ضصاد8012,اختيارخ وبصادر-2800-1399/08/11,33,531,907525000,1524,1200,1680,156,10.24,1709,185,12.14,1200,2000,1399-6-29
559,تسه9804,امتياز تسهيلات مسكن تير98,33,440,353219753,843497,801323,801323,-42174,-5.0,802772,-40725,-4.83,801323,805000,1399-6-29
560,هجم911,اختيارف ت جم-38645-99/11/28,33,160000,160000,1,1,1,0,0.0,1,0,0.0,1,1,1399-6-29
561,سايرا,ايرانيت‌,32,226599,8117328521,34753,33363,33364,-1389,-4.0,35595,842,2.42,33363,36140,1399-6-29
562,خكار,ايركا پارت صنعت,32,38135,1398029100,38580,36660,36660,-1920,-4.98,38520,-60,-0.16,36660,36660,1399-6-29
563,ختراك,ريخته‌گري‌ تراكتورسازي‌ ايران‌,32,26010,579242700,23440,22270,22270,-1170,-4.99,23430,-10,-0.04,22270,22270,1399-6-29
564,ضصاد8019,اختيارخ وبصادر-4200-1399/08/11,31,239,145492000,766,600,695,-71,-9.27,609,-157,-20.5,400,750,1399-6-29
565,ضصاد8020,اختيارخ وبصادر-4400-1399/08/11,31,503,271606000,608,644,405,-203,-33.39,540,-68,-11.18,355,799,1399-6-29
566,اخزا807,اسنادخزانه-م7بودجه98-000719,31,33336,27817548455,835579,831112,834156,-1423,-0.17,834460,-1119,-0.13,831111,839889,1399-6-29
567,قاسم,قاسم ايران,31,52632,806164344,16123,15317,15317,-806,-5.0,16109,-14,-0.09,15317,15317,1399-6-29
568,قلرست,قند لرستان‌,31,45013,1170788130,27370,26010,26010,-1360,-4.97,27340,-30,-0.11,26010,26010,1399-6-29
569,كرونا2,تامين مالي جمعي صرفا اهداي سود,30,2042,20420000,10000,10000,10000,0,0.0,10000,0,0.0,10000,10000,1399-6-29
570,ضخود7059,اختيارخ خودرو-4400-1399/07/09,30,2045,39425000,16,10,15,-1,-6.25,19,3,18.75,10,30,1399-6-29
571,ساراب,سيمان‌ داراب‌,30,79959,990692010,13040,12390,12390,-650,-4.98,13030,-10,-0.08,12390,12390,1399-6-29
572,فجام,جام‌دارو,29,18863,1106692210,61750,58670,58670,-3080,-4.99,61680,-70,-0.11,58670,58670,1399-6-29
573,كصدف,كاشي صدف سرام استقلال آباده,28,261756,3773212740,14133,14415,14415,282,2.0,14237,104,0.74,14415,14415,1399-6-29
574,سكه0012پ01,سكه تمام بهارتحويلي 1روزه رفاه,28,18600,23016700200,1225205,1237457,1237457,12252,1.0,1237457,12252,1.0,1237457,1237457,1399-6-29
575,ضجار7031,اختيارخ وتجارت-4600-1399/07/22,28,1137,155405000,134,150,107,-27,-20.15,137,3,2.24,107,173,1399-6-29
576,ضغدر8046,اختيارخ وغدير-19000-1399/08/26,28,511,1716601000,3054,3000,3000,-54,-1.77,3359,305,9.99,2900,3600,1399-6-29
577,كقزوي,شيشه‌ قزوين‌,28,89399,913925977,10761,10223,10223,-538,-5.0,10735,-26,-0.24,10223,10223,1399-6-29
578,فنورد,نوردوقطعات‌ فولادي‌,27,18408,2254795920,116660,122490,122490,5830,5.0,116910,250,0.21,122490,122490,1399-6-29
579,افرا,افرانت,27,27305,1788477500,68947,65500,65500,-3447,-5.0,68817,-130,-0.19,65500,65500,1399-6-29
580,ضجار7018,اختيارخ وتجارت-2000-1399/07/22,27,530,833947000,1579,1599,1650,71,4.5,1573,-6,-0.38,1400,1700,1399-6-29
581,همعاد911,اختيارف ت معادن-19080-99/11/19,27,390000,390000,1,1,1,0,0.0,1,0,0.0,1,1,1399-6-29
582,سنوين,سرمايه گذاري اقتصاد نوين,27,22377,248854617,11347,11121,11121,-226,-1.99,11341,-6,-0.05,11121,11121,1399-6-29
583,اخزا804,اسنادخزانه-م4بودجه98-000421,27,34025,29576552048,867884,868001,869500,1616,0.19,869259,1375,0.16,868000,872000,1399-6-29
584,غبشهر,صنعتي‌ بهشهر,26,22202,484681930,21920,21970,21600,-320,-1.46,21920,0,0.0,20840,21970,1399-6-29
585,سفار,سيمان‌فارس‌,26,7081,736140760,109430,103960,103960,-5470,-5.0,109350,-80,-0.07,103960,103960,1399-6-29
586,ضملي8077,اختيارخ فملي -29750-1399/08/06,26,118,1020074000,9434,4000,8500,-934,-9.9,8645,-789,-8.36,4000,9979,1399-6-29
587,ثعمرا,عمران و توسعه شاهد,26,34210,919496380,28292,26878,26878,-1414,-5.0,28265,-27,-0.1,26878,26878,1399-6-29
588,ساذري,آذريت‌,26,6211,1163755070,178448,187370,187370,8922,5.0,178942,494,0.28,187370,187370,1399-6-29
589,سخند,صندوق س.سپهرخبرگان نفت-د,25,21280,213290800,10012,10039,10011,-1,-0.01,10023,11,0.11,10010,10039,1399-6-29
590,غشاذر,پگاه‌آذربايجان‌غربي‌,25,44081,973308480,23240,22080,22080,-1160,-4.99,23220,-20,-0.09,22080,22080,1399-6-29
591,اطلس2,صندوق س.توسعه اندوخته آينده-س,25,250000,250000,215111,1,1,-215110,-100.0,1,-215110,-100.0,1,1,1399-6-29
592,فبيرا,بسته‌ بندي‌ ايران‌,25,261087,1325277612,5232,5076,5076,-156,-2.98,5221,-11,-0.21,5076,5076,1399-6-29
593,ثالوند,سرمايه گذاري مسكن الوند,25,20618,283188230,14457,13735,13735,-722,-4.99,14453,-4,-0.03,13735,13735,1399-6-29
594,كپرور,فرآوري زغال سنگ پروده طبس,25,56862,2372453226,43918,41723,41723,-2195,-5.0,43808,-110,-0.25,41723,41723,1399-6-29
595,بنيرو,نيروترانس‌,25,7864,540571360,72350,68740,68740,-3610,-4.99,72310,-40,-0.06,68740,68740,1399-6-29
596,دفرا,فرآورده‌هاي‌ تزريقي‌ ايران‌,25,8780,239342800,28690,27260,27260,-1430,-4.98,28680,-10,-0.03,27260,27260,1399-6-29
597,ضپاس7017,اختيارخ وپارس-4400-1399/07/30,24,367,455845000,1350,1580,1000,-350,-25.93,1242,-108,-8.0,1000,1590,1399-6-29
598,زشريف,كشت وصنعت شريف آباد,24,30039,808860153,28344,26927,26927,-1417,-5.0,28320,-24,-0.08,26927,26927,1399-6-29
599,پلوله,گازلوله‌,24,64585,1331807285,20417,20621,20621,204,1.0,20471,54,0.26,20621,20621,1399-6-29
600,اخزا703,اسنادخزانه-م3بودجه97-990721,24,115412,113881577183,987131,989000,987898,767,0.08,986739,-392,-0.04,973804,989000,1399-6-29
601,سصفها,سيمان‌اصفهان‌,23,15868,1739926200,115420,109650,109650,-5770,-5.0,115210,-210,-0.18,109650,109650,1399-6-29
602,ضخود7048,اختيارخ خودرو-2800-1399/07/09,22,443,303069000,600,700,650,50,8.33,684,84,14.0,520,720,1399-6-29
603,ثغرب,شركت سرمايه گذاري مسكن شمالغرب,22,25419,348392814,14427,13706,13706,-721,-5.0,14422,-5,-0.03,13706,13706,1399-6-29
604,بايكا,كارخانجات كابلسازي ‌ايران‌,22,31730,1336531060,43424,42122,42122,-1302,-3.0,43334,-90,-0.21,42122,42122,1399-6-29
605,ضغدر8043,اختيارخ وغدير-16000-1399/08/26,22,150,623925000,4098,4490,3800,-298,-7.27,4159,61,1.49,3700,5000,1399-6-29
606,ضجار7016,اختيارخ وتجارت-1800-1399/07/22,22,310,548554000,1785,1800,1709,-76,-4.26,1770,-15,-0.84,1610,1900,1399-6-29
607,پلاسك,پلاسكوكار,22,80137,730849440,9600,9120,9120,-480,-5.0,9590,-10,-0.1,9120,9120,1399-6-29
608,زعف9908پ14,زعفران9908پوشالمعمول نوين(پ),22,3544,242284519,68144,65051,70797,2653,3.89,68365,221,0.32,65051,70998,1399-6-29
609,سكه0011پ02,سكه تمام بهارتحويلي 1روزه ملت,21,12500,15468212500,1225205,1237457,1237457,12252,1.0,1237457,12252,1.0,1237457,1237457,1399-6-29
610,سيلام,سيمان‌ ايلام‌,21,31097,319366190,10810,10270,10270,-540,-5.0,10810,0,0.0,10270,10270,1399-6-29
611,هنفت912,اختيارف ت نفت-15330-99/12/04,20,360000,360000,1,1,1,0,0.0,1,0,0.0,1,1,1399-6-29
612,اخزا812,اسنادخزانه-م12بودجه98-001111,20,61870,49063658586,793668,791508,794000,332,0.04,793012,-656,-0.08,791508,794117,1399-6-29
613,غدشت,دشت‌ مرغاب‌,20,1788,526029600,309680,294200,294200,-15480,-5.0,309510,-170,-0.05,294200,294200,1399-6-29
614,سكه9912پ04,سكه تمام بهارتحويل1روزه صادرات,20,10500,12993298500,1225205,1237457,1237457,12252,1.0,1237457,12252,1.0,1237457,1237457,1399-6-29
615,صگل411,ص اجاره گل گهر 411- 3 ماهه 17%,20,2496,2506041200,1005633,1013000,1000000,-5633,-0.56,1004023,-1610,-0.16,1000000,1015600,1399-6-29
616,زعف9908پ12,زعفران9908پوشالمعمول سحرخيز(پ),20,4810,340983700,68208,69000,68050,-158,-0.23,70891,2683,3.93,67000,71550,1399-6-29
617,فنوال,نورد آلومينيوم‌,20,10497,381775890,38280,36370,36370,-1910,-4.99,38260,-20,-0.05,36370,36370,1399-6-29
618,هفارس912,اختيارف ت فارس-14576-99/12/13,19,900000,900000,1,1,1,0,0.0,1,0,0.0,1,1,1399-6-29
619,ضصاد8014,اختيارخ وبصادر-3200-1399/08/11,19,217,301008000,1275,1200,1400,125,9.8,1387,112,8.78,1200,1480,1399-6-29
620,واعتبار,سرمايه گذاري اعتبار ايران,19,39481,309136230,8240,7830,7830,-410,-4.98,8240,0,0.0,7830,7830,1399-6-29
621,پارتا,مجتمع‌صنعتي‌آرتاويل‌تاير,19,68833,4285542580,64185,62260,62260,-1925,-3.0,63909,-276,-0.43,62260,62260,1399-6-29
622,ضخود7058,اختيارخ خودرو-4200-1399/07/09,19,497,14571000,25,20,49,24,96.0,29,4,16.0,20,55,1399-6-29
623,ضصاد8008,اختيارخ وبصادر-2000-1399/08/11,18,170,353239000,2237,1999,2250,13,0.58,2078,-159,-7.11,1999,2549,1399-6-29
624,وثنو,سرمايه گذاري ساختماني نوين,18,15038,272789320,18701,18140,18140,-561,-3.0,18693,-8,-0.04,18140,18140,1399-6-29
625,ثنظام,س. ساختماني نظام مهندسي ايران,18,43732,2121526784,50012,48512,48512,-1500,-3.0,49848,-164,-0.33,48512,48512,1399-6-29
626,ضخود7053,اختيارخ خودرو-3200-1399/07/09,18,112,32510000,580,350,280,-300,-51.72,290,-290,-50.0,251,350,1399-6-29
627,كطبس,ذغال‌سنگ‌ نگين‌ ط‌بس‌,18,7101,363429180,53870,51180,51180,-2690,-4.99,53850,-20,-0.04,51180,51180,1399-6-29
628,اخزا813,اسنادخزانه-م13بودجه98-010219,18,31378,23605579070,751171,752000,752200,1029,0.14,752297,1126,0.15,752000,754999,1399-6-29
629,ضچاد7025,اختيارخ كچاد-26000-1399/07/07,18,669,162906000,165,160,340,175,106.06,244,79,47.88,160,450,1399-6-29
630,لخانه,لوازم‌ خانگي‌ پارس‌,18,36620,2064965180,59356,56389,56389,-2967,-5.0,59034,-322,-0.54,56389,56389,1399-6-29
631,اخزا713,اسنادخزانه-م13بودجه97-000518,17,13455,11534838786,857305,855000,858362,1057,0.12,857290,-15,0.0,853704,860000,1399-6-29
632,اخزا820,اسنادخزانه-م20بودجه98-020806,17,18261,10736581349,588000,587003,590001,2001,0.34,587951,-49,-0.01,587002,590001,1399-6-29
633,كهرام,توليدي گرانيت بهسرام,17,70749,4274371584,62284,60416,60416,-1868,-3.0,61872,-412,-0.66,60416,60416,1399-6-29
634,شمواد,توليد مواداوليه الياف مصنوعي,16,33262,2084596064,65970,62672,62672,-3298,-5.0,65608,-362,-0.55,62672,62672,1399-6-29
635,ثشرق,سرمايه گذاري مسكن شمال شرق,16,91644,667168320,7660,7280,7280,-380,-4.96,7650,-10,-0.13,7280,7280,1399-6-29
636,ثپرديس,سرمايه گذاري مسكن پرديس,16,36893,510082618,14553,13826,13826,-727,-5.0,14545,-8,-0.05,13826,13826,1399-6-29
637,لخزر,پارس‌ خزر,16,2797,608263590,228910,217470,217470,-11440,-5.0,228760,-150,-0.07,217470,217470,1399-6-29
638,هترول911,اختيارف ت پترول-14730-99/11/15,16,500000,500000,1,1,1,0,0.0,1,0,0.0,1,1,1399-6-29
639,پست9908-02,پسته فندقي32-30طلاسبززرند9908,16,542,797405654,1503447,1578619,1462000,-41447,-2.76,1471228,-32219,-2.14,1435000,1578619,1399-6-29
640,افران2,صندوق س افرا نماد پايدار-ثابت,15,1500000,1500000,11700,1,1,-11699,-99.99,1,-11699,-99.99,1,1,1399-6-29
641,زير0003پ01,زيره سبز0003كيميابذر(پ),15,509,239954985,457600,464999,480400,22800,4.98,471424,13824,3.02,464999,480400,1399-6-29
642,ثزاگرس,سرمايه گذاري توسعه عمران زاگرس,15,24729,585904197,24425,23693,23693,-732,-3.0,24403,-22,-0.09,23693,23693,1399-6-29
643,كشرق,صنعتي و معدني شمال شرق شاهرود,15,11868,1009041096,89496,85022,85022,-4474,-5.0,89401,-95,-0.11,85022,85022,1399-6-29
644,ضخود7062,اختيارخ خودرو-5000-1399/07/09,14,329,3916000,7,4,10,3,42.86,12,5,71.43,3,100,1399-6-29
645,دروز,داروسازي‌ روزدارو,14,4833,94823460,20650,19620,19620,-1030,-4.99,20650,0,0.0,19620,19620,1399-6-29
646,شرنگي,شيميايي رنگين,14,5932,713631464,124022,120302,120302,-3720,-3.0,123885,-137,-0.11,120302,120302,1399-6-29
647,ضسپا8018,اختيارخ خساپا-2400-1399/08/26,14,161,161000000,1029,1000,1000,-29,-2.82,1000,-29,-2.82,1000,1000,1399-6-29
648,ضخود7055,اختيارخ خودرو-3600-1399/07/09,14,135,27080000,465,113,230,-235,-50.54,201,-264,-56.77,113,290,1399-6-29
649,خعمرا,توسعه و عمران شهرستان نائين,14,204830,3044797950,14158,14865,14865,707,4.99,14261,103,0.73,14865,14865,1399-6-29
650,سشمال,سيمان‌ شمال‌,14,36956,450124080,12820,12180,12180,-640,-4.99,12810,-10,-0.08,12180,12180,1399-6-29
651,وپسا,س. پتروشيمي ساختمان  خليج فارس,14,27291,141312798,5338,5178,5178,-160,-3.0,5337,-1,-0.02,5178,5178,1399-6-29
652,خلنت,لنت‌ ترمزايران‌,14,15672,1451227200,97470,92600,92600,-4870,-5.0,97320,-150,-0.15,92600,92600,1399-6-29
653,شسم,توليد سموم‌ علف‌ كش,14,1756,140636284,78519,80089,80089,1570,2.0,78541,22,0.03,80089,80089,1399-6-29
654,لسرما,سرما آفرين‌,14,18723,469572840,26390,25080,25080,-1310,-4.96,26380,-10,-0.04,25080,25080,1399-6-29
655,ضملي8067,اختيارخ فملي -14750-1399/08/06,13,48,1036999000,21000,22400,20000,-1000,-4.76,21604,604,2.88,20000,22400,1399-6-29
656,صگل1411,ص اجاره گل گهر 1411-3 ماهه 17%,13,8258,8116750235,1014421,1521631,1030000,15579,1.54,982895,-31526,-3.11,970005,1030000,1399-6-29
657,هصند911,اختيارف ت صندوق-19926-99/11/29,13,180000,180000,1,1,1,0,0.0,1,0,0.0,1,1,1399-6-29
658,ضصاد8015,اختيارخ وبصادر-3400-1399/08/11,13,169,214358000,1203,1397,1320,117,9.73,1268,65,5.4,1185,1398,1399-6-29
659,ضجار7023,اختيارخ وتجارت-3000-1399/07/22,13,181,130705000,750,673,720,-30,-4.0,722,-28,-3.73,655,800,1399-6-29
660,وثوق,سرمايه گذاري وثوق امين,13,16722,262920006,16209,15723,15723,-486,-3.0,16202,-7,-0.04,15723,15723,1399-6-29
661,زنگان,صنعت روي زنگان,13,3649,567642089,163748,155561,155561,-8187,-5.0,163650,-98,-0.06,155561,155561,1399-6-29
662,غبهار,كشت وصنعت بهاران گلبهار خراسان,13,8050,313636050,40165,38961,38961,-1204,-3.0,40146,-19,-0.05,38961,38961,1399-6-29
663,لپيام,گسترش صنايع پيام,13,21392,661782912,32224,30936,30936,-1288,-4.0,32135,-89,-0.28,30936,30936,1399-6-29
664,لبوتان,گروه‌صنعتي‌بوتان‌,13,6221,492952040,83410,79240,79240,-4170,-5.0,83370,-40,-0.05,79240,79240,1399-6-29
665,ولتجار,واسپاري تجارت وسرمايه ايرانيان,13,224993,1528152456,7002,6792,6792,-210,-3.0,6985,-17,-0.24,6792,6792,1399-6-29
666,كساپا,سايپاشيشه‌,12,12650,253253000,21070,20020,20020,-1050,-4.98,21060,-10,-0.05,20020,20020,1399-6-29
667,خفنر,فنرسازي‌خاور,12,50998,1020979960,21070,20020,20020,-1050,-4.98,21050,-20,-0.09,20020,20020,1399-6-29
668,كابگن,توليدي و صنعتي آبگينه‌,12,49725,220779000,4397,4440,4440,43,0.98,4399,2,0.05,4440,4440,1399-6-29
669,زعف9908پ17,زعفران9908پوشالمعمول بيرجند(پ),12,3285,220906100,68031,65000,68500,469,0.69,67247,-784,-1.15,65000,68500,1399-6-29
670,ضملي8079,اختيارخ فملي-33750-1399/08/06,12,88,622496000,6940,7000,7000,60,0.86,7074,134,1.93,7000,8000,1399-6-29
671,ثاباد,توريستي ورفاهي آبادگران ايران,12,83214,2675330100,33840,32150,32150,-1690,-4.99,33740,-100,-0.3,32150,32150,1399-6-29
672,ضپاس7016,اختيارخ وپارس-4200-1399/07/30,12,237,273550000,1481,999,1170,-311,-21.0,1154,-327,-22.08,999,1200,1399-6-29
673,گنجين,صندوق س. گنجينه يكم آويد-د,12,159826,1806680195,11276,11297,11300,24,0.21,11304,28,0.25,11297,11308,1399-6-29
674,غگلپا,شير پاستوريزه پگاه گلپايگان,11,2211,162913113,77561,73683,73683,-3878,-5.0,77548,-13,-0.02,73683,73683,1399-6-29
675,سدشت2,صنايع سيمان دشتستان,11,385636,14962676800,36960,38800,38800,1840,4.98,38800,1840,4.98,38800,38800,1399-6-29
676,چكاوه,صنايع‌كاغذسازي‌كاوه‌,11,6310,238139400,39720,37740,37740,-1980,-4.98,39710,-10,-0.03,37740,37740,1399-6-29
677,چافست,افست‌,11,8326,215310360,27220,25860,25860,-1360,-5.0,27210,-10,-0.04,25860,25860,1399-6-29
678,ياقوت2,صندوق س ياقوت آگاه-ثابت,11,103000000,103000000,11020,1,1,-11019,-99.99,1,-11019,-99.99,1,1,1399-6-29
679,دلقما,دارويي‌ لقمان‌,11,2588,89674200,36470,34650,34650,-1820,-4.99,36470,0,0.0,34650,34650,1399-6-29
680,ضغدر8042,اختيارخ وغدير-15000-1399/08/26,11,134,675610000,4869,4900,5010,141,2.9,5042,173,3.55,4900,5600,1399-6-29
681,كلوند,كاشي‌ الوند,10,8315,215441650,27270,25910,25910,-1360,-4.99,27260,-10,-0.04,25910,25910,1399-6-29
682,زعف9908پ11,زعفران9908نگين سحرخيز(پ),10,5212,472336770,91394,90660,90660,-734,-0.8,90625,-769,-0.84,89010,90660,1399-6-29
683,ضپاس7018,اختيارخ وپارس-4600-1399/07/30,10,373,343410000,1070,990,920,-150,-14.02,921,-149,-13.93,900,990,1399-6-29
684,فمراد,آلومراد,10,3840,577190400,158220,150310,150310,-7910,-5.0,158120,-100,-0.06,150310,150310,1399-6-29
685,فالوم,آلومتك‌,10,57577,1973451675,35335,34275,34275,-1060,-3.0,35227,-108,-0.31,34275,34275,1399-6-29
686,فسديد,لوله‌وتجهيزات‌ سديد - ورشكسته,10,20237,2456448008,120183,121384,121384,1201,1.0,120767,584,0.49,121384,121384,1399-6-29
687,خنصير,مهندسي‌نصيرماشين‌,10,2621,132517760,53220,50560,50560,-2660,-5.0,53210,-10,-0.02,50560,50560,1399-6-29
688,ضجار7024,اختيارخ وتجارت-3200-1399/07/22,10,216,121960000,619,600,580,-39,-6.3,565,-54,-8.72,440,600,1399-6-29
689,سفارود,كارخانه فارسيت درود,10,19883,137928371,7078,6937,6937,-141,-1.99,7076,-2,-0.03,6937,6937,1399-6-29
690,خفناور,مهندسي صنعتي روان فن آور,10,9759,232927812,25124,23868,23868,-1256,-5.0,25109,-15,-0.06,23868,23868,1399-6-29
691,چفيبر,فيبر ايران‌,10,74869,822061620,11550,10980,10980,-570,-4.94,11540,-10,-0.09,10980,10980,1399-6-29
692,دشيري,شيرين دارو,9,916,170752476,192176,186411,186411,-5765,-3.0,192125,-51,-0.03,186411,186411,1399-6-29
693,سكه0112پ03,سكه تمام بهارتحويلي1روزه سامان,9,11800,14601992600,1213075,1237457,1237457,24382,2.01,1237457,24382,2.01,1237457,1237457,1399-6-29
694,اخزا718,اسنادخزانه-م18بودجه97-000525,9,18793,16343315131,864754,850124,866000,1246,0.14,869649,4895,0.57,850124,873472,1399-6-29
695,ضغدر8045,اختيارخ وغدير-18000-1399/08/26,9,62,220670000,3267,3500,3500,233,7.13,3559,292,8.94,3500,3600,1399-6-29
696,خكمك,كمك‌فنرايندامين‌,9,6923,394541770,59980,56990,56990,-2990,-4.98,59960,-20,-0.03,56990,56990,1399-6-29
697,ضصاد8017,اختيارخ وبصادر-3800-1399/08/11,9,53,51664000,967,998,920,-47,-4.86,975,8,0.83,910,1098,1399-6-29
698,خچرخش,چرخشگر,9,9632,207184320,22640,21510,21510,-1130,-4.99,22640,0,0.0,21510,21510,1399-6-29
699,ضفلا8086,اختيارخ فولاد-17775-1399/08/28,9,67,319564000,4009,4000,5499,1490,37.17,4770,761,18.98,4000,7000,1399-6-29
700,كسعدي,كاشي‌ سعدي‌,9,1719,110566080,67700,64320,64320,-3380,-4.99,67690,-10,-0.01,64320,64320,1399-6-29
701,ضسپا8021,اختيارخ خساپا-3000-1399/08/26,8,171,14695000,500,200,199,-301,-60.2,86,-414,-82.8,50,200,1399-6-29
702,وسالت,بانك قرض الحسنه رسالت,8,9970,43040490,4151,4317,4317,166,4.0,4152,1,0.02,4317,4317,1399-6-29
703,تپمپي,پمپ‌ سازي‌ ايران‌,8,4100,202294000,51930,49340,49340,-2590,-4.99,51920,-10,-0.02,49340,49340,1399-6-29
704,اخزا805,اسنادخزانه-م5بودجه98-000422,8,26961,23476753142,867501,867500,871881,4380,0.5,870767,3266,0.38,867500,871999,1399-6-29
705,زير0003پ04,زيره سبز0003شركت مينوبذر(پ),8,172,75023113,429492,434720,434800,5308,1.24,436181,6689,1.56,434720,469999,1399-6-29
706,شستا003,اجاره تامين اجتماعي-سپهر000523,8,129,129692047,1038395,1050000,1045000,6605,0.64,1005365,-33030,-3.18,1001000,1050000,1399-6-29
707,ضغدر8044,اختيارخ وغدير-17000-1399/08/26,8,80,306200000,3681,3600,3800,119,3.23,3827,146,3.97,3600,4000,1399-6-29
708,ضصاد8018,اختيارخ وبصادر-4000-1399/08/11,8,207,144944000,933,700,800,-133,-14.26,700,-233,-24.97,410,999,1399-6-29
709,ولبهمن,شركت بهمن ليزينگ,8,30829,319357611,10904,10359,10359,-545,-5.0,10900,-4,-0.04,10359,10359,1399-6-29
710,صمسكن912,ص دين مسكن جنوب-ماهانه16درصد,8,624,117078000,197499,187625,187625,-9874,-5.0,187625,-9874,-5.0,187625,187625,1399-6-29
711,زعف9908پ15,زعفران9908پوشالمعمول طلاسرخ(پ),8,543,36068750,67792,69150,65750,-2042,-3.01,66425,-1367,-2.02,65100,69150,1399-6-29
712,فنرژي,گسترش صنايع انرژي آذرآب,8,10597,116439836,11212,10988,10988,-224,-2.0,11209,-3,-0.03,10988,10988,1399-6-29
713,اخزا810,اسنادخزانه-م10بودجه98-001006,8,15340,12302738714,800828,800001,806430,5602,0.7,802004,1176,0.15,800001,806430,1399-6-29
714,غشوكو,شوكو پارس,7,1108,48251184,45839,43548,43548,-2291,-5.0,45833,-6,-0.01,43548,43548,1399-6-29
715,پلاست,كارخانجات توليدي پلاستيران,7,14142,588986016,43839,41648,41648,-2191,-5.0,43771,-68,-0.16,41648,41648,1399-6-29
716,آگاس2,صندوق س.هستي بخش آگاه-س,7,1400000,1400000,82176,1,1,-82175,-100.0,1,-82175,-100.0,1,1,1399-6-29
717,غمهرا,توليدي‌مهرام‌,7,4640,487292800,110540,105020,105020,-5520,-4.99,110480,-60,-0.05,105020,105020,1399-6-29
718,نتوس,پشم‌ بافي‌ توس,7,7454,79623628,11244,10682,10682,-562,-5.0,11242,-2,-0.02,10682,10682,1399-6-29
719,ضپيك7033,اختيارخ تاپيكو-21370-99/07/20,7,92,150567000,1862,2000,1601,-261,-14.02,1637,-225,-12.08,1601,2000,1399-6-29
720,ضصاد8000,اختيارخ وبصادر-1200-1399/08/11,7,64,210578000,3168,3300,3010,-158,-4.99,3290,122,3.85,3010,3589,1399-6-29
721,سنير,سيمان‌ سفيد ني‌ريز,7,2173,199568320,96670,91840,91840,-4830,-5.0,96650,-20,-0.02,91840,91840,1399-6-29
722,فماك,ماداكتو استيل كرد,7,233000,6943400000,29980,29800,29800,-180,-0.6,29800,-180,-0.6,29800,29800,1399-6-29
723,قمرو,قند مرودشت‌,7,2227,78858070,37270,35410,35410,-1860,-4.99,37270,0,0.0,35410,35410,1399-6-29
724,ضملت8032,اختيارخ وبملت-5789-1399/08/28,6,112,472976738,1239,1000,1095,-144,-11.62,1020,-219,-17.68,1000,1100,1399-6-29
725,ضملي8082,اختيارخ فملي-39750-1399/08/06,6,19,73900000,3579,4500,4250,671,18.75,3889,310,8.66,3760,4500,1399-6-29
726,ثرود,سرمايه‌گذاري مسكن زاينده رود,6,6843,84832671,13049,12397,12397,-652,-5.0,13048,-1,-0.01,12397,12397,1399-6-29
727,ضفلا8079,اختيارخ فولاد-10775-1399/08/28,6,31,360700000,9857,11700,10500,643,6.52,11635,1778,18.04,10500,11900,1399-6-29
728,خموتور,موتورسازان‌تراكتورسازي‌ايران‌,6,7558,99992340,13920,13230,13230,-690,-4.96,13920,0,0.0,13230,13230,1399-6-29
729,ضصاد8022,اختيارخ وبصادر-4800-1399/08/11,6,128,74572000,578,550,699,121,20.93,583,5,0.87,550,699,1399-6-29
730,فافزا,فولاد افزا سپاهان,6,1426,67779206,49001,47531,47531,-1470,-3.0,48996,-5,-0.01,47531,47531,1399-6-29
731,اخزا704,اسنادخزانه-م4بودجه97-991022,6,49,46688000,950051,953000,952000,1949,0.21,952816,2765,0.29,952000,953000,1399-6-29
732,صايپا203,صكوك مرابحه سايپا203-3ماهه 16%,6,2041,1949652000,957035,988000,955100,-1935,-0.2,955243,-1792,-0.19,955000,988000,1399-6-29
733,ثامان,سامان‌ گستراصفهان‌,5,1621,35856520,23280,22120,22120,-1160,-4.98,23280,0,0.0,22120,22120,1399-6-29
734,سلار,شركت سيمان لارستان,5,3458,101658284,30307,29398,29398,-909,-3.0,30302,-5,-0.02,29398,29398,1399-6-29
735,وسقم,شركت س استان قم,5,91824,129471840,1350,1410,1410,60,4.44,1350,0,0.0,1410,1410,1399-6-29
736,فن آوا,گروه فن آوا,5,2036,29243068,14656,14363,14363,-293,-2.0,14655,-1,-0.01,14363,14363,1399-6-29
737,ضگل8066,اختيارخ كگل-25100-1399/08/21,5,9,41400000,5058,4800,4400,-658,-13.01,4600,-458,-9.05,4300,4800,1399-6-29
738,تكنو,تكنوتار,5,4987,73109420,15430,14660,14660,-770,-4.99,15430,0,0.0,14660,14660,1399-6-29
739,وايرا,سرمايه گذاري صنايع ايران,5,3113,28297170,9371,9090,9090,-281,-3.0,9371,0,0.0,9090,9090,1399-6-29
740,پست9908-04,پسته فندقي32-30سبزدانه9908,5,46,68774480,1511621,1545448,1480000,-31621,-2.09,1495097,-16524,-1.09,1480000,1545448,1399-6-29
741,شلرد02,كود شيميايي اوره لردگان,5,6203,6246773300,1001000,1075000,1001100,100,0.01,1007057,6057,0.61,1001100,1075000,1399-6-29
742,ضصاد8023,اختيارخ وبصادر-5000-1399/08/11,5,103,35465000,550,300,449,-101,-18.36,344,-206,-37.45,300,449,1399-6-29
743,ضپاس7025,اختيارخ وپارس-7500-1399/07/30,4,383,41140000,300,100,110,-190,-63.33,107,-193,-64.33,100,110,1399-6-29
744,اخزا723,اسنادخزانه-م23بودجه97-000824,4,2024,1657593148,829323,816052,820005,-9318,-1.12,818969,-10354,-1.25,816052,820100,1399-6-29
745,ثاژن,سخت آژند,4,20095,208626290,10593,10382,10382,-211,-1.99,10589,-4,-0.04,10382,10382,1399-6-29
746,ضخود7063,اختيارخ خودرو-5500-1399/07/09,4,70,236000,10,4,3,-7,-70.0,3,-7,-70.0,3,4,1399-6-29
747,ضغدر8030,اختيارخ وغدير-6510-1399/08/26,4,34,448000000,14400,14000,13200,-1200,-8.33,13176,-1224,-8.5,13000,14000,1399-6-29
748,وثخوز,سرمايه گذاري و توسعه خوزستان,4,2278,84037698,38031,36891,36891,-1140,-3.0,38026,-5,-0.01,36891,36891,1399-6-29
749,ضفلا8080,اختيارخ فولاد-11775-1399/08/28,4,48,409000000,8000,10000,8000,0,0.0,8521,521,6.51,8000,10000,1399-6-29
750,ضصاد8021,اختيارخ وبصادر-4600-1399/08/11,4,185,124000000,507,600,700,193,38.07,670,163,32.15,600,700,1399-6-29
751,ضچاد7018,اختيارخ كچاد-15300-1399/07/07,4,20,127202000,1592,5001,6600,5008,314.57,6360,4768,299.5,5000,6600,1399-6-29
752,ضصاد8011,اختيارخ وبصادر-2600-1399/08/11,4,28,53165000,1455,1865,1900,445,30.58,1899,444,30.52,1865,1900,1399-6-29
753,اشاد10,مشاركت دولتي10-شرايط خاص001226,4,3200,3083071900,986026,987000,952301,-33725,-3.42,963460,-22566,-2.29,952301,987000,1399-6-29
754,زعف9908پ09,زعفران9908نگين نوين(پ),4,3230,287578000,87424,86100,90660,3236,3.7,89033,1609,1.84,86100,90660,1399-6-29
755,ومللح,ح . اعتباري ملل,4,2341,33476300,14708,14300,14300,-408,-2.77,14300,-408,-2.77,14300,14300,1399-6-29
756,اخزا716,اسنادخزانه-م16بودجه97-000407,4,14722,12902769350,876266,876266,877001,735,0.08,876428,162,0.02,876266,877001,1399-6-29
757,وبصادر2,بانك صادرات ايران,4,11606345,50603664200,4160,4360,4360,200,4.81,4360,200,4.81,4360,4360,1399-6-29
758,غنيلي,مجتمع توليدي نيلي صنعت كرمان,4,60000,1015515000,16601,16601,17000,399,2.4,16925,324,1.95,16601,17100,1399-6-29
759,ضصاد8016,اختيارخ وبصادر-3600-1399/08/11,4,107,127400000,810,1100,1200,390,48.15,1191,381,47.04,1100,1200,1399-6-29
760,ثتوسا,س.توسعه و عمران استان اردبيل,4,363,26861274,76286,73998,73998,-2288,-3.0,76283,-3,0.0,73998,73998,1399-6-29
761,ضخوز7028,اختيارخ فخوز-43470-1399/07/20,4,40,437000000,11262,12000,7000,-4262,-37.84,10925,-337,-2.99,7000,12000,1399-6-29
762,ضجار7030,اختيارخ وتجارت-4400-1399/07/22,4,20,1035000,191,52,51,-140,-73.3,52,-139,-72.77,51,52,1399-6-29
763,ضملي8085,اختيارخ فملي-51750-1399/08/06,4,15,64485000,2474,5900,2997,523,21.14,4299,1825,73.77,2997,5900,1399-6-29
764,پست9908-08,پسته فندقي32-30زرينمه ولات9908,3,19,27775113,1484598,1519995,1435011,-49587,-3.34,1461848,-22750,-1.53,1435011,1519995,1399-6-29
765,وپارس2,بانك‌پارسيان‌,3,1560000000,7862400000000,5290,5040,5040,-250,-4.73,5040,-250,-4.73,5040,5040,1399-6-29
766,لازما,كارخانه هاي صنعتي آزمايش,3,2829,89257779,32194,31551,31551,-643,-2.0,32188,-6,-0.02,31551,31551,1399-6-29
767,وسخراش,شركت س استان خراسان شمالي,3,135000,190350000,1350,1410,1410,60,4.44,1350,0,0.0,1410,1410,1399-6-29
768,بشهاب,لامپ‌  پارس‌ شهاب‌,3,241,16990500,74210,70500,70500,-3710,-5.0,74210,0,0.0,70500,70500,1399-6-29
769,ضگل8058,اختيارخ كگل-14100-1399/08/21,3,150,2119500000,10045,14600,13000,2955,29.42,14130,4085,40.67,13000,14700,1399-6-29
770,ضفلا8076,اختيارخ فولاد-8775-1399/08/28,3,19,255700000,12000,13300,13500,1500,12.5,13458,1458,12.15,13300,13500,1399-6-29
771,ضفار8037,اختيارخ فارس-12826-1399/08/06,3,30,240000000,7213,8000,8000,787,10.91,8000,787,10.91,8000,8000,1399-6-29
772,ضپاس7015,اختيارخ وپارس-4000-1399/07/30,3,30,39750000,1669,1000,1500,-169,-10.13,1325,-344,-20.61,1000,1500,1399-6-29
773,اشاد92,مشاركت دولتي9-شرايط خاص990909,3,153,145069704,992442,948168,948168,-44274,-4.46,948168,-44274,-4.46,948168,948168,1399-6-29
774,ضگل8068,اختيارخ كگل-28000-1399/08/21,2,50,225000000,1,4500,4500,4499,449900.0,4500,4499,449900.0,4500,4500,1399-6-29
775,شستا993,اجاره ت.اجتماعي-كاردان991226,2,104,105529840,1014710,1014710,1014710,0,0.0,1014710,0,0.0,1014710,1014710,1399-6-29
776,ضجار7025,اختيارخ وتجارت-3400-1399/07/22,2,34,16480000,487,445,490,3,0.62,485,-2,-0.41,445,490,1399-6-29
777,كچاد2,معدني‌وصنعتي‌چادرملو,2,3000000,64980000000,20630,21660,21660,1030,4.99,21660,1030,4.99,21660,21660,1399-6-29
778,ضملي8075,اختيارخ فملي -25750-1399/08/06,2,6,66000000,12500,11000,11000,-1500,-12.0,11000,-1500,-12.0,11000,11000,1399-6-29
779,ضپاس7019,اختيارخ وپارس-4800-1399/07/30,2,5,4590000,1990,920,910,-1080,-54.27,918,-1072,-53.87,910,920,1399-6-29
780,ضخود7052,اختيارخ خودرو-1400-1399/07/09,2,2,3850000,2409,1800,2050,-359,-14.9,1925,-484,-20.09,1800,2050,1399-6-29
781,ضفار8029,اختيارخ فارس-7326-1399/08/06,2,3,53800000,13000,18000,17900,4900,37.69,17933,4933,37.95,17900,18000,1399-6-29
782,سپرمي,پرميت‌,2,703,5829276,8461,8292,8292,-169,-2.0,8461,0,0.0,8292,8292,1399-6-29
783,ضخود7066,اختيارخ خودرو-7000-1399/07/09,2,69,207000,130,3,3,-127,-97.69,3,-127,-97.69,3,3,1399-6-29
784,ضچاد7012,اختيارخ كچاد-9300-1399/07/07,2,2,24000000,9100,12000,12000,2900,31.87,12000,2900,31.87,12000,12000,1399-6-29
785,زعف9908پ13,زعفران9908پوشالمعمول روستا(پ),2,155,10379000,68409,65050,69000,591,0.86,66961,-1448,-2.12,65050,69000,1399-6-29
786,ضصاد8013,اختيارخ وبصادر-3000-1399/08/11,2,9,12405000,1485,1205,1400,-85,-5.72,1378,-107,-7.21,1205,1400,1399-6-29
787,ضملت8034,اختيارخ وبملت-6755-1399/08/28,2,13,43078823,895,801,800,-95,-10.61,800,-95,-10.61,800,801,1399-6-29
788,تملي711,تسهيلات مسكن ب. ملي-بهمن97,2,9,3783078,400326,420342,420342,20016,5.0,420342,20016,5.0,420342,420342,1399-6-29
789,ضفلا8083,اختيارخ فولاد-14775-1399/08/28,2,7,46400000,6125,7500,1400,-4725,-77.14,6629,504,8.23,1400,7500,1399-6-29
790,ضملي8087,اختيارخ فملي-59750-1399/08/06,2,30,21600000,737,720,720,-17,-2.31,720,-17,-2.31,720,720,1399-6-29
791,ضغدر8039,اختيارخ وغدير-12000-1399/08/26,2,3,18150000,5300,6000,6150,850,16.04,6050,750,14.15,6000,6150,1399-6-29
792,شرق1400,مشاركت ليزينگ ايران وشرق140010,2,6,6060000,1013018,1010000,1010000,-3018,-0.3,1010000,-3018,-0.3,1010000,1010000,1399-6-29
793,خمحور,توليدمحورخودرو,2,196,11275880,60550,57530,57530,-3020,-4.99,60550,0,0.0,57530,57530,1399-6-29
794,تملي612,تسهيلات مسكن بانك ملي-اسفند96,2,8,17877680,2128296,2234710,2234710,106414,5.0,2234710,106414,5.0,2234710,2234710,1399-6-29
795,ضگل8057,اختيارخ كگل-13100-1399/08/21,2,6,59400000,9600,9900,9900,300,3.13,9900,300,3.13,9900,9900,1399-6-29
796,شستا994,اجاره تامين اجتماعي-نوين991226,2,83,83000520,1000007,1000008,1000006,-1,0.0,1000006,-1,0.0,1000006,1000008,1399-6-29
797,تملي706,تسهيلات مسكن ب. ملي-شهريور97,2,25,5064075,192918,202563,202563,9645,5.0,202563,9645,5.0,202563,202563,1399-6-29
798,صايپا908,صكوك مرابحه سايپا908-3ماهه 18%,2,75,74850010,998000,998002,998000,0,0.0,998000,0,0.0,998000,998002,1399-6-29
799,طسان7050,اختيارف پارسان-11000-99/07/15,2,8,24000,2,3,3,1,50.0,3,1,50.0,3,3,1399-6-29
800,ضفلا8084,اختيارخ فولاد-15775-1399/08/28,2,2,12300000,5191,6150,6150,959,18.47,6150,959,18.47,6150,6150,1399-6-29
801,ضپاس7014,اختيارخ وپارس-3800-1399/07/30,2,18,28620000,2095,1590,1590,-505,-24.11,1590,-505,-24.11,1590,1590,1399-6-29
802,عسناسنگ,سلف كنستانتره سنگ آهن سناباد,2,4,26735344,6718870,6683836,6683836,-35034,-0.52,6683836,-35034,-0.52,6683836,6683836,1399-6-29
803,ضسپا8007,اختيارخ خساپا-1100-1399/08/26,2,3,3302000,2501,1101,1100,-1401,-56.02,1101,-1400,-55.98,1100,1101,1399-6-29
804,ضملي8076,اختيارخ فملي -27750-1399/08/06,2,7,70009000,11699,10002,10001,-1698,-14.51,10001,-1698,-14.51,10001,10002,1399-6-29
805,ضگل8061,اختيارخ كگل-17100-1399/08/21,2,8,86260000,8900,10680,11500,2600,29.21,10782,1882,21.15,10680,11500,1399-6-29
806,تملي807,تسهيلات مسكن ب. ملي-مهر98,2,24,5288736,209871,220364,220364,10493,5.0,220364,10493,5.0,220364,220364,1399-6-29
807,تملي703,تسهيلات مسكن ب. ملي-خرداد97,2,2,448878,213752,224439,224439,10687,5.0,224439,10687,5.0,224439,224439,1399-6-29
808,ضفلا8082,اختيارخ فولاد-13775-1399/08/28,2,8,76400000,8453,10000,8800,347,4.11,9550,1097,12.98,8800,10000,1399-6-29
809,كيش1402,اجاره س. و توسعه كيش14020820,2,38,39900000,1029333,1132266,1050000,20667,2.01,1050000,20667,2.01,1050000,1050000,1399-6-29
810,ضملي8080,اختيارخ فملي-35750-1399/08/06,2,4,22900000,5427,4900,6000,573,10.56,5725,298,5.49,4900,6000,1399-6-29
811,ضمخا7049,اختيارخ اخابر-13750-1399/07/30,1,9,27000000,9000,3000,3000,-6000,-66.67,3000,-6000,-66.67,3000,3000,1399-6-29
812,وبملت2,بانك ملت,1,15000000,91350000000,6350,6090,6090,-260,-4.09,6090,-260,-4.09,6090,6090,1399-6-29
813,تملي705,تسهيلات مسكن ب. ملي-مرداد97,1,1,282946,269473,282946,282946,13473,5.0,282946,13473,5.0,282946,282946,1399-6-29
814,بفجر2,فجر انرژي خليج فارس,1,2500000,80000000000,31750,32000,32000,250,0.79,32000,250,0.79,32000,32000,1399-6-29
815,وخاور2,بانك خاورميانه,1,50000000,574500000000,11810,11490,11490,-320,-2.71,11490,-320,-2.71,11490,11490,1399-6-29
816,ضغدر8040,اختيارخ وغدير-13000-1399/08/26,1,11,70400000,6800,6400,6400,-400,-5.88,6400,-400,-5.88,6400,6400,1399-6-29
817,ضخود7041,اختيارخ خودرو-1700-1399/07/09,1,1,999000,1565,999,999,-566,-36.17,999,-566,-36.17,999,999,1399-6-29
818,گندم2,مرابحه گندم2-واجدشرايط خاص1400,1,2000,1900000000,1000000,950000,950000,-50000,-5.0,950000,-50000,-5.0,950000,950000,1399-6-29
819,اروند06,منفعت صبا اروند ملت 14001113,1,2000,1940000000,960000,970000,970000,10000,1.04,970000,10000,1.04,970000,970000,1399-6-29
820,تملي801,تسهيلات مسكن ب. ملي-فروردين98,1,1,273036,260035,273036,273036,13001,5.0,273036,13001,5.0,273036,273036,1399-6-29
821,تملي707,تسهيلات مسكن ب. ملي-مهر97,1,1,354409,337533,354409,354409,16876,5.0,354409,16876,5.0,354409,354409,1399-6-29
822,پارسا306,صكوك اجاره پارسيان-6ماهه16%,1,19,18430000,970000,970000,970000,0,0.0,970000,0,0.0,970000,970000,1399-6-29
823,ضفار8031,اختيارخ فارس-8326-1399/08/06,1,5,80000000,15000,16000,16000,1000,6.67,16000,1000,6.67,16000,16000,1399-6-29
824,ضسپا8008,اختيارخ خساپا-1200-1399/08/26,1,1,2000000,2800,2000,2000,-800,-28.57,2000,-800,-28.57,2000,2000,1399-6-29
825,صايپا012,صكوك مرابحه سايپا012-3ماهه 16%,1,6,6000000,1001592,1000000,1000000,-1592,-0.16,1000000,-1592,-0.16,1000000,1000000,1399-6-29
826,ضچاد7023,اختيارخ كچاد-21300-1399/07/07,1,3,1500000,933,500,500,-433,-46.41,500,-433,-46.41,500,500,1399-6-29
827,غگز,گز سكه,1,1000,34000000,34000,34000,34000,0,0.0,34000,0,0.0,34000,34000,1399-6-29
828,كگل2,معدني و صنعتي گل گهر,1,424291,11167339120,25070,26320,26320,1250,4.99,26320,1250,4.99,26320,26320,1399-6-29
829,تملي702,تسهيلات مسكن ب. ملي-ارديبهشت97,1,42,17209794,390245,409757,409757,19512,5.0,409757,19512,5.0,409757,409757,1399-6-29
830,ضخوز7027,اختيارخ فخوز-39470-1399/07/20,1,1,13000000,14007,13000,13000,-1007,-7.19,13000,-1007,-7.19,13000,13000,1399-6-29
831,ضچاد7026,اختيارخ كچاد-28000-1399/07/07,1,1,3000,1,3,3,2,200.0,3,2,200.0,3,3,1399-6-29
832,ضفلا8088,اختيارخ فولاد-19775-1399/08/28,1,5,20000000,4160,4000,4000,-160,-3.85,4000,-160,-3.85,4000,4000,1399-6-29
833,ضجار7017,اختيارخ وتجارت-1900-1399/07/22,1,29,49300000,1735,1700,1700,-35,-2.02,1700,-35,-2.02,1700,1700,1399-6-29
834,ضملي8062,اختيارخ فملي -9750-1399/08/06,1,10,275000000,23500,27500,27500,4000,17.02,27500,4000,17.02,27500,27500,1399-6-29
835,تابا,تابان نيرو سپاهان,1,159,5061129,32815,31831,31831,-984,-3.0,32815,0,0.0,31831,31831,1399-6-29
836,اراد47,مرابحه عام دولت4-ش.خ 0008,1,25000,24225000000,969600,969000,969000,-600,-0.06,969000,-600,-0.06,969000,969000,1399-6-29
837,ضغدر8041,اختيارخ وغدير-14000-1399/08/26,1,2,12000000,5000,6000,6000,1000,20.0,6000,1000,20.0,6000,6000,1399-6-29
838,تملي709,تسهيلات مسكن ب. ملي-آذر97,1,11,3179407,275274,289037,289037,13763,5.0,289037,13763,5.0,289037,289037,1399-6-29
839,اجاد22,اجاره دولتي آپرورش-لوتوس991118,1,1800,1800007200,1010000,1000004,1000004,-9996,-0.99,1000004,-9996,-0.99,1000004,1000004,1399-6-29
840,ضفلا8087,اختيارخ فولاد-18775-1399/08/28,1,50,250000000,4800,5000,5000,200,4.17,5000,200,4.17,5000,5000,1399-6-29
841,اراد40,مرابحه عام دولت4-ش.خ 0207,1,100,97986000,933200,979860,979860,46660,5.0,979860,46660,5.0,979860,979860,1399-6-29
842,ضپار8019,اختيارخ خپارس-3800-1399/08/18,1,1,2500000,7000,2500,2500,-4500,-64.29,2500,-4500,-64.29,2500,2500,1399-6-29
843,ضگل8062,اختيارخ كگل-18100-1399/08/21,1,7,63000000,9417,9000,9000,-417,-4.43,9000,-417,-4.43,9000,9000,1399-6-29
844,تملي701,تسهيلات مسكن ب. ملي-فروردين97,1,1,475654,453004,475654,475654,22650,5.0,475654,22650,5.0,475654,475654,1399-6-29
845,اعتماد4,صندوق س.اعتماد آفرين پارسيان-د,1,18509570,600080259400,32371,32420,32420,49,0.15,32420,49,0.15,32420,32420,1399-6-29
846,ضچاد7013,اختيارخ كچاد-10300-1399/07/07,1,5,57500000,10936,11500,11500,564,5.16,11500,564,5.16,11500,11500,1399-6-29
847,ضجار7021,اختيارخ وتجارت-2600-1399/07/22,1,1,935000,1098,935,935,-163,-14.85,935,-163,-14.85,935,935,1399-6-29
848,ضملي1153,اختيارخ فملي-20280-1399/11/05,1,1,15000000,1,15000,15000,14999,1499900.0,15000,14999,1499900.0,15000,15000,1399-6-29
849,ضخود7067,اختيارخ خودرو-7500-1399/07/09,1,1,180000,135,180,180,45,33.33,180,45,33.33,180,180,1399-6-29
850,ضملت8029,اختيارخ وبملت-4582-1399/08/28,1,2,21533200,2000,2600,2600,600,30.0,2600,600,30.0,2600,2600,1399-6-29
851,ضخود7054,اختيارخ خودرو-3400-1399/07/09,1,1,100000,500,100,100,-400,-80.0,100,-400,-80.0,100,100,1399-6-29
852,رايان911,مشاركت رايان سايپا-3ماهه18%,1,14,13860000,992000,990000,990000,-2000,-0.2,990000,-2000,-0.2,990000,990000,1399-6-29
853,مكرج112,مشاركت شهرداري كرج-3ماهه18%,1,1000,938000000,908000,938000,938000,30000,3.3,938000,30000,3.3,938000,938000,1399-6-29
854,ضجار7010,اختيارخ وتجارت-1200-1399/07/22,1,8,16000000,2380,2000,2000,-380,-15.97,2000,-380,-15.97,2000,2000,1399-6-29
855,تملي712,تسهيلات مسكن ب. ملي-اسفند97,1,1,430884,410366,430884,430884,20518,5.0,430884,20518,5.0,430884,430884,1399-6-29
856,ضپاس7000,اختيارخ وپارس-1500-1399/07/30,1,1,3800000,3910,3800,3800,-110,-2.81,3800,-110,-2.81,3800,3800,1399-6-29
857,ضصاد8009,اختيارخ وبصادر-2200-1399/08/11,1,1,2600000,2250,2600,2600,350,15.56,2600,350,15.56,2600,2600,1399-6-29
858,زير0003پ02,زيره سبز0003 دانش(پ),1,11,4781920,427355,434720,434720,7365,1.72,434720,7365,1.72,434720,434720,1399-6-29
859,دمعيار2,صندوق س. توازن معيار-د,1,700000,700000,10083,1,1,-10082,-99.99,1,-10082,-99.99,1,1,1399-6-29
860,افاد1,منفعت دولت-با شرايط خاص140006,1,5800,5800046400,1000006,1000008,1000008,2,0.0,1000008,2,0.0,1000008,1000008,1399-6-29
861,ضفلا8060,اختيارخ فولاد-3507-1399/08/28,1,1,22513608,18000,14001,14001,-3999,-22.22,14001,-3999,-22.22,14001,14001,1399-6-29
862,گواهي ظرفيت,گواهي ظرفيت نقدي,1,1350000,14362650000,10639,10639,10639,0,0.0,10639,0,0.0,10639,10639,1399-6-29
863,ضفار8039,اختيارخ فارس-14826-1399/08/06,1,5,34800000,11500,6960,6960,-4540,-39.48,6960,-4540,-39.48,6960,6960,1399-6-29
864,ضخود7065,اختيارخ خودرو-6500-1399/07/09,1,61,305000,200,5,5,-195,-97.5,5,-195,-97.5,5,5,1399-6-29
865,شخارك4,پتروشيمي‌ خارك‌,1,309519756,349757324280,48060,1130,1130,-46930,-97.65,1130,-46930,-97.65,1130,1130,1399-6-29
866,ضخود7050,اختيارخ خودرو-1200-1399/07/09,1,2,4000000,2200,2000,2000,-200,-9.09,2000,-200,-9.09,2000,2000,1399-6-29
867,اشاد9,مشاركت دولتي9-شرايط خاص990909,1,100,99300000,992442,993000,993000,558,0.06,993000,558,0.06,993000,993000,1399-6-29
868,ضفلا8068,اختيارخ فولاد-4751-1399/08/28,1,1,24120000,14925,15000,15000,75,0.5,15000,75,0.5,15000,15000,1399-6-29
869,ضملي8081,اختيارخ فملي-37750-1399/08/06,1,1,5200000,4250,5200,5200,950,22.35,5200,950,22.35,5200,5200,1399-6-29
870,ضپاس7013,اختيارخ وپارس-3600-1399/07/30,1,1,1810000,1999,1810,1810,-189,-9.45,1810,-189,-9.45,1810,1810,1399-6-29
871,ضترا8017,اختيارخ شتران-3126-1399/08/11,1,1,19001000,27500,19001,19001,-8499,-30.91,19001,-8499,-30.91,19001,19001,1399-6-29
872,اراد48,مرابحه عام دولت4-ش.خ 0009,1,25000,24176500000,967060,967060,967060,0,0.0,967060,0,0.0,967060,967060,1399-6-29
873,وتوكا2,سرمايه‌گذاري‌توكافولاد(هلدينگ,1,10000000,126400000000,12040,12640,12640,600,4.98,12640,600,4.98,12640,12640,1399-6-29
874,پخش2,پخش البرز,1,2000000,62000000000,32514,31000,31000,-1514,-4.66,31000,-1514,-4.66,31000,31000,1399-6-29
875,ضفار8041,اختيارخ فارس-16826-1399/08/06,1,3,9000000,3555,3000,3000,-555,-15.61,3000,-555,-15.61,3000,3000,1399-6-29
876,ضجار7027,اختيارخ وتجارت-3800-1399/07/22,1,11,4389000,278,399,399,121,43.53,399,121,43.53,399,399,1399-6-29
877,ضفار8036,اختيارخ فارس-11826-1399/08/06,1,5,50000000,9000,10000,10000,1000,11.11,10000,1000,11.11,10000,10000,1399-6-29
878,اروند03,منفعت صبا اروند تمدن14001113,1,1000,965000000,945000,965000,965000,20000,2.12,965000,20000,2.12,965000,965000,1399-6-29
879,وتوكاح2,ح . ‌توكافولاد(هلدينگ‌,1,2798076,27989154228,10161,10003,10003,-158,-1.55,10003,-158,-1.55,10003,10003,1399-6-29
880,ضغدر8047,اختيارخ وغدير-20000-1399/08/26,1,5,13000000,3800,2600,2600,-1200,-31.58,2600,-1200,-31.58,2600,2600,1399-6-29
881,تملي704,تسهيلات مسكن ب. ملي-تير97,1,1,711658,677770,711658,711658,33888,5.0,711658,33888,5.0,711658,711658,1399-6-29
882,ضملي8069,اختيارخ فملي -16750-1399/08/06,1,10,190000000,19000,19000,19000,0,0.0,19000,0,0.0,19000,19000,1399-6-29
883,صخابر102,صكوك اجاره مخابرات-3 ماهه 16%,1,2000,1992000000,991000,996000,996000,5000,0.5,996000,5000,0.5,996000,996000,1399-6-29
884,تملي802,تسهيلات مسكن ب. ملي-ارديبهشت98,1,1,453999,432380,453999,453999,21619,5.0,453999,21619,5.0,453999,453999,1399-6-29
885,اخزا8212,اسنادخزانه-م21بودجه98-020906,1,143000,83941000000,581475,587000,587000,5525,0.95,587000,5525,0.95,587000,587000,1399-6-29
886,ضصاد8001,اختيارخ وبصادر-1300-1399/08/11,1,1,3300000,2455,3300,3300,845,34.42,3300,845,34.42,3300,3300,1399-6-29
887,بذر2,صندوق س بذر اميد آفرين-سهام,1,4020000,4020000,124220,1,1,-124219,-100.0,1,-124219,-100.0,1,1,1399-6-29
888,ضخوز7024,اختيارخ فخوز-33470-1399/07/20,1,3,8400000,18000,2800,2800,-15200,-84.44,2800,-15200,-84.44,2800,2800,1399-6-29
889,مبين012,اجاره اعتماد مبين تمدن010710,1,200,196400000,952000,982000,982000,30000,3.15,982000,30000,3.15,982000,982000,1399-6-29
