,نماد,نام,تعداد,حجم,ارزش,دیروز,اولین,آخرین معامله - مقدار,آخرین معامله - تغییر,آخرین معامله - درصد,قیمت پایانی - مقدار,قیمت پایانی - تغییر,قیمت پایانی - درصد,کمترین,بیشترین,تاریخ
0,سپيدار,سپيدار سيستم آسيا,164746,10966311,724629902490,64273,62988,68129,3856,6.0,66078,1805,2.81,62988,68129,1399-12-24
1,چخزر,صنايع چوب خزر كاسپين,117576,18679799,1099212908607,56769,55634,60175,3406,6.0,58845,2076,3.66,55634,60175,1399-12-24
2,پالايش,صندوق پالايشي يکم-سهام,75091,73804756,6266770009180,86820,87500,83360,-3460,-3.99,84910,-1910,-2.2,83350,88280,1399-12-24
3,اپال,فرآوري معدني اپال كاني پارس,55263,149334951,2661806216460,16860,17870,17870,1010,5.99,17820,960,5.69,17150,17870,1399-12-24
4,دارا يكم,صندوق واسطه گري مالي يكم-سهام,45781,38204115,5647047349340,146850,150100,144460,-2390,-1.63,147810,960,0.65,143500,151900,1399-12-24
5,خودرو,ايران‌ خودرو,40292,1577658368,3941709376970,2380,2450,2500,120,5.04,2500,120,5.04,2420,2520,1399-12-24
6,خساپا,سايپا,38883,1704255428,3855333838620,2160,2200,2270,110,5.09,2260,100,4.63,2180,2280,1399-12-24
7,كزغال,زغال سنگ پروده طبس,38234,30418150,1125775033166,35418,37543,35999,581,1.64,37010,1592,4.49,35821,37543,1399-12-24
8,شپنا,پالايش نفت اصفهان,33146,235524745,3107381169490,13270,13550,13020,-250,-1.88,13190,-80,-0.6,13010,13740,1399-12-24
9,شستا,سرمايه گذاري تامين اجتماعي,31785,106986423,2022066685530,19000,19030,18720,-280,-1.47,18900,-100,-0.53,18630,19370,1399-12-24
10,خگستر,گسترش‌سرمايه‌گذاري‌ايران‌خودرو,22392,458285051,1316683885210,2770,2830,2830,60,2.17,2870,100,3.61,2770,2930,1399-12-24
11,بركت,گروه دارويي بركت,20401,43304225,1479725736260,34270,35170,33590,-680,-1.98,34170,-100,-0.29,33590,35980,1399-12-24
12,ولپارس,ليزينگ پارسيان,16081,17472291,87474006710,5070,5050,4980,-90,-1.78,5010,-60,-1.18,4970,5210,1399-12-24
13,وتجارت,بانك تجارت,15248,354461718,949904499560,2630,2740,2630,0,0.0,2680,50,1.9,2610,2770,1399-12-24
14,وكبهمن,مديريت سرمايه گذاري كوثربهمن,14434,4560075,53872765225,11756,12002,11750,-6,-0.05,11814,58,0.49,11530,12080,1399-12-24
15,فملي,ملي‌ صنايع‌ مس‌ ايران‌,14321,66448754,834974672830,12470,12540,12430,-40,-0.32,12570,100,0.8,12400,12740,1399-12-24
16,خپارس,پارس‌ خودرو,13460,170410655,974484250180,5710,5600,5610,-100,-1.75,5720,10,0.18,5600,5980,1399-12-24
17,كمند,صندوق س. با درآمد ثابت كمند,13247,626767527,6298492210060,10045,10049,10050,5,0.05,10049,4,0.04,10047,10051,1399-12-24
18,شتران,پالايش نفت تهران,12854,98215548,854566003620,8800,8950,8630,-170,-1.93,8700,-100,-1.14,8630,8960,1399-12-24
19,خزاميا,زامياد,12600,109959402,897153477530,8210,8050,8060,-150,-1.83,8160,-50,-0.61,8050,8470,1399-12-24
20,بوعلي,پتروشيمي بوعلي سينا,12449,2849822,122298381490,42710,42720,42710,0,0.0,42910,200,0.47,42300,43650,1399-12-24
21,كاما,باما,12205,45196518,617742060270,13260,13730,13510,250,1.89,13670,410,3.09,13290,13990,1399-12-24
22,بپيوند,برق و انرژي پيوندگستر پارس,11466,6548478,93452686476,14225,14217,14020,-205,-1.44,14271,46,0.32,13980,14650,1399-12-24
23,شاروم,پتروشيمي اروميه,11225,7848663,149499618173,19190,18897,18807,-383,-2.0,19048,-142,-0.74,18807,19528,1399-12-24
24,وسپهر,سرمايه گذاري مالي سپهرصادرات,11110,23893265,241327333694,10100,10100,10100,0,0.0,10100,0,0.0,10100,10102,1399-12-24
25,وبملت,بانك ملت,11100,270006098,1098368708760,3940,4080,4020,80,2.03,4070,130,3.3,3990,4150,1399-12-24
26,ثاميد,توسعه و عمران اميد,10228,71183679,112441091110,1580,1590,1570,-10,-0.63,1580,0,0.0,1560,1610,1399-12-24
27,شبندر,پالايش نفت بندرعباس,10175,40173664,1106990558540,27990,27990,27440,-550,-1.96,27560,-430,-1.54,27440,28570,1399-12-24
28,وپارس,بانك‌پارسيان‌,9737,305078582,958015396000,3100,3180,3060,-40,-1.29,3140,40,1.29,3050,3270,1399-12-24
29,وبصادر,بانك صادرات ايران,9175,288551731,702568396540,2360,2440,2400,40,1.69,2430,70,2.97,2380,2490,1399-12-24
30,كچاد,معدني‌وصنعتي‌چادرملو,9169,44306889,1023777042610,21940,22600,23130,1190,5.42,23110,1170,5.33,22200,23250,1399-12-24
31,آريا,پليمر آريا ساسول,8813,3807993,328139033192,85906,87630,85000,-906,-1.05,86171,265,0.31,84900,88400,1399-12-24
32,ذوب,سهامي ذوب آهن  اصفهان,7971,102344974,389326333994,3705,3762,3769,64,1.73,3804,99,2.67,3710,3858,1399-12-24
33,سيتا,سرمايه گذاري سيمان تامين,7741,9587443,144063314940,15010,15030,15010,0,0.0,15030,20,0.13,15000,15200,1399-12-24
34,بگيلان,توسعه مسير برق گيلان,7345,1932847,41144702387,21230,21240,21050,-180,-0.85,21277,47,0.22,20932,21880,1399-12-24
35,چكاپا,گروه صنايع كاغذ پارس,7022,72033151,379430199670,5040,5000,5340,300,5.95,5270,230,4.56,5000,5340,1399-12-24
36,ختوقا,قطعات‌ اتومبيل‌ ايران‌,6962,146670732,397545744110,2730,2680,2680,-50,-1.83,2710,-20,-0.73,2680,2790,1399-12-24
37,غپينو,پارس‌ مينو,6355,55338354,363926328550,6520,6390,6840,320,4.91,6580,60,0.92,6390,6890,1399-12-24
38,خمحركه,نيرو محركه‌,6104,63175684,306778903340,4890,4800,4800,-90,-1.84,4860,-30,-0.61,4800,5030,1399-12-24
39,فارس,صنايع پتروشيمي خليج فارس,5855,45690217,433836506100,9020,9340,9470,450,4.99,9500,480,5.32,9160,9560,1399-12-24
40,پيزد,مجتمع صنايع لاستيك يزد,5670,423178,28032070013,66106,67650,65720,-386,-0.58,66182,76,0.11,65400,67790,1399-12-24
41,غپاك,لبنيات‌ پاك‌,5630,19684043,479760301540,24470,24860,25040,570,2.33,24370,-100,-0.41,23990,25330,1399-12-24
42,كگل,معدني و صنعتي گل گهر,5400,24654062,494441085320,19180,19480,20330,1150,6.0,20060,880,4.59,19210,20330,1399-12-24
43,وساپا,سرمايه‌گذاري‌ سايپا,5342,85622593,530567430110,6270,6150,6150,-120,-1.91,6200,-70,-1.12,6150,6340,1399-12-24
44,پترول,گروه پتروشيمي س. ايرانيان,5243,24274294,230596477160,9340,9440,9450,110,1.18,9500,160,1.71,9370,9680,1399-12-24
45,بترانس,ايران‌ ترانسفو,5097,78548254,211604123360,2620,2670,2700,80,3.05,2690,70,2.67,2620,2760,1399-12-24
46,شگويا,پتروشيمي تندگويان,5041,22805309,193842104903,8382,8500,8425,43,0.51,8500,118,1.41,8300,8640,1399-12-24
47,سدبير,س. تدبيرگران فارس وخوزستان,4921,9677931,871117705463,90988,89169,92000,1012,1.11,90011,-977,-1.07,89169,93510,1399-12-24
48,حفاري,حفاري شمال,4890,37288935,278781275410,7490,7700,7490,0,0.0,7480,-10,-0.13,7350,7750,1399-12-24
49,بالاس,مهندسي ساختمان تاسيسات راه آهن,4863,3640365,220101939798,59390,61517,58203,-1187,-2.0,60462,1072,1.81,58203,62500,1399-12-24
50,كيميا,معدني كيمياي زنجان گستران,4760,25977676,475546820310,18613,18241,18241,-372,-2.0,18306,-307,-1.65,18241,18950,1399-12-24
51,ورنا,سرمايه‌گذاري‌ رنا(هلدينگ‌,4619,63418290,357389916120,5700,5590,5590,-110,-1.93,5640,-60,-1.05,5590,5830,1399-12-24
52,نوري,پتروشيمي نوري,4478,4517021,272978260570,58270,59960,60490,2220,3.81,60430,2160,3.71,58830,61600,1399-12-24
53,صبا,سرمايه گذاري صبا تامين,4412,16739872,129602596608,7496,7635,7810,314,4.19,7742,246,3.28,7560,7850,1399-12-24
54,سامان,بانك سامان,4289,60037029,639607635739,10760,10590,10701,-59,-0.55,10654,-106,-0.99,10545,10900,1399-12-24
55,سمگا,گروه سرمايه گذاري ميراث فرهنگي,4087,44883286,1235310512080,27476,28000,27777,301,1.1,27523,47,0.17,26927,28130,1399-12-24
56,دعبيد,لابراتوارداروسازي‌  دكترعبيدي‌,4071,9572590,239511549210,24050,25490,24500,450,1.87,25020,970,4.03,24060,25490,1399-12-24
57,خفولا,خدمات فني فولاد يزد,3958,6984191,335051938136,47322,48741,46480,-842,-1.78,47973,651,1.38,46376,48741,1399-12-24
58,فاراك,ماشين‌ سازي‌ اراك‌,3910,33102667,164941715610,4990,4930,4940,-50,-1.0,4980,-10,-0.2,4910,5110,1399-12-24
59,حريل,ريل پردازسير,3851,44123356,252435610997,5771,5656,5700,-71,-1.23,5721,-50,-0.87,5656,5975,1399-12-24
60,ثاخت,بين‌المللي‌توسعه‌ساختمان,3839,89375056,238749441910,2540,2610,2690,150,5.91,2670,130,5.12,2560,2690,1399-12-24
61,خاهن,آهنگري‌ تراكتورسازي‌ ايران‌,3792,8847502,329469905520,37610,36860,36860,-750,-1.99,37240,-370,-0.98,36860,38980,1399-12-24
62,وصنعت,سرمايه گذاري توسعه صنعت وتجارت,3704,26936064,181510926940,6830,6700,6730,-100,-1.46,6740,-90,-1.32,6700,7000,1399-12-24
63,آوا,صندوق س.سهام آواي معيار-س,3653,38593990,260419629597,6721,6767,6665,-56,-0.83,6748,27,0.4,6650,6890,1399-12-24
64,كلر,كلر پارس,3597,4842762,619158719852,130319,127713,127713,-2606,-2.0,127852,-2467,-1.89,127713,131200,1399-12-24
65,غنوش,نوش‌ مازندران‌,3547,4577008,274563698370,58790,59900,60500,1710,2.91,59990,1200,2.04,57800,62000,1399-12-24
66,ختراك,ريخته‌گري‌ تراكتورسازي‌ ايران‌,3483,21748779,359176254550,16530,16200,16200,-330,-2.0,16510,-20,-0.12,16200,17520,1399-12-24
67,كرازي,كارخانجات‌توليدي‌شيشه‌رازي‌,3439,7770226,188678645990,24320,25000,23840,-480,-1.97,24280,-40,-0.16,23840,25000,1399-12-24
68,ومعادن,توسعه‌معادن‌وفلزات‌,3261,15231565,193651531350,12300,12450,12620,320,2.6,12710,410,3.33,12320,13030,1399-12-24
69,امين يكم,صندوق درآمد ثابت امين يكم فردا,3237,105344675,1075360434187,10193,10205,10210,17,0.17,10208,15,0.15,10199,10214,1399-12-24
70,فخوز,فولاد  خوزستان,3236,17489787,252376710150,14060,14140,14500,440,3.13,14430,370,2.63,14120,14780,1399-12-24
71,خودكفا,اقتصادي و خودكفايي آزادگان,3216,9273489,216109171480,22961,23100,23000,39,0.17,23304,343,1.49,22510,23649,1399-12-24
72,هاي وب,داده گسترعصرنوين-هاي وب,3209,11589687,116786566040,9890,10200,9990,100,1.01,10080,190,1.92,9800,10340,1399-12-24
73,شبريز,پالايش نفت تبريز,3143,14392198,448287785490,31580,31610,30950,-630,-1.99,31150,-430,-1.36,30950,32100,1399-12-24
74,اخابر,مخابرات ايران,3052,16780131,159807852880,9630,9610,9450,-180,-1.87,9520,-110,-1.14,9440,9840,1399-12-24
75,تملت,تامين سرمايه بانك ملت,2971,16681017,91861392190,5510,5530,5510,0,0.0,5510,0,0.0,5420,5610,1399-12-24
76,ونوين,بانك‌اقتصادنوين‌,2960,80546284,344304103180,4210,4290,4310,100,2.38,4270,60,1.43,4160,4350,1399-12-24
77,رمپنا,گروه مپنا (سهامي عام),2916,18122109,284806012640,15620,15810,15810,190,1.22,15720,100,0.64,15320,16200,1399-12-24
78,ولانا,شركت ليزينگ آريا دانا,2867,5237927,210415688665,40417,40417,39615,-802,-1.98,40172,-245,-0.61,39609,41400,1399-12-24
79,فاسمين,كالسيمين‌,2789,12850847,224225036520,16830,17020,17170,340,2.02,17450,620,3.68,17020,17830,1399-12-24
80,غسالم,سالمين‌,2772,28084310,117438877870,4080,4040,4320,240,5.88,4180,100,2.45,4040,4320,1399-12-24
81,وپاسار,بانك  پاسارگاد,2572,42403893,529210086150,12200,12360,12510,310,2.54,12480,280,2.3,12260,12510,1399-12-24
82,شلرد,كود شيميايي اوره لردگان,2568,21088600,155633300588,7425,7650,7259,-166,-2.24,7380,-45,-0.61,7130,7690,1399-12-24
83,فوكا,فولاد كاويان,2507,22918707,277469923194,12133,12133,11891,-242,-1.99,12107,-26,-0.21,11891,12412,1399-12-24
84,ونيكي,سرمايه‌گذاري‌ ملي‌ايران‌,2486,9464227,104961715860,11230,11240,11010,-220,-1.96,11090,-140,-1.25,11010,11500,1399-12-24
85,كپارس,كاشي‌ پارس‌,2468,908325,139196218410,151430,150990,149000,-2430,-1.6,153240,1810,1.2,148410,158000,1399-12-24
86,مبين,مبين انرژي خليج فارس,2434,12823694,224674951590,16760,17530,17390,630,3.76,17520,760,4.53,16950,17760,1399-12-24
87,فمراد,آلومراد,2322,1563507,225990322220,147370,144430,144430,-2940,-1.99,144540,-2830,-1.92,144430,146880,1399-12-24
88,بجهرم,توسعه مولد نيروگاهي جهرم,2296,20176311,57669403997,2837,2810,2828,-9,-0.32,2858,21,0.74,2810,2919,1399-12-24
89,اعتماد,صندوق س.اعتماد آفرين پارسيان-د,2289,55882840,1974712850360,35318,35336,35340,22,0.06,35337,19,0.05,35335,35340,1399-12-24
90,چكارن,كارتن‌ ايران‌,2268,24478221,85561710140,3530,3460,3470,-60,-1.7,3500,-30,-0.85,3460,3590,1399-12-24
91,غشهداب,كشت و صنعت شهداب ناب خراسان,2259,18606045,71882865328,3825,3825,3865,40,1.05,3863,38,0.99,3770,3926,1399-12-24
92,چكاوه,صنايع‌كاغذسازي‌كاوه‌,2217,9398599,179250800660,18160,17800,19240,1080,5.95,19070,910,5.01,17800,19240,1399-12-24
93,دزهراويح,ح . ‌داروسازي‌زهراوي‌,2192,4733833,20794648720,4470,4330,4400,-70,-1.57,4390,-80,-1.79,4320,4490,1399-12-24
94,افق,فروشگاههاي زنجيره اي افق كوروش,2109,3727888,260030106650,70460,70500,69330,-1130,-1.6,69750,-710,-1.01,69060,72000,1399-12-24
95,پارسان,گسترش نفت و گاز پارسيان,2106,12890213,270903013170,20190,20610,20780,590,2.92,21020,830,4.11,20250,21400,1399-12-24
96,غگلپا,شير پاستوريزه پگاه گلپايگان,2098,2076237,158419352145,75925,79990,74407,-1518,-2.0,76301,376,0.5,74407,79990,1399-12-24
97,وهور,مديريت انرژي اميد  تابان هور,2087,78243095,173819546212,2252,2252,2207,-45,-2.0,2222,-30,-1.33,2207,2282,1399-12-24
98,بكهنوج,توليد برق ماهتاب كهنوج,2083,42102900,72850145596,1757,1723,1722,-35,-1.99,1730,-27,-1.54,1722,1778,1399-12-24
99,سفارس,سيمان فارس و خوزستان,2006,10329660,188744367360,18010,18000,18000,-10,-0.06,18270,260,1.44,17700,18770,1399-12-24
100,وشهر,بانك شهر,2004,21494129,137455571608,6179,6426,6391,212,3.43,6395,216,3.5,6200,6426,1399-12-24
101,كاوه,فولاد كاوه جنوب كيش,1968,16080131,327085328900,20080,20330,20340,260,1.29,20340,260,1.29,20000,20850,1399-12-24
102,سرو,صندوق س سروسودمند مدبران-سهام,1945,1904001,129336323940,67300,68200,67770,470,0.7,67930,630,0.94,67220,68790,1399-12-24
103,نوين,بيمه نوين,1918,15536706,87573943493,5730,5616,5638,-92,-1.61,5637,-93,-1.62,5616,5840,1399-12-24
104,شيران,س. صنايع‌شيميايي‌ايران,1905,4334930,113735768100,25980,26300,26200,220,0.85,26240,260,1.0,25980,26730,1399-12-24
105,رتاپ,تجارت الكترونيك  پارسيان,1885,12896300,96476034010,7070,7490,7490,420,5.94,7480,410,5.8,7280,7490,1399-12-24
106,خكرمان,گروه اقتصادي كرمان خودرو,1864,20052644,82120757765,4127,4046,4052,-75,-1.82,4095,-32,-0.78,4045,4240,1399-12-24
107,گكوثر,هتل پارسيان كوثر اصفهان,1808,31731841,76796437793,2437,2420,2449,12,0.49,2420,-17,-0.7,2390,2470,1399-12-24
108,آگاس,صندوق س.هستي بخش آگاه-س,1802,1781926,119567121613,66202,66870,67050,848,1.28,67100,898,1.36,66350,67600,1399-12-24
109,پارند,صندوق س. پارند پايدار سپهر,1789,105655035,1187864399559,11238,11245,11243,5,0.04,11243,5,0.04,11242,11245,1399-12-24
110,فنوال,نورد آلومينيوم‌,1784,4444845,115712839830,25530,27050,25520,-10,-0.04,26030,500,1.96,25050,27050,1399-12-24
111,شسپا,نفت سپاهان,1774,8901881,140622368480,15930,16100,15620,-310,-1.95,15800,-130,-0.82,15620,16100,1399-12-24
112,دي,بانك دي,1756,3590051,67539629463,19196,18813,18813,-383,-2.0,18813,-383,-2.0,18813,18813,1399-12-24
113,گوهران,سرمايه گذاري توسعه گوهران اميد,1753,13387367,97705970168,7331,7260,7331,0,0.0,7298,-33,-0.45,7185,7564,1399-12-24
114,ارفع,شركت آهن و فولاد ارفع,1746,5824881,84622871837,14304,14886,14540,236,1.65,14528,224,1.57,14225,14886,1399-12-24
115,وپست,پست بانك ايران,1719,8671419,162515159840,18180,18180,18430,250,1.38,18740,560,3.08,17860,19250,1399-12-24
116,سيلام,سيمان‌ ايلام‌,1710,15388177,178435503480,11720,11490,11490,-230,-1.96,11600,-120,-1.02,11490,11900,1399-12-24
117,زشگزا,شير و گوشت زاگرس شهركرد,1685,9191061,72258340300,7886,7729,7730,-156,-1.98,7862,-24,-0.3,7729,8100,1399-12-24
118,كيان,صندوق س. با درآمد ثابت كيان,1682,27946513,769831891571,27535,27550,27548,13,0.05,27547,12,0.04,27545,27550,1399-12-24
119,تاصيكو,سرمايه گذاري صدرتامين,1679,12445562,138350082610,11080,11060,11090,10,0.09,11120,40,0.36,10860,11390,1399-12-24
120,ونيرو,سرمايه‌گذاري‌نيرو,1656,28495918,77689101140,2670,2650,2770,100,3.75,2730,60,2.25,2640,2800,1399-12-24
121,ضخود2007,اختيارخ خودرو-3000-1400/02/08,1654,71645,7714069000,101,120,100,-1,-0.99,108,7,6.93,94,130,1399-12-24
122,وصندوق,سرمايه‌گذاري‌صندوق‌بازنشستگي‌,1644,16371549,234136267720,13680,13600,14350,670,4.9,14300,620,4.53,13600,14500,1399-12-24
123,كروي,توسعه‌ معادن‌ روي‌ ايران‌,1634,3734617,104169613290,27590,28330,27390,-200,-0.72,27890,300,1.09,27040,28700,1399-12-24
124,شفن,پتروشيمي فناوران,1623,302876,98933146640,315040,333000,323370,8330,2.64,325610,10570,3.36,319940,333000,1399-12-24
125,كارين2,صندوق س نگين سامان-ثابت,1621,16210000,16210000,10132,1,1,-10131,-99.99,1,-10131,-99.99,1,1,1399-12-24
126,تايرا,تراكتورسازي‌ايران‌,1609,4819237,136481623420,26890,28390,27620,730,2.71,28320,1430,5.32,27000,28500,1399-12-24
127,تاپيكو,س. نفت و گاز و پتروشيمي تأمين,1601,7333648,87454756420,11760,11980,11830,70,0.6,11870,110,0.94,11700,12160,1399-12-24
128,وسپهح,ح . سرمايه‌گذاري‌ سپه‌,1578,9461327,47984132500,5030,5010,5110,80,1.59,5070,40,0.8,4970,5130,1399-12-24
129,رانفور,خدمات‌انفورماتيك‌,1563,3881120,90535170370,23190,23170,23600,410,1.77,23330,140,0.6,22860,24050,1399-12-24
130,وملي,گروه‌ صنعتي‌ ملي‌ (هلدينگ‌,1522,435919,74326777160,170780,170440,168900,-1880,-1.1,170510,-270,-0.16,168560,174980,1399-12-24
131,زاگرس,پتروشيمي زاگرس,1515,751729,154734029510,203653,200110,206800,3147,1.55,205838,2185,1.07,200110,210200,1399-12-24
132,البرز,بيمه البرز,1482,22590092,79359083920,3470,3530,3500,30,0.86,3510,40,1.15,3460,3580,1399-12-24
133,دروز,داروسازي‌ روزدارو,1480,7859306,223663004280,27860,27310,29530,1670,5.99,28460,600,2.15,27310,29530,1399-12-24
134,زدشت,كشت و صنعت دشت خرم دره,1471,2408384,65468534802,27662,27110,27109,-553,-2.0,27184,-478,-1.73,27109,28020,1399-12-24
135,وبانك,سرمايه گذاري گروه توسعه ملي,1461,7004850,60207163990,8340,8400,8650,310,3.72,8500,160,1.92,8400,8750,1399-12-24
136,خمحور,توليدمحورخودرو,1437,2534373,168358796440,63420,67220,67220,3800,5.99,66430,3010,4.75,62160,67220,1399-12-24
137,كنور,توسعه معدني و صنعتي صبانور,1419,1491496,71008052160,46460,47130,46600,140,0.3,47610,1150,2.48,46020,49240,1399-12-24
138,ستران,سيمان‌ تهران‌,1418,2556908,66336094200,25950,25900,25630,-320,-1.23,25940,-10,-0.04,25550,26500,1399-12-24
139,شغدير,پتروشيمي غدير,1377,1163368,78530338089,65544,66000,67500,1956,2.98,67503,1959,2.99,66000,69300,1399-12-24
140,سشرق,سيمان‌ شرق‌,1373,10527926,71437503080,6900,6770,6770,-130,-1.88,6790,-110,-1.59,6770,6950,1399-12-24
141,وتوس,توسعه‌شهري‌توس‌گستر,1359,6293499,89092513290,14280,14000,14230,-50,-0.35,14160,-120,-0.84,14000,14840,1399-12-24
142,بكام,كارخانجات توليدي شهيد قندي,1356,12856325,43924827020,3420,3430,3420,0,0.0,3420,0,0.0,3390,3500,1399-12-24
143,قرن,پديده شيمي قرن,1349,761667,48404586440,63020,62100,63500,480,0.76,63530,510,0.81,62100,64490,1399-12-24
144,تنوين,تامين سرمايه نوين,1315,19003758,136773356520,7150,7120,7410,260,3.64,7200,50,0.7,7010,7420,1399-12-24
145,خفنر,فنرسازي‌خاور,1305,7302083,64098233970,8890,8720,8720,-170,-1.91,8780,-110,-1.24,8720,9060,1399-12-24
146,شاوان,پالايش نفت لاوان,1303,2089767,187664296531,86829,92038,89000,2171,2.5,89802,2973,3.42,87650,92038,1399-12-24
147,هرمز,فولاد هرمزگان جنوب,1282,6096419,85592085418,13624,13510,14000,376,2.76,13904,280,2.06,13510,14250,1399-12-24
148,تبرك,گروه كارخانجات صنعتي تبرك,1281,3994172,66265786328,16720,16720,16420,-300,-1.79,16591,-129,-0.77,16386,17113,1399-12-24
149,ضسپا3004,اختيارخ خساپا-2500-1400/03/26,1278,61745,13419356000,208,220,212,4,1.92,217,9,4.33,207,247,1399-12-24
150,خشرق,الكتريك‌ خودرو شرق‌,1273,6197952,100713281190,16510,16180,16180,-330,-2.0,16250,-260,-1.57,16180,16440,1399-12-24
151,مدير,ص.س.مديريت ثروت ص.بازنشستگي-س,1267,6987413,63491121214,9037,9120,9001,-36,-0.4,9086,49,0.54,8998,9268,1399-12-24
152,پارسيان,بيمه پارسيان,1266,9696953,106527437240,10920,11240,10710,-210,-1.92,10990,70,0.64,10710,11330,1399-12-24
153,طلا,صندوق س.پشتوانه طلاي لوتوس,1259,2136883,162169712245,76628,77000,74800,-1828,-2.39,75891,-737,-0.96,74800,77000,1399-12-24
154,پكوير,كوير تاير,1258,6360985,83376398620,13290,13300,13030,-260,-1.96,13110,-180,-1.35,13030,13600,1399-12-24
155,فلات,گروه صنايع معادن فلات ايرانيان,1250,4470522,63062997555,13723,14134,14134,411,2.99,14106,383,2.79,13805,14134,1399-12-24
156,جم پيلن,پلي پروپيلن جم - جم پيلن,1247,2071033,162599588230,76560,77970,78600,2040,2.66,78510,1950,2.55,77850,79900,1399-12-24
157,بساما,بيمه سامان,1233,2131635,49559053218,22111,22500,23436,1325,5.99,23141,1030,4.66,22500,23437,1399-12-24
158,فولاژ,فولاد آلياژي ايران,1206,8814776,162134690870,17490,17220,18530,1040,5.95,18390,900,5.15,17220,18530,1399-12-24
159,خكاوه,سايپا ديزل,1177,10864212,36189398823,3301,3271,3316,15,0.45,3331,30,0.91,3250,3390,1399-12-24
160,وملل,اعتباري ملل,1168,20584511,270177580791,13390,13123,13123,-267,-1.99,13125,-265,-1.98,13123,13338,1399-12-24
161,سبزوا,سيمان لار سبزوار,1141,9502505,33774207518,3618,3561,3546,-72,-1.99,3573,-45,-1.24,3546,3650,1399-12-24
162,شاراك,پتروشيمي شازند,1133,3660162,93212757570,25470,25800,25250,-220,-0.86,25470,0,0.0,25120,25980,1399-12-24
163,سكه0012پ01,سكه تمام بهارتحويلي 1روزه رفاه,1131,411800,430587845800,1057911,1057777,1033998,-23913,-2.26,1045624,-12287,-1.16,1022032,1062000,1399-12-24
164,دپارس,پارس‌ دارو,1128,864408,73876010070,85690,83980,83980,-1710,-2.0,85460,-230,-0.27,83980,88310,1399-12-24
165,ونفت,سرمايه‌گذاري‌ صنعت‌ نفت‌,1124,2550966,42593658940,16340,16970,16540,200,1.22,16630,290,1.77,16360,17000,1399-12-24
166,شكربن,كربن‌ ايران‌,1120,728282,69450799580,92900,96800,94400,1500,1.61,95360,2460,2.65,93650,98270,1399-12-24
167,فجر,فولاد اميركبيركاشان,1078,2302815,136906668110,60220,61150,59020,-1200,-1.99,59450,-770,-1.28,59020,61400,1399-12-24
168,ومهان,گروه توسعه مالي مهر آيندگان,1062,3970711,52469501837,13141,13540,13200,59,0.45,13214,73,0.56,12879,13690,1399-12-24
169,وبوعلي,سرمايه‌گذاري‌بوعلي‌,1061,6299417,35739390680,5660,5740,5650,-10,-0.18,5670,10,0.18,5560,5790,1399-12-24
170,آريان,سرمايه گذاري پارس آريان,1060,16748555,186954262187,10958,11286,11286,328,2.99,11162,204,1.86,10851,11286,1399-12-24
171,تسه9911,امتياز تسهيلات مسكن بهمن99,1057,17961,10680408350,605685,605555,580000,-25685,-4.24,594644,-11041,-1.82,576755,620000,1399-12-24
172,جم,پتروشيمي جم,1054,5287619,191035292460,35930,37500,35900,-30,-0.08,36130,200,0.56,35710,37880,1399-12-24
173,ضخود2006,اختيارخ خودرو-2500-1400/02/08,1047,42657,10227069000,218,231,230,12,5.5,240,22,10.09,221,290,1399-12-24
174,همراه,شركت ارتباطات سيار ايران,1026,3148386,79447908500,25470,25020,25010,-460,-1.81,25280,-190,-0.75,24970,25900,1399-12-24
175,ارزش,صندوق س ارزش آفرين بيدار-سهام,995,5560391,53631774720,9540,9690,9590,50,0.52,9650,110,1.15,9570,9740,1399-12-24
176,والبر,سرمايه‌ گذاري‌ البرز(هلدينگ‌,989,4948747,82955776070,16940,16950,16610,-330,-1.95,16760,-180,-1.06,16610,16960,1399-12-24
177,لسرما,سرما آفرين‌,985,1790435,47238294670,26730,26200,26200,-530,-1.98,26400,-330,-1.23,26200,27550,1399-12-24
178,سنوين,سرمايه گذاري اقتصاد نوين,982,6217235,64251274288,10067,10368,10369,302,3.0,10334,267,2.65,10067,10369,1399-12-24
179,خريخت,صنايع‌ريخته‌گري‌ايران‌,971,12201562,41915008800,3410,3410,3400,-10,-0.29,3430,20,0.59,3350,3520,1399-12-24
180,خديزل,بهمن  ديزل,965,1959467,78919823433,40677,39864,39868,-809,-1.99,40276,-401,-0.99,39864,42752,1399-12-24
181,پارس,پتروشيمي پارس,947,787644,116966755510,145640,151600,146060,420,0.29,148500,2860,1.96,144070,151690,1399-12-24
182,شپديس,پتروشيمي پرديس,933,1735634,167050131680,94650,97990,95510,860,0.91,96250,1600,1.69,95150,97990,1399-12-24
183,جمح,ح . پتروشيمي جم,908,1482190,44005632610,29610,30900,29140,-470,-1.59,29690,80,0.27,29020,30900,1399-12-24
184,ورازي,بيمه رازي,885,4812099,40287342690,8515,8150,8250,-265,-3.11,8372,-143,-1.68,8150,8867,1399-12-24
185,اميد,تامين سرمايه اميد,837,9204894,76921556620,8460,8460,8300,-160,-1.89,8360,-100,-1.18,8300,8500,1399-12-24
186,كرماشا,صنايع پتروشيمي كرمانشاه,831,1355488,52213001930,36740,38910,38500,1760,4.79,38440,1700,4.63,37620,38940,1399-12-24
187,فسپا,گروه‌صنعتي‌سپاهان‌,813,1383062,52394965030,37100,37200,37500,400,1.08,37880,780,2.1,37200,38400,1399-12-24
188,فسازان,غلتك سازان سپاهان,808,2008234,66844324260,33550,34640,33000,-550,-1.64,33290,-260,-0.77,32880,34640,1399-12-24
189,وسكاب,س.ص.بازنشستگي كاركنان بانكها,807,7685046,40810064520,5220,5340,5250,30,0.57,5290,70,1.34,5230,5380,1399-12-24
190,وآرين,شركت توسعه اقتصادي آرين,803,8997937,34644019650,3844,3780,3927,83,2.16,3850,6,0.16,3768,3950,1399-12-24
191,شجم,صنايع پتروشيمي تخت جمشيد,786,8275375,79973394420,9850,9653,9697,-153,-1.55,9664,-186,-1.89,9653,9850,1399-12-24
192,پلاسك,پلاسكوكار,770,5200391,40906253180,8020,7860,7860,-160,-2.0,7890,-130,-1.62,7860,8000,1399-12-24
193,بميلا,توسعه بازرگاني آهن وفولادميلاد,769,2862970,47968420785,17488,17930,16614,-874,-5.0,16755,-733,-4.19,16614,17930,1399-12-24
194,رنيك,جنرال مكانيك,767,1123442,23047026135,20374,20450,20302,-72,-0.35,20438,64,0.31,20298,21000,1399-12-24
195,ثزاگرس,سرمايه گذاري توسعه عمران زاگرس,762,991901,58582377696,61988,58889,58889,-3099,-5.0,59061,-2927,-4.72,58889,60810,1399-12-24
196,وسپه,سرمايه‌گذاري‌ سپه‌,759,5017349,33987149530,6690,6840,6720,30,0.45,6750,60,0.9,6600,6860,1399-12-24
197,بموتو,موتوژن‌,751,328407,18782408900,56980,58400,56400,-580,-1.02,57060,80,0.14,56000,58400,1399-12-24
198,وساخت,سرمايه‌ گذاري‌ ساختمان‌ايران‌,750,1030591,45634246920,45050,44970,44150,-900,-2.0,44320,-730,-1.62,44150,45050,1399-12-24
199,وخاور,بانك خاورميانه,741,10166887,91353048650,8980,9100,9010,30,0.33,8990,10,0.11,8810,9200,1399-12-24
200,كاردان,صندوق س تجارت شاخصي كاردان,740,379859,59134197150,154320,156050,155000,680,0.44,155670,1350,0.87,152300,157990,1399-12-24
201,سرچشمه,سرمايه گذاري مس سرچشمه,722,3664974,23561302865,6364,6440,6361,-3,-0.05,6394,30,0.47,6360,6550,1399-12-24
202,كپشير,پشم‌شيشه‌ايران‌,719,1507578,62465040500,42110,41270,41270,-840,-1.99,41430,-680,-1.61,41270,43100,1399-12-24
203,قچار,فراوردههاي غذايي وقند چهارمحال,715,534190,49123228917,92761,91000,90906,-1855,-2.0,91958,-803,-0.87,90906,94340,1399-12-24
204,شبصير,توليدات پتروشيمي قائد بصير,706,6754849,440726877854,61553,65246,65246,3693,6.0,65246,3693,6.0,65246,65246,1399-12-24
205,حسينا,توسعه خدمات دريايي وبندري سينا,685,772010,54651161185,69822,69500,71500,1678,2.4,70791,969,1.39,69500,72500,1399-12-24
206,سپاها,سيمان‌سپاهان‌,662,3926853,32974258450,8540,8420,8370,-170,-1.99,8440,-100,-1.17,8370,8590,1399-12-24
207,وحكمت,بيمه حكمت صبا,654,7649946,27709561563,3694,3621,3665,-29,-0.79,3622,-72,-1.95,3621,3700,1399-12-24
208,شوينده,مديريت صنعت شوينده ت.ص.بهشهر,630,1767461,52603040050,30010,30010,29410,-600,-2.0,29760,-250,-0.83,29410,30500,1399-12-24
209,وپترو,سرمايه‌گذاري صنايع پتروشيمي‌,623,2366125,34783009620,14880,14850,14590,-290,-1.95,14750,-130,-0.87,14590,15200,1399-12-24
210,دالبر,البرزدارو,616,2441328,37775332350,14950,15710,15130,180,1.2,15330,380,2.54,15100,15840,1399-12-24
211,تسه9908,امتياز تسهيلات مسكن آبان99,616,15190,8850004206,593698,571000,567000,-26698,-4.5,582620,-11078,-1.87,564014,619998,1399-12-24
212,تيپيكو,سرمايه گذاري دارويي تامين,604,1287494,51595460430,39850,40240,39910,60,0.15,40020,170,0.43,39800,40500,1399-12-24
213,ساراب,سيمان‌ داراب‌,596,2760635,45010327660,16630,16300,16300,-330,-1.98,16330,-300,-1.8,16300,16540,1399-12-24
214,شفارا,پتروشيمي فارابي,584,3927403,15329072408,3948,3871,3900,-48,-1.22,3913,-35,-0.89,3870,3989,1399-12-24
215,غپونه,نوش پونه مشهد,583,1548509,31544123299,20782,20367,20367,-415,-2.0,20371,-411,-1.98,20367,20757,1399-12-24
216,آساميد,صندوق س.مشترك آسمان اميد -د,581,27975994,326592791662,11669,11675,11676,7,0.06,11674,5,0.04,11674,11680,1399-12-24
217,سيدكو,سرمايه گذاري توسعه صنايع سيمان,574,4114636,24703771860,6050,5930,6030,-20,-0.33,6030,-20,-0.33,5930,6110,1399-12-24
218,حتايد,تايدواترخاورميانه,574,1872517,45745706080,24310,24110,24480,170,0.7,24420,110,0.45,24110,25000,1399-12-24
219,سخوز,سيمان خوزستان,571,1397535,29997563070,21640,21320,21250,-390,-1.8,21530,-110,-0.51,21210,22160,1399-12-24
220,شرانل,نفت ايرانول,564,1808546,65901055693,36879,36200,36142,-737,-2.0,36439,-440,-1.19,36142,37920,1399-12-24
221,وبشهر,توسعه‌ صنايع‌ بهشهر(هلدينگ,560,2409299,28617670610,11700,11600,11600,-100,-0.85,11800,100,0.85,11530,12250,1399-12-24
222,ثباغ,شهر سازي و خانه سازي باغميشه,560,1585697,23115122962,14846,14550,14550,-296,-1.99,14719,-127,-0.86,14550,14864,1399-12-24
223,ميدكو,هلدينگ صنايع  معدني خاورميانه,554,4130321,126365926336,30394,30500,30700,306,1.01,30595,201,0.66,30394,30790,1399-12-24
224,تسه9910,امتياز تسهيلات مسكن دي99,547,12777,7506537469,590797,591100,582800,-7997,-1.35,587504,-3293,-0.56,571100,607885,1399-12-24
225,حكشتي,كشتيراني جمهوري اسلامي ايران,545,1289418,24718143060,19560,19170,19170,-390,-1.99,19480,-80,-0.41,19170,19170,1399-12-24
226,وسين,بيمه سينا,545,2459996,35140738153,14511,14303,14221,-290,-2.0,14285,-226,-1.56,14221,14506,1399-12-24
227,اطلس,صندوق س.توسعه اندوخته آينده-س,539,108052,22804696149,210337,212000,209013,-1324,-0.63,211053,716,0.34,209001,212500,1399-12-24
228,پكرمان,گروه‌ صنعتي‌ بارز,527,1377810,37027310480,25750,25700,26750,1000,3.88,26540,790,3.07,25700,27290,1399-12-24
229,كهمدا,شيشه‌ همدان‌,527,1612450,15824104730,9870,9780,9900,30,0.3,9850,-20,-0.2,9730,10000,1399-12-24
230,شخارك,پتروشيمي‌ خارك‌,522,723939,32227919830,43890,45400,44100,210,0.48,44090,200,0.46,44020,45420,1399-12-24
231,تماوند,تامين سرمايه دماوند,521,2395230,36783927097,15526,15900,15216,-310,-2.0,15357,-169,-1.09,15216,15900,1399-12-24
232,غبشهر,صنعتي‌ بهشهر,519,1244519,25004849610,20200,20330,20190,-10,-0.05,20150,-50,-0.25,19800,20800,1399-12-24
233,بپاس,بيمه پاسارگاد,519,3489986,240048217052,70185,68782,68782,-1403,-2.0,68782,-1403,-2.0,68782,68782,1399-12-24
234,شگلح,ح . گلتاش‌,513,2452438,15950675420,6520,6670,6400,-120,-1.84,6500,-20,-0.31,6360,6680,1399-12-24
235,غفارس,شير پاستوريزه پگاه فارس,508,2325551,37547831357,16455,16400,16126,-329,-2.0,16214,-241,-1.46,16126,16406,1399-12-24
236,شنفت,نفت‌ پارس‌,505,293553,14424364090,49950,49970,48960,-990,-1.98,49710,-240,-0.48,48960,50000,1399-12-24
237,واحيا,م .صنايع و معادن احياء سپاهان,500,748657,106013472771,139476,140000,141500,2024,1.45,141605,2129,1.53,140000,142800,1399-12-24
238,وگردش,بانك گردشگري,499,3579745,61821176368,17423,17075,17500,77,0.44,17327,-96,-0.55,17075,17695,1399-12-24
239,وبهمن,سرمايه‌گذاري‌بهمن‌,494,2177553,34865154980,16280,15980,15960,-320,-1.97,16090,-190,-1.17,15960,16550,1399-12-24
240,شپاس,نفت پاسارگاد,493,1086304,24554877186,21551,22310,22830,1279,5.93,22031,480,2.23,22120,22844,1399-12-24
241,شلعاب,لعابيران‌,491,1746917,38167501500,22250,21810,21810,-440,-1.98,21940,-310,-1.39,21810,22010,1399-12-24
242,جوين,كشت و صنعت جوين,487,16287581,95086897878,5957,5838,5838,-119,-2.0,5838,-119,-2.0,5838,5838,1399-12-24
243,ثمسكن,سرمايه‌گذاري‌ مسكن‌,484,6580935,35324784150,5370,5400,5390,20,0.37,5370,0,0.0,5300,5500,1399-12-24
244,دتماد,توليدمواداوليه‌داروپخش‌,483,344292,15012454580,43630,44720,43200,-430,-0.99,43620,-10,-0.02,43010,44720,1399-12-24
245,تصميم,صندوق س با درآمد ثابت تصميم,483,6030389,95659118326,15859,15869,15861,2,0.01,15863,4,0.03,15860,15870,1399-12-24
246,وثنو,سرمايه گذاري ساختماني نوين,478,5569400,34544099319,5909,6204,6204,295,4.99,6202,293,4.96,6054,6204,1399-12-24
247,خراسان,پتروشيمي خراسان,454,419397,31573312730,73390,76390,73300,-90,-0.12,74500,1110,1.51,73030,76390,1399-12-24
248,سيستم,همكاران سيستم,449,611253,15767141300,25970,25950,25900,-70,-0.27,25910,-60,-0.23,25520,26150,1399-12-24
249,مارون,پتروشيمي مارون,446,215033,33197230972,149190,152999,154039,4849,3.25,150853,1663,1.11,151000,157226,1399-12-24
250,فيروزه,صندوق شاخص30 شركت فيروزه- سهام,445,302409,41867782610,136750,138890,137500,750,0.55,138450,1700,1.24,136750,140820,1399-12-24
251,شپاكسا,پاكسان‌,443,725513,18656010260,25880,25450,25920,40,0.15,25820,-60,-0.23,25370,26210,1399-12-24
252,دشيميح,ح . شيمي‌ داروئي‌ داروپخش‌,439,606523,11988610010,19440,19110,19650,210,1.08,19770,330,1.7,19110,20300,1399-12-24
253,ياقوت,صندوق س ياقوت آگاه-ثابت,439,6066111,73092823048,12043,12050,12055,12,0.1,12049,6,0.05,12048,12055,1399-12-24
254,كگهر,سنگ آهن گهرزمين,438,2458088,113970592966,46232,47350,46230,-2,0.0,46358,126,0.27,46005,47350,1399-12-24
255,كاريس,صندوق س.سپهر كاريزما-س,434,2017651,21838666890,10739,10987,10848,109,1.01,10824,85,0.79,10685,10987,1399-12-24
256,وتوشه,سرمايه‌ گذاري‌ پارس‌ توشه‌,427,1189399,26692887840,22420,22520,21980,-440,-1.96,22430,10,0.04,21980,23340,1399-12-24
257,غويتاح,ح . ويتانا,423,1747829,20236364612,11814,11578,11578,-236,-2.0,11578,-236,-2.0,11578,11579,1399-12-24
258,سحرخيز,صندوق س. گروه زعفران سحرخيز,420,2223125,21187430136,9539,9445,9543,4,0.04,9530,-9,-0.09,9421,9639,1399-12-24
259,بخاور,بيمه زندگي خاورميانه,416,3404322,23452557493,7006,6870,6866,-140,-2.0,6950,-56,-0.8,6866,7220,1399-12-24
260,وكار,بانك‌ كارآفرين‌,412,7839706,18954151610,2450,2480,2410,-40,-1.63,2440,-10,-0.41,2410,2480,1399-12-24
261,شيراز,پتروشيمي‌شيراز,410,735809,40356004990,53230,55990,55410,2180,4.1,53830,600,1.13,54050,55990,1399-12-24
262,آكورد,صندوق س. آرمان آتي كوثر-د,405,4912698,153046147056,31138,31153,31155,17,0.05,31153,15,0.05,31152,31157,1399-12-24
263,تسه9909,امتياز تسهيلات مسكن آذر99,398,5880,3472960497,598425,571855,568504,-29921,-5.0,590640,-7785,-1.3,568504,628346,1399-12-24
264,ارفعح,ح.شركت آهن و فولاد ارفع,395,59874912,724907345014,12354,13050,12107,-247,-2.0,12107,-247,-2.0,12107,13050,1399-12-24
265,وسرمد,بيمه  سرمد,386,2472841,15885324301,6378,6568,6380,2,0.03,6414,36,0.56,6302,6569,1399-12-24
266,ما,بيمه  ما,380,4643341,34886256510,7650,7540,7500,-150,-1.96,7550,-100,-1.31,7500,7760,1399-12-24
267,عيار,صندوق س. پشتوانه طلاي مفيد,374,429415,11626043047,26986,27200,26615,-371,-1.37,27074,88,0.33,26600,27380,1399-12-24
268,وارس,سرمايه گذاري ارس صبا,374,2064228,29737882503,14022,13801,14442,420,3.0,14406,384,2.74,13801,14442,1399-12-24
269,بفجر,فجر انرژي خليج فارس,371,783535,18681183790,23000,23790,23770,770,3.35,23250,250,1.09,23340,24170,1399-12-24
270,نهال,صندوق س. طلاي سرخ نوويرا,360,1022707,9636352652,9319,9304,9358,39,0.42,9422,103,1.11,9201,9519,1399-12-24
271,آسيا,بيمه آسيا,347,8779533,20456311890,2370,2330,2330,-40,-1.69,2350,-20,-0.84,2330,2330,1399-12-24
272,اتكام,شركت بيمه اتكايي امين,342,2306338,11221234889,4954,4860,4855,-99,-2.0,4934,-20,-0.4,4855,4980,1399-12-24
273,زفكاح,ح . كشت و دامداري فكا,338,1476084,11051653726,7563,7580,7460,-103,-1.36,7487,-76,-1.0,7440,7599,1399-12-24
274,شكبير,پتروشيمي اميركبير,337,1005978,88167037332,87850,89070,86093,-1757,-2.0,87668,-182,-0.21,86093,89070,1399-12-24
275,ضخود2005,اختيارخ خودرو-2000-1400/02/08,336,8616,5228307000,528,600,610,82,15.53,607,79,14.96,558,635,1399-12-24
276,ساينا,صنايع بهداشتي ساينا,330,57475,8994711047,159491,156302,156303,-3188,-2.0,158940,-551,-0.35,156302,160000,1399-12-24
277,پرديس,سرمايه گذاري پرديس,327,2547042,14087846700,5600,5650,5490,-110,-1.96,5580,-20,-0.36,5490,5650,1399-12-24
278,ولساپا,ليزينگ رايان‌ سايپا,320,5516115,19637369400,3630,3560,3560,-70,-1.93,3600,-30,-0.83,3560,3560,1399-12-24
279,زر,صندوق س.پشتوانه سكه طلاي زر,315,427449,19661199471,46459,46800,45500,-959,-2.06,45997,-462,-0.99,45500,46800,1399-12-24
280,دارو,كارخانجات‌داروپخش‌,313,275240,9142598630,32940,33630,33160,220,0.67,32990,50,0.15,32320,34520,1399-12-24
281,كگاز,شيشه‌ و گاز,313,812837,14749479710,18510,18140,18140,-370,-2.0,18400,-110,-0.59,18140,18220,1399-12-24
282,شكلر,نيروكلر,312,259571,12960062870,50930,49920,49920,-1010,-1.98,50660,-270,-0.53,49920,50800,1399-12-24
283,پسهند,صنايع‌ لاستيكي‌  سهند,309,230008,9879672290,43280,43920,42690,-590,-1.36,43210,-70,-0.16,42460,44000,1399-12-24
284,ضسپا3003,اختيارخ خساپا-2000-1400/03/26,308,11403,5286582000,420,457,440,20,4.76,464,44,10.48,420,480,1399-12-24
285,قپيرا,فرآورده‌هاي‌غدايي‌وقندپيرانشهر,307,175882,18035019870,104620,102530,102530,-2090,-2.0,103850,-770,-0.74,102530,104430,1399-12-24
286,زرين,صندوق س. سهام زرين كوروش-س,305,2435783,24335275850,10161,10130,9930,-231,-2.27,9991,-170,-1.67,9810,10249,1399-12-24
287,دسبحا,گروه دارويي سبحان,300,1976607,37949024580,18930,20060,19000,70,0.37,19130,200,1.06,18700,20060,1399-12-24
288,آساس,صندوق س.آسمان آرماني سهام-س,294,132041,21682059301,161125,163000,164990,3865,2.4,164207,3082,1.91,163000,166027,1399-12-24
289,شراز,پالايش نفت شيراز,292,173104,19168051833,112730,114900,110506,-2224,-1.97,111949,-781,-0.69,110476,114900,1399-12-24
290,لبوتان,گروه‌صنعتي‌بوتان‌,290,183868,11179944600,61840,60620,60610,-1230,-1.99,61600,-240,-0.39,60610,61650,1399-12-24
291,اتكاي,بيمه اتكايي ايرانيان,289,1388451,22558128262,15335,16225,16255,920,6.0,15723,388,2.53,16200,16255,1399-12-24
292,تسه9907,امتياز تسهيلات مسكن مهر99,283,4217,2475154144,599970,569972,571111,-28859,-4.81,586947,-13023,-2.17,569972,629968,1399-12-24
293,انرژي3,سايراشخاص بورس انرژي,283,43213,11264764840,265990,260680,260680,-5310,-2.0,265030,-960,-0.36,260680,260680,1399-12-24
294,سهگمت,سيمان‌هگمتان‌,282,748623,18789397110,25550,25040,25050,-500,-1.96,25380,-170,-0.67,25040,25780,1399-12-24
295,سغرب,سيمان‌غرب‌,278,856468,32580042720,38810,38040,38040,-770,-1.98,38300,-510,-1.31,38040,38040,1399-12-24
296,ختراكح,ح . ريخته‌گري‌ تراكتورسازي‌,276,4946545,61089852850,12550,12400,12350,-200,-1.59,12350,-200,-1.59,12350,12400,1399-12-24
297,شفا,سرمايه گذاري شفادارو,276,274689,12434690540,46030,45110,45120,-910,-1.98,45840,-190,-0.41,45110,46830,1399-12-24
298,كالا,بورس كالاي ايران,275,1056588,35786635560,34560,33870,33870,-690,-2.0,34050,-510,-1.48,33870,33870,1399-12-24
299,خصدرا,صنعتي‌ دريايي‌ ايران‌,275,3900017,11056548195,2892,2835,2835,-57,-1.97,2871,-21,-0.73,2835,2835,1399-12-24
300,پارتا,مجتمع‌صنعتي‌آرتاويل‌تاير,274,445981,25307169374,57850,56693,56693,-1157,-2.0,56825,-1025,-1.77,56693,59000,1399-12-24
301,فروي,ذوب روي اصفهان,272,187777,12019981324,65318,64012,64012,-1306,-2.0,64996,-322,-0.49,64012,64012,1399-12-24
302,بورس,بورس اوراق بهادار تهران,269,1210429,45294253180,38180,37420,37420,-760,-1.99,37610,-570,-1.49,37420,37420,1399-12-24
303,افران,صندوق س افرا نماد پايدار-ثابت,268,4928336,63484394786,12866,12871,12888,22,0.17,12882,16,0.12,12869,12890,1399-12-24
304,واعتبار,سرمايه گذاري اعتبار ايران,266,1632976,14477144210,8960,8820,9000,40,0.45,8930,-30,-0.33,8800,9180,1399-12-24
305,بالبر,كابل‌ البرز,257,175796,10718282120,62210,60970,60970,-1240,-1.99,61940,-270,-0.43,60970,60970,1399-12-24
306,امين يكم2,صندوق درآمد ثابت امين يكم فردا,250,25000000,25000000,10193,1,1,-10192,-99.99,1,-10192,-99.99,1,1,1399-12-24
307,دسبحان,سبحان دارو,246,972479,21093780510,21670,21310,21240,-430,-1.98,21680,10,0.05,21240,22000,1399-12-24
308,پتاير,ايران‌ تاير,243,9917537,41653655400,4280,4200,4200,-80,-1.87,4210,-70,-1.64,4200,4200,1399-12-24
309,سپ,پرداخت الكترونيك سامان كيش,242,716178,11943360880,17010,16680,16800,-210,-1.23,16930,-80,-0.47,16670,16980,1399-12-24
310,شپترو,پتروشيمي آبادان,239,6201049,33014384876,5169,5324,5324,155,3.0,5324,155,3.0,5324,5324,1399-12-24
311,پارند2,صندوق س. پارند پايدار سپهر,239,23900000,23900000,11238,1,1,-11237,-99.99,1,-11237,-99.99,1,1,1399-12-24
312,شرنگي,شيميايي رنگين,237,131597,30250968573,223311,230010,230010,6699,3.0,229876,6565,2.94,222000,230010,1399-12-24
313,ثبهساز,بهساز كاشانه تهران,224,1625168,3770389760,2360,2320,2320,-40,-1.69,2360,0,0.0,2320,2320,1399-12-24
314,شكف,كف,224,117346,9838175522,83907,84000,85539,1632,1.95,83840,-67,-0.08,82229,85583,1399-12-24
315,دكپسولح,ح .توليد ژلاتين كپسول ايران,221,615516,13499894478,22118,21676,21680,-438,-1.98,21933,-185,-0.84,21676,22773,1399-12-24
316,قنقش,قند نقش جهان,217,350176,26134348636,76080,74559,74559,-1521,-2.0,74632,-1448,-1.9,74559,75990,1399-12-24
317,اخزا903,اسنادخزانه-م3بودجه99-011110,212,479105,330159930311,690633,687116,682500,-8133,-1.18,689118,-1515,-0.22,673002,693000,1399-12-24
318,پخش,پخش البرز,211,1185430,40060753192,33927,33250,33249,-678,-2.0,33819,-108,-0.32,33249,34370,1399-12-24
319,تسه9902,امتياز تسهيلات مسكن ارديبهشت99,207,3154,1836305643,594502,570100,570000,-24502,-4.12,582215,-12287,-2.07,565000,598870,1399-12-24
320,دلر,داروسازي‌ اكسير,205,385080,13908910400,36620,35930,36000,-620,-1.69,36480,-140,-0.38,35890,37040,1399-12-24
321,وايرا,سرمايه گذاري صنايع ايران,205,1094383,12463746834,11602,11650,11370,-232,-2.0,11467,-135,-1.16,11370,11650,1399-12-24
322,ساربيل,سيمان آرتا اردبيل,205,531598,31374913960,60220,59020,59020,-1200,-1.99,59450,-770,-1.28,59020,59020,1399-12-24
323,كپرور,فرآوري زغال سنگ پروده طبس,204,230092,8819502391,39000,38250,38220,-780,-2.0,38879,-121,-0.31,38220,39170,1399-12-24
324,دكيمي,كيميدارو,204,270402,6809304140,25660,25170,25300,-360,-1.4,25590,-70,-0.27,25150,25500,1399-12-24
325,شاملا,معدني‌ املاح‌  ايران‌,202,177116,9169466110,52180,51480,51170,-1010,-1.94,52100,-80,-0.15,51140,53500,1399-12-24
326,سكه9912پ04,سكه تمام بهارتحويل1روزه صادرات,196,74100,77665700100,1062508,1047103,1036000,-26508,-2.49,1048120,-14388,-1.35,1032500,1061999,1399-12-24
327,تكنار,مجتمع معادن مس تكنار,196,167234,23312879938,142081,139240,139240,-2841,-2.0,139403,-2678,-1.88,139240,143000,1399-12-24
328,كاذرح,ح . فرآورده‌هاي‌نسوزآذر,194,4600400,141682945520,26820,32050,30770,3950,14.73,30800,3980,14.84,30770,32050,1399-12-24
329,اخزا902,اسنادخزانه-م2بودجه99-011019,185,489374,341697219266,699619,695000,695898,-3721,-0.53,698233,-1386,-0.2,688555,700000,1399-12-24
330,تسه9905,امتياز تسهيلات مسكن مرداد99,184,3145,1846530500,597276,590000,567444,-29832,-4.99,587132,-10144,-1.7,567444,600000,1399-12-24
331,آتيمس,صندوق س.آرمان آتيه درخشان مس-س,181,42602,7732848110,180056,180000,181000,944,0.52,181514,1458,0.81,178370,184939,1399-12-24
332,ضپاس2002,اختيارخ وپارس-3000-1400/02/29,179,3878,1580503000,341,400,360,19,5.57,408,67,19.65,352,449,1399-12-24
333,جهرم,پتروشيمي جهرم,177,3005699,5569560247,1930,1853,1853,-77,-3.99,1908,-22,-1.14,1853,1853,1399-12-24
334,تسه9810,امتياز تسهيلات مسكن دي98,177,2462,1440815937,592707,567444,570000,-22707,-3.83,585222,-7485,-1.26,563072,622000,1399-12-24
335,بنو,بيمه تجارت نو,177,4997132,170167335996,34747,34053,34053,-694,-2.0,34053,-694,-2.0,34053,34053,1399-12-24
336,خبازرس,بازرسي مهندسي و صنعتي ايران,177,583097,19819467030,34683,33990,33990,-693,-2.0,33990,-693,-2.0,33990,33990,1399-12-24
337,تسه9801,امتياز تسهيلات مسكن فروردين98,176,2380,1341424844,581499,553000,552425,-29074,-5.0,563624,-17875,-3.07,552425,580000,1399-12-24
338,تسه9906,امتياز تسهيلات مسكن شهريور99,176,1620,958155937,593759,593759,581000,-12759,-2.15,591454,-2305,-0.39,565182,623446,1399-12-24
339,وپخش,داروپخش‌ (هلدينگ‌,176,89327,9023986190,103050,100990,100990,-2060,-2.0,102670,-380,-0.37,100990,101660,1399-12-24
340,كمينا,شيشه سازي مينا,176,388483,9039999410,24239,23270,23270,-969,-4.0,23774,-465,-1.92,23270,23270,1399-12-24
341,زبينا,كشاورزي و دامپروري بينالود,171,3837903,13455687918,3577,3506,3506,-71,-1.98,3557,-20,-0.56,3506,3506,1399-12-24
342,فرابورس,فرابورس ايران,170,213023,6895554510,33030,32370,32370,-660,-2.0,32937,-93,-0.28,32370,32370,1399-12-24
343,دزهراوي,داروسازي‌زهراوي‌,168,535708,4199950720,8000,7840,7840,-160,-2.0,7990,-10,-0.13,7840,7840,1399-12-24
344,فسرب,ملي‌ سرب‌وروي‌ ايران‌,167,98136,8008878960,83270,81610,81610,-1660,-1.99,83000,-270,-0.32,81610,81610,1399-12-24
345,تسه9904,امتياز تسهيلات مسكن تير99,163,2014,1169106640,601942,573000,571845,-30097,-5.0,580490,-21452,-3.56,571845,591000,1399-12-24
346,وتوسم,سرمايه‌گذاري‌توسعه‌ملي‌,161,1615561,15767875360,9950,9760,9760,-190,-1.91,9890,-60,-0.6,9760,9760,1399-12-24
347,ومشان,س. فني و مهندسي مشانير,159,168033,12912327852,74606,76844,76844,2238,3.0,75970,1364,1.83,76844,76844,1399-12-24
348,تسه9903,امتياز تسهيلات مسكن خرداد99,158,1499,873211809,590961,566553,561515,-29446,-4.98,582530,-8431,-1.43,561413,599999,1399-12-24
349,سصوفي,سيمان‌ صوفيان‌,154,1301261,24684921170,19350,18970,18970,-380,-1.96,19160,-190,-0.98,18970,18970,1399-12-24
350,ماديرا,صنايع ماشين هاي اداري ايران,152,477282,4215354624,9012,8832,8832,-180,-2.0,8996,-16,-0.18,8832,8832,1399-12-24
351,وبيمهح,ح . سرمايه‌ گذاري‌ صنعت‌ بيمه‌,151,4660058,4686374230,1020,1040,1000,-20,-1.96,1010,-10,-0.98,1000,1040,1399-12-24
352,اخزا910,اسنادخزانه-م10بودجه99-020807,150,293840,172098086656,586693,586900,583683,-3010,-0.51,585686,-1007,-0.17,583570,586900,1399-12-24
353,اخزا909,اسنادخزانه-م9بودجه99-020316,149,699595,443540519546,635377,632100,633001,-2376,-0.37,633996,-1381,-0.22,632004,635380,1399-12-24
354,گوهر,صندوق سكه طلاي كيان,144,73928,3936733743,52857,54100,52447,-410,-0.78,53251,394,0.75,51852,54100,1399-12-24
355,پدرخش,درخشان‌ تهران‌,143,41321,5222974400,128970,126400,126400,-2570,-1.99,128700,-270,-0.21,126400,126400,1399-12-24
356,ضشنا2002,اختيارخ شپنا-12000-1400/02/27,141,1950,3794596000,2027,2380,1890,-137,-6.76,1946,-81,-4.0,1853,2380,1399-12-24
357,ضجار2002,اختيارخ وتجارت-2500-1400/02/22,140,4768,1862232000,378,430,367,-11,-2.91,391,13,3.44,367,450,1399-12-24
358,دارا,صندوق س. دارا الگوريتم-د,140,2190482,21962793576,10027,10039,10019,-8,-0.08,10026,-1,-0.01,10007,10039,1399-12-24
359,كارين,صندوق س نگين سامان-ثابت,135,5419256,54941771169,10132,10138,10141,9,0.09,10138,6,0.06,10137,10141,1399-12-24
360,سپاس,صندوق س. پاداش سهامداري توسعه1,135,2745205,27574068126,10039,10045,10045,6,0.06,10044,5,0.05,10044,10051,1399-12-24
361,افق ملت,صندوق س در سهام افق ملت,134,27039,3408483290,123270,127000,125000,1730,1.4,126060,2790,2.26,124500,127990,1399-12-24
362,تليسه,دامداري تليسه نمونه,131,505470,2221540650,4484,4395,4395,-89,-1.98,4480,-4,-0.09,4395,4395,1399-12-24
363,ارمغان,ص سرمايه گذاري ارمغان ايرانيان,130,1419589,14273423096,10045,10049,10056,11,0.11,10055,10,0.1,10049,10056,1399-12-24
364,چدن,توليدي چدن سازان,127,224600,5477994000,24880,24390,24390,-490,-1.97,24830,-50,-0.2,24390,24390,1399-12-24
365,قنيشا,قند  نيشابور,126,236167,13832301190,59760,58570,58570,-1190,-1.99,59420,-340,-0.57,58570,58570,1399-12-24
366,فردا,صندوق س آواي فرداي زاگرس-ثابت,125,3483415,35954660573,10317,10326,10325,8,0.08,10322,5,0.05,10321,10326,1399-12-24
367,تسه9802,امتياز تسهيلات مسكن ارديبهشت98,122,1686,977403966,595728,570015,568050,-27678,-4.65,579718,-16010,-2.69,566151,599887,1399-12-24
368,غزر,صنعتي زر ماكارون,121,116916,3026955240,26410,25890,25890,-520,-1.97,26380,-30,-0.11,25890,25890,1399-12-24
369,ثشاهد,سرمايه‌ گذاري‌ شاهد,121,178528,3336688320,19070,18690,18690,-380,-1.99,19040,-30,-0.16,18690,18690,1399-12-24
370,تسه9803,امتياز تسهيلات مسكن خرداد98,120,1186,699834334,607406,580000,577381,-30025,-4.94,590080,-17326,-2.85,577050,604945,1399-12-24
371,سشمال,سيمان‌ شمال‌,118,442529,5363451480,12360,12120,12120,-240,-1.94,12330,-30,-0.24,12120,12120,1399-12-24
372,دماوند,توليد نيروي برق دماوند,118,103754,4889926020,48091,47130,47130,-961,-2.0,48001,-90,-0.19,47130,47130,1399-12-24
373,دانا,بيمه دانا,117,1237105,8140150900,6710,6580,6580,-130,-1.94,6690,-20,-0.3,6580,6580,1399-12-24
374,كخاك,صنايع‌خاك‌چيني‌ايران‌,117,179636,7700517830,43720,42870,42850,-870,-1.99,43590,-130,-0.3,42850,43770,1399-12-24
375,دفرا,فرآورده‌هاي‌ تزريقي‌ ايران‌,115,184833,4766498050,26230,25710,25710,-520,-1.98,26190,-40,-0.15,25710,26230,1399-12-24
376,فروس,فروسيليس‌ ايران‌,113,1438037,6830675750,4840,4750,4750,-90,-1.86,4830,-10,-0.21,4750,4750,1399-12-24
377,كحافظ,كاشي‌ وسراميك‌ حافظ‌,112,258453,3098851470,12230,11990,11990,-240,-1.96,12210,-20,-0.16,11990,11990,1399-12-24
378,كبافق,معادن‌ بافق‌,111,287342,15266480460,54210,53130,53130,-1080,-1.99,53870,-340,-0.63,53130,53130,1399-12-24
379,اخزا901,اسنادخزانه-م1بودجه99-010621,110,78227,57726008124,742341,740000,728300,-14041,-1.89,737929,-4412,-0.59,728300,740002,1399-12-24
380,قجامح,ح.فرآورده غذايي وقندتربت‌جام,110,1487881,8954067858,6140,6018,6018,-122,-1.99,6018,-122,-1.99,6018,6018,1399-12-24
381,آبادا,توليد نيروي برق آبادان,109,423167,6279798280,15140,14840,14840,-300,-1.98,15100,-40,-0.26,14840,14840,1399-12-24
382,فلوله,لوله‌وماشين‌سازي‌ايران‌,108,279226,5752055600,21020,20600,20600,-420,-2.0,20970,-50,-0.24,20600,20600,1399-12-24
383,سكرد,سيمان كردستان,107,1704403,17333778510,10370,10170,10170,-200,-1.93,10300,-70,-0.68,10170,10170,1399-12-24
384,تسه9901,امتياز تسهيلات مسكن فروردين99,107,949,559653773,604619,576333,600000,-4619,-0.76,589730,-14889,-2.46,574389,600000,1399-12-24
385,اخزا908,اسنادخزانه-م8بودجه99-020606,104,356876,216179381657,605875,603551,604500,-1375,-0.23,605755,-120,-0.02,603510,606500,1399-12-24
386,گدنا,تهيه توزيع غذاي دنا آفرين فدك,102,154910,5189794820,34185,33502,33502,-683,-2.0,34113,-72,-0.21,33502,33502,1399-12-24
387,ضخود2008,اختيارخ خودرو-3500-1400/02/08,100,4040,217601000,53,84,50,-3,-5.66,54,1,1.89,48,84,1399-12-24
388,اراد84,مرابحه عام دولت84-ش.خ030624,100,20000000,20000000000000,1000000,1000000,1000000,0,0.0,1000000,0,0.0,1000000,1000000,1399-12-24
389,سكه0112پ03,سكه تمام بهارتحويلي1روزه سامان,97,25500,26621514600,1060556,1062000,1032000,-28556,-2.69,1043981,-16575,-1.56,1030000,1062000,1399-12-24
390,سبرق021,سلف موازي برق صادراتي گيلان021,93,89165000,14999871290000,168226,168226,168226,0,0.0,168226,0,0.0,168226,168226,1399-12-24
391,غالبر,لبنيات‌ كالبر,92,137261,2402067500,17850,17500,17500,-350,-1.96,17830,-20,-0.11,17500,17500,1399-12-24
392,فخاس,فولاد خراسان,92,719933,21130033550,29940,29350,29350,-590,-1.97,29810,-130,-0.43,29350,29350,1399-12-24
393,فلامي,لاميران‌,91,141662,6275626600,45200,44300,44300,-900,-1.99,45080,-120,-0.27,44300,44300,1399-12-24
394,خوساز,محورسازان‌ايران‌خودرو,90,1551026,12253105400,8060,7900,7900,-160,-1.99,8020,-40,-0.5,7900,7900,1399-12-24
395,فيروزا,صندوق بادرآمد ثابت فيروزه آسيا,88,516517,11434642430,22132,22040,22133,1,0.0,22138,6,0.03,22040,22200,1399-12-24
396,زكوثر,سرمايه گذاري كشاورزي كوثر,87,86966,1864551040,21870,21440,21440,-430,-1.97,21850,-20,-0.09,21440,21440,1399-12-24
397,وثوق,سرمايه گذاري وثوق امين,87,456487,10053213201,22940,22023,22023,-917,-4.0,22458,-482,-2.1,22023,22023,1399-12-24
398,تسه9812,امتياز تسهيلات مسكن اسفند98,86,704,408089323,594207,565000,564497,-29710,-5.0,579672,-14535,-2.45,564497,600000,1399-12-24
399,وپويا,سرمايه گذاري پويا,86,409484,2695223688,6716,6582,6582,-134,-2.0,6709,-7,-0.1,6582,6582,1399-12-24
400,زملارد,كشاورزي و دامپروري ملارد شير,86,95281,3403437320,36448,35720,35720,-728,-2.0,36397,-51,-0.14,35720,35720,1399-12-24
401,بمپنا,توليد برق عسلويه  مپنا,85,57854,4253042271,75009,73509,73509,-1500,-2.0,74877,-132,-0.18,73509,73560,1399-12-24
402,فزرين,زرين معدن آسيا,83,258676,7025640160,27714,27160,27160,-554,-2.0,27634,-80,-0.29,27160,27160,1399-12-24
403,ضشنا2003,اختيارخ شپنا-14000-1400/02/27,81,1416,1373300000,925,961,947,22,2.38,970,45,4.86,903,1100,1399-12-24
404,فنرژي,گسترش صنايع انرژي آذرآب,79,89008,1804192160,20683,20270,20270,-413,-2.0,20606,-77,-0.37,20270,20270,1399-12-24
405,ثتوسا,س.توسعه و عمران استان اردبيل,79,58463,2282220131,40663,39037,39037,-1626,-4.0,40469,-194,-0.48,39037,39037,1399-12-24
406,غصينو,صنعتي مينو,79,74175,4977068325,68468,67099,67099,-1369,-2.0,68398,-70,-0.1,67099,67099,1399-12-24
407,سمتاز,سيمان ممتازان كرمان,78,131288,2590049664,19154,19728,19728,574,3.0,19225,71,0.37,19728,19728,1399-12-24
408,اخزا905,اسنادخزانه-م5بودجه99-020218,78,402857,262351494526,651664,650000,649999,-1665,-0.26,651227,-437,-0.07,649250,656000,1399-12-24
409,تپمپي,پمپ‌ سازي‌ ايران‌,77,229944,4424122560,19630,19240,19240,-390,-1.99,19590,-40,-0.2,19240,19240,1399-12-24
410,قصفها,قنداصفهان‌,76,13016,2075271040,162690,159440,159440,-3250,-2.0,162550,-140,-0.09,159440,159440,1399-12-24
411,پرداخت,به پرداخت ملت,76,1357189,48207353280,36240,35520,35520,-720,-1.99,35530,-710,-1.96,35520,35520,1399-12-24
412,حفارس,حمل و نقل بين المللي خليج فارس,75,970901,4611779750,4840,4750,4750,-90,-1.86,4830,-10,-0.21,4750,4750,1399-12-24
413,اخزا815,اسنادخزانه-م15بودجه98-010406,73,92843,72089066163,776599,776598,775999,-600,-0.08,776462,-137,-0.02,767767,779500,1399-12-24
414,فالوم,آلومتك‌,73,574851,22274901399,39539,38749,38749,-790,-2.0,38749,-790,-2.0,38749,38749,1399-12-24
415,لپارس,پارس‌ الكتريك‌,73,54767,5213818400,97140,95200,95200,-1940,-2.0,96930,-210,-0.22,95200,95200,1399-12-24
416,فافزا,فولاد افزا سپاهان,71,126776,6775923648,54538,53448,53448,-1090,-2.0,54170,-368,-0.67,53448,53448,1399-12-24
417,تسه9809,امتياز تسهيلات مسكن آذر98,71,692,400139583,592152,562545,562545,-29607,-5.0,578236,-13916,-2.35,562545,621759,1399-12-24
418,لخانهح,ح.لوازم‌ خانگي‌ پارس‌,69,264059,5123800836,19799,19404,19404,-395,-2.0,19404,-395,-2.0,19404,19404,1399-12-24
419,كوثر,بيمه كوثر,68,203565,2937239385,14723,14429,14429,-294,-2.0,14705,-18,-0.12,14429,14429,1399-12-24
420,ثفارس,عمران‌وتوسعه‌فارس‌,68,297806,2986994180,10230,10030,10030,-200,-1.96,10220,-10,-0.1,10030,10030,1399-12-24
421,حكشتيح,ح . كشتيراني ج. ا. ا,67,420325,6409417380,15470,15460,15200,-270,-1.75,15250,-220,-1.42,15200,15460,1399-12-24
422,اخزا904,اسنادخزانه-م4بودجه99-011215,65,381412,259301286979,670002,671974,679000,8998,1.34,679846,9844,1.47,670003,682000,1399-12-24
423,اخزا821,اسنادخزانه-م21بودجه98-020906,65,36057,21069346329,583122,585897,586200,3078,0.53,584334,1212,0.21,581025,586200,1399-12-24
424,سيمرغ,سيمرغ,65,629701,10056324970,16290,15970,15970,-320,-1.96,16220,-70,-0.43,15970,15970,1399-12-24
425,صايند,صندوق س. گنجينه آينده روشن-د,64,398570,3943465630,9915,9910,9901,-14,-0.14,9894,-21,-0.21,9871,9913,1399-12-24
426,كفرآور,فرآورده هاي سيمان شرق,64,247595,5897217710,24304,23818,23818,-486,-2.0,24155,-149,-0.61,23818,23818,1399-12-24
427,كماسه,تامين‌ ماسه‌ ريخته‌گري‌,62,22699,990357370,44520,43630,43630,-890,-2.0,44500,-20,-0.04,43630,43630,1399-12-24
428,تسه9811,امتياز تسهيلات مسكن بهمن98,62,391,226726018,602671,572538,596000,-6671,-1.11,579862,-22809,-3.78,572538,596000,1399-12-24
429,كهرام,توليدي گرانيت بهسرام,61,79365,9208562220,112649,116028,116028,3379,3.0,114127,1478,1.31,116028,116028,1399-12-24
430,صنوين,صندوق سرمايه‌گذاري صنوين-مختلط,61,14353,1500522800,103550,103550,105500,1950,1.88,104540,990,0.96,103550,105900,1399-12-24
431,لكما,كارخانجات‌مخابراتي‌ايران‌,60,317541,1981138299,6366,6239,6239,-127,-1.99,6353,-13,-0.2,6239,6239,1399-12-24
432,ثروتم,صندوق س. ثروت آفرين پارسيان-س,60,235850,17825185450,74886,76350,75300,414,0.55,75578,692,0.92,75100,76350,1399-12-24
433,وگستر,گسترش سرمايه گذاري ايرانيان,60,97787,1857855213,19386,18999,18999,-387,-2.0,19371,-15,-0.08,18999,18999,1399-12-24
434,تسه9808,امتياز تسهيلات مسكن آبان98,60,859,503375659,594948,565204,565201,-29747,-5.0,586002,-8946,-1.5,565201,624600,1399-12-24
435,نيرو,نيرو سرمايه,59,60271,3218956964,54484,53395,53395,-1089,-2.0,54300,-184,-0.34,53395,54540,1399-12-24
436,ولبهمن,شركت بهمن ليزينگ,59,1196726,9979498114,8509,8339,8339,-170,-2.0,8474,-35,-0.41,8339,8339,1399-12-24
437,اوصتا,صندوق انديشه ورزان صباتامين -د,58,4270715,77300017558,18088,18095,18115,27,0.15,18100,12,0.07,18095,18115,1399-12-24
438,تكنو,تكنوتار,58,253833,5777239080,23220,22760,22760,-460,-1.98,23170,-50,-0.22,22760,22760,1399-12-24
439,سخاش,سيمان‌خاش‌,57,20605,3190478200,158000,154840,154840,-3160,-2.0,157790,-210,-0.13,154840,154840,1399-12-24
440,ضخود2009,اختيارخ خودرو-4000-1400/02/08,57,3263,87158000,27,29,24,-3,-11.11,27,0,0.0,22,30,1399-12-24
441,نطرين,عطرين نخ قم,57,178196,2086140572,11945,11707,11707,-238,-1.99,11935,-10,-0.08,11707,11707,1399-12-24
442,كاذر,فرآورده‌هاي‌نسوزآذر,55,721730,23918132200,33810,33140,33140,-670,-1.98,33480,-330,-0.98,33140,33140,1399-12-24
443,بهپاك,صنعتي بهپاك,55,213541,9677891661,46245,45321,45321,-924,-2.0,46062,-183,-0.4,45321,45321,1399-12-24
444,كسرا,سراميك‌هاي‌صنعتي‌اردكان‌,55,222678,4803164460,22010,21570,21570,-440,-2.0,21970,-40,-0.18,21570,21570,1399-12-24
445,فرآور,فرآوري‌موادمعدني‌ايران‌,55,42507,1533227490,36800,36070,36070,-730,-1.98,36780,-20,-0.05,36070,36070,1399-12-24
446,خاتم,صندوق س خاتم ايساتيس پويا-ثابت,53,934483,9990983664,10687,10690,10695,8,0.07,10691,4,0.04,10690,10695,1399-12-24
447,غويتا,ويتانا,53,116537,2098015611,18370,18003,18003,-367,-2.0,18354,-16,-0.09,18003,18003,1399-12-24
448,اخزا816,اسنادخزانه-م16بودجه98-010503,53,93938,71959956100,765565,752503,769400,3835,0.5,766037,472,0.06,752503,770800,1399-12-24
449,كفپارس,فرآورده‌هاي‌ نسوز پارس‌,52,318255,1483068300,4750,4660,4660,-90,-1.89,4750,0,0.0,4660,4660,1399-12-24
450,ضخود2013,اختيارخ خودرو-7000-1400/02/08,52,2399,20911000,6,10,8,2,33.33,9,3,50.0,7,10,1399-12-24
451,سقاين,سيمان‌ قائن‌,52,216261,16042240980,75690,74180,74180,-1510,-1.99,75190,-500,-0.66,74180,74180,1399-12-24
452,واتي,سرمايه‌ گذاري‌ آتيه‌ دماوند,51,863736,10313007840,12180,11940,11940,-240,-1.97,12130,-50,-0.41,11940,11940,1399-12-24
453,فاذر,صنايع‌ آذرآب‌,50,84358,2038089280,24650,24160,24160,-490,-1.99,24630,-20,-0.08,24160,24160,1399-12-24
454,ملت,بيمه ملت,50,79606,1311906880,16810,16480,16480,-330,-1.96,16800,-10,-0.06,16480,16480,1399-12-24
455,كيان2,صندوق س. با درآمد ثابت كيان,50,5000000,5000000,27535,1,1,-27534,-100.0,1,-27534,-100.0,1,1,1399-12-24
456,ريشمك,توليد و صادرات ريشمك,49,72670,3777967960,53048,51988,51988,-1060,-2.0,52966,-82,-0.15,51988,51988,1399-12-24
457,كوير,توليدي فولاد سپيد فراب كوير,49,68981,1536896680,22730,22280,22280,-450,-1.98,22720,-10,-0.04,22280,22280,1399-12-24
458,خمهر,مهركام‌پارس‌,48,469697,1160151590,2520,2470,2470,-50,-1.98,2520,0,0.0,2470,2470,1399-12-24
459,ودي,بيمه  دي,47,139522,3214168314,23507,23037,23037,-470,-2.0,23476,-31,-0.13,23037,23037,1399-12-24
460,كسعدي,كاشي‌ سعدي‌,47,292356,6233029920,21750,21320,21320,-430,-1.98,21700,-50,-0.23,21320,21320,1399-12-24
461,سكه0011پ02,سكه تمام بهارتحويلي 1روزه ملت,47,8400,8838012300,1060362,1065998,1040000,-20362,-1.92,1052144,-8218,-0.78,1035000,1065998,1399-12-24
462,خرينگ,رينگ‌سازي‌مشهد,47,37292,1684479640,46090,45170,45170,-920,-2.0,46060,-30,-0.07,45170,45170,1399-12-24
463,ضشنا2001,اختيارخ شپنا-10000-1400/02/27,46,376,1339076000,3717,3900,3353,-364,-9.79,3561,-156,-4.2,3353,3900,1399-12-24
464,خاذين,سايپاآذين‌,46,234336,1103722560,4800,4710,4710,-90,-1.88,4800,0,0.0,4710,4710,1399-12-24
465,ثشرق,سرمايه گذاري مسكن شمال شرق,45,1509494,10324938960,6970,6840,6840,-130,-1.87,6940,-30,-0.43,6840,6840,1399-12-24
466,سپر,صندوق س سپر سرمايه بيدار- ثابت,44,257435,2925765641,11363,11365,11365,2,0.02,11365,2,0.02,11365,11367,1399-12-24
467,قثابت,قند ثابت‌ خراسان‌,43,41456,2819837120,69400,68020,68020,-1380,-1.99,69320,-80,-0.12,68020,68020,1399-12-24
468,غچين,كشت‌ و صنعت‌ چين‌ چين,43,164942,3310385940,20470,20070,20070,-400,-1.95,20440,-30,-0.15,20070,20070,1399-12-24
469,اخزا813,اسنادخزانه-م13بودجه98-010219,43,61237,48973669717,798001,795000,800000,1999,0.25,799740,1739,0.22,795000,803500,1399-12-24
470,زعف0008پ05,زعفران0008نگين زرين(پ),42,64680,7624479968,117810,115300,117450,-360,-0.31,117880,70,0.06,115300,119000,1399-12-24
471,وسنا,سرمايه گذاري نيروگاهي ايران,41,128805,1935166320,15330,15024,15024,-306,-2.0,15302,-28,-0.18,15024,15024,1399-12-24
472,الماس,صندوق س.امين تدبيرگران فردا-س,41,7425,809936812,109030,109411,109150,120,0.11,109082,52,0.05,109000,109489,1399-12-24
473,كمنگنز,معادن‌منگنزايران‌,41,22849,1978266420,88340,86580,86580,-1760,-1.99,88270,-70,-0.08,86580,86580,1399-12-24
474,اخزا808,اسنادخزانه-م8بودجه98-000817,40,23249,20478112525,878196,877917,878000,-196,-0.02,880817,2621,0.3,877916,882999,1399-12-24
475,فنورد,نوردوقطعات‌ فولادي‌,40,3982,770078980,197330,193390,193390,-3940,-2.0,197270,-60,-0.03,193390,193390,1399-12-24
476,ركيش,كارت اعتباري ايران كيش,40,288702,7347465900,25960,25450,25450,-510,-1.96,25880,-80,-0.31,25450,25450,1399-12-24
477,ضمخا7071,اختيارخ اخابر-24000-1400/07/28,40,1510,318610000,211,211,211,0,0.0,211,0,0.0,211,211,1399-12-24
478,تسه9806,امتياز تسهيلات مسكن شهريور98,40,409,238339629,595224,565463,565463,-29761,-5.0,582737,-12487,-2.1,565463,598000,1399-12-24
479,غمينو,شركت صنايع غذايي مينو شرق,40,72284,862709540,12178,11935,11935,-243,-2.0,12174,-4,-0.03,11935,11935,1399-12-24
480,درازك,دارويي‌ رازك‌,39,161486,5563192700,35150,34450,34450,-700,-1.99,35070,-80,-0.23,34450,34450,1399-12-24
481,دسينا,داروسازي‌ سينا,39,611752,15783201600,26320,25800,25800,-520,-1.98,26150,-170,-0.65,25800,25800,1399-12-24
482,ساوه,سيمان ساوه,39,9073,546929513,61511,60281,60281,-1230,-2.0,61497,-14,-0.02,60281,60281,1399-12-24
483,اخزا817,اسنادخزانه-م17بودجه98-010512,39,106957,81364552332,761828,759000,760000,-1828,-0.24,760722,-1106,-0.15,759000,762000,1399-12-24
484,داريك,صندوق س.اعتماد داريك-د,39,49800,516264400,10343,10459,10343,0,0.0,10367,24,0.23,10343,10459,1399-12-24
485,اخزا814,اسنادخزانه-م14بودجه98-010318,38,87547,68710149859,784921,784000,784921,0,0.0,784837,-84,-0.01,780050,788000,1399-12-24
486,دابور,داروسازي‌ ابوريحان‌,38,210482,8255104040,40020,39220,39220,-800,-2.0,39880,-140,-0.35,39220,39220,1399-12-24
487,غمهراح,ح . توليدي‌مهرام‌,38,378384,43514160000,69250,115000,115000,45750,66.06,115000,45750,66.06,115000,115000,1399-12-24
488,اراد40,مرابحه عام دولت4-ش.خ 0207,38,930000,930000000000,999999,1000000,1000000,1,0.0,1000000,1,0.0,1000000,1000000,1399-12-24
489,اخزا907,اسنادخزانه-م7بودجه99-020704,38,111464,66839313010,599995,596000,600000,5,0.0,599649,-346,-0.06,596000,600001,1399-12-24
490,بزاگرس,نيروگاه زاگرس كوثر,38,70944,504553728,7257,7112,7112,-145,-2.0,7256,-1,-0.01,7112,7112,1399-12-24
491,فاما,صنعتي‌ آما,38,62188,1243760000,20400,20000,20000,-400,-1.96,20390,-10,-0.05,20000,20000,1399-12-24
492,سرود,سيمان‌شاهرود,38,397353,7788118800,20000,19600,19600,-400,-2.0,19940,-60,-0.3,19600,19600,1399-12-24
493,دتوليد,داروسازي توليد دارو,38,22737,620356308,27840,27284,27284,-556,-2.0,27833,-7,-0.03,27284,27284,1399-12-24
494,وتوصا,گروه س توسعه صنعتي ايران,38,98274,1177322520,12220,11980,11980,-240,-1.96,12210,-10,-0.08,11980,11980,1399-12-24
495,وبيمه,سرمايه‌ گذاري‌ صنعت‌ بيمه‌,37,192990,546161700,2880,2830,2830,-50,-1.74,2880,0,0.0,2830,2830,1399-12-24
496,حبندر,دريايي و کشتيراني خط دريابندر,37,127590,4394199600,35874,34440,34440,-1434,-4.0,35546,-328,-0.91,34440,34440,1399-12-24
497,اخزا811,اسنادخزانه-م11بودجه98-001013,37,73146,62609764697,853241,855000,853238,-3,0.0,855956,2715,0.32,853238,857000,1399-12-24
498,سصفها,سيمان‌اصفهان‌,36,16606,2090861460,128470,125910,125910,-2560,-1.99,128360,-110,-0.09,125910,125910,1399-12-24
499,ومعلم,بيمه معلم,35,371965,1744515850,4785,4690,4690,-95,-1.99,4782,-3,-0.06,4690,4690,1399-12-24
500,زعف0008پ16,زعفران0008نگين بيرجند(پ),35,15014,1770227509,117508,119000,117996,488,0.42,117905,397,0.34,117110,119000,1399-12-24
501,اپرداز,آتيه داده پرداز,35,106136,2195847704,21111,20689,20689,-422,-2.0,21092,-19,-0.09,20689,20689,1399-12-24
502,دمعيار,صندوق س. توازن معيار-د,35,908169,9185333695,10108,10119,10110,2,0.02,10114,6,0.06,10110,10119,1399-12-24
503,ديران,ايران‌دارو,34,225433,6330158640,28650,28080,28080,-570,-1.99,28580,-70,-0.24,28080,28080,1399-12-24
504,ضملت3001,اختيارخ وبملت-3500-1400/03/19,34,490,457969000,854,1019,880,26,3.04,935,81,9.48,860,1050,1399-12-24
505,غبهنوش,بهنوش‌ ايران‌,34,11965,866026700,73850,72380,72380,-1470,-1.99,73820,-30,-0.04,72380,72380,1399-12-24
506,تسه9807,امتياز تسهيلات مسكن مهر98,34,509,296384377,593160,563502,600000,6840,1.15,582288,-10872,-1.83,563502,600000,1399-12-24
507,تكمبا,كمباين‌ سازي‌ ايران‌,34,415039,3145995620,7730,7580,7580,-150,-1.94,7720,-10,-0.13,7580,7580,1399-12-24
508,ميهن,بيمه ميهن,34,177743,859031919,4931,4833,4833,-98,-1.99,4929,-2,-0.04,4833,4833,1399-12-24
509,سدشت,صنايع سيمان دشتستان,33,22919,1363680500,56140,59500,59500,3360,5.99,56220,80,0.14,59500,59500,1399-12-24
510,شپلي,پلي اكريل ايران,33,117615,1203907140,10444,10236,10236,-208,-1.99,10427,-17,-0.16,10236,10236,1399-12-24
511,شگل,گلتاش‌,33,78897,826840560,10690,10480,10480,-210,-1.96,10690,0,0.0,10480,10480,1399-12-24
512,لابسا,آبسال‌,33,17790,864594000,49590,48600,48600,-990,-2.0,49570,-20,-0.04,48600,48600,1399-12-24
513,اخزا818,اسنادخزانه-م18بودجه98-010614,32,141200,105709218231,746377,745500,742010,-4367,-0.59,748649,2272,0.3,742010,749000,1399-12-24
514,دامين,داروسازي‌ امين‌,32,86017,1176712560,13950,13680,13680,-270,-1.94,13940,-10,-0.07,13680,13680,1399-12-24
515,سمايه,بانك سرمايه,32,632263,4191271427,6764,6629,6629,-135,-2.0,6734,-30,-0.44,6629,6629,1399-12-24
516,زماهان,مجتمع توليد گوشت مرغ ماهان,32,76464,1560094992,20819,20403,20403,-416,-2.0,20806,-13,-0.06,20403,20403,1399-12-24
517,زگلدشت,كشت و دام گلدشت نمونه اصفهان,31,13238,577242990,44494,43605,43605,-889,-2.0,44484,-10,-0.02,43605,43605,1399-12-24
518,اخزا809,اسنادخزانه-م9بودجه98-000923,31,43248,37382490499,863854,864292,864292,438,0.05,864375,521,0.06,864292,865990,1399-12-24
519,دشيري,شيرين دارو,31,2233,472152219,220253,211443,211443,-8810,-4.0,220036,-217,-0.1,211443,211443,1399-12-24
520,چفيبر,فيبر ايران‌,31,39087,535491900,13970,13700,13700,-270,-1.93,13970,0,0.0,13700,13700,1399-12-24
521,ختور,رادياتور ايران‌,30,48109,1124307330,23840,23370,23370,-470,-1.97,23830,-10,-0.04,23370,23370,1399-12-24
522,بنيرو,نيروترانس‌,30,27313,413245690,15430,15130,15130,-300,-1.94,15430,0,0.0,15130,15130,1399-12-24
523,اخزا906,اسنادخزانه-م6بودجه99-020321,30,35276,23474097770,663132,640342,665441,2309,0.35,665441,2309,0.35,629977,696000,1399-12-24
524,قيستو,شركت قند بيستون,30,1112901,17367933006,15300,15606,15606,306,2.0,15369,69,0.45,15606,15606,1399-12-24
525,وآذر,سرمايه‌گذاري‌توسعه‌آذربايجان‌,30,11268,950343120,86060,84340,84340,-1720,-2.0,86030,-30,-0.03,84340,84340,1399-12-24
526,غگرجي,بيسكويت‌  گرجي‌,30,110535,2058161700,19000,18620,18620,-380,-2.0,18980,-20,-0.11,18620,18620,1399-12-24
527,كساپا,سايپاشيشه‌,29,105672,4083166080,39420,38640,38640,-780,-1.98,39350,-70,-0.18,38640,38640,1399-12-24
528,توريل,توکاريل,29,42994,1090456822,25880,25363,25363,-517,-2.0,25868,-12,-0.05,25363,25363,1399-12-24
529,كسرام,پارس‌ سرام‌,29,250708,2068341000,8410,8250,8250,-160,-1.9,8400,-10,-0.12,8250,8250,1399-12-24
530,تسه9804,امتياز تسهيلات مسكن تير98,29,600,375505748,626430,596002,596502,-29928,-4.78,625843,-587,-0.09,595150,657700,1399-12-24
531,آسام,صندوق س.آرمان سپهر آشنا-م,28,12600,1299933320,102468,102500,103020,552,0.54,103169,701,0.68,101005,103500,1399-12-24
532,ضشنا2000,اختيارخ شپنا-9000-1400/02/27,28,100,421618000,4518,4000,4180,-338,-7.48,4216,-302,-6.68,4000,4350,1399-12-24
533,حتوكا,حمل‌ونقل‌توكا,27,36941,1119312300,30910,30300,30300,-610,-1.97,30900,-10,-0.03,30300,30300,1399-12-24
534,دشيمي,شيمي‌ داروئي‌ داروپخش‌,26,37368,1152055440,31450,30830,30830,-620,-1.97,31440,-10,-0.03,30830,30830,1399-12-24
535,شسينا,صنايع‌شيميايي‌سينا,26,3751,503609260,137000,134260,134260,-2740,-2.0,136970,-30,-0.02,134260,134260,1399-12-24
536,دسانكو,داروسازي سبحان انكولوژي,26,142940,2145529400,15316,15010,15010,-306,-2.0,15303,-13,-0.08,15010,15010,1399-12-24
537,اخزا806,اسنادخزانه-م6بودجه98-000519,25,108525,100333669390,922197,922252,916917,-5280,-0.57,924521,2324,0.25,916917,925000,1399-12-24
538,قشكر,شكرشاهرود,25,76953,295499520,3910,3840,3840,-70,-1.79,3910,0,0.0,3840,3840,1399-12-24
539,اخزا820,اسنادخزانه-م20بودجه98-020806,25,12770,7533945019,592597,578374,591100,-1497,-0.25,589972,-2625,-0.44,578374,592000,1399-12-24
540,ساروم,سيمان‌اروميه‌,25,23338,976695300,42700,41850,41850,-850,-1.99,42680,-20,-0.05,41850,41850,1399-12-24
541,غدام,خوراك‌  دام‌ پارس‌,25,7909,3117174170,402170,394130,394130,-8040,-2.0,401660,-510,-0.13,394130,394130,1399-12-24
542,اخزا812,اسنادخزانه-م12بودجه98-001111,25,136264,114860157850,842686,842790,845950,3264,0.39,842924,238,0.03,842000,845950,1399-12-24
543,وايران,ليزينگ ايرانيان,24,172499,2142437580,12670,12420,12420,-250,-1.97,12660,-10,-0.08,12420,12420,1399-12-24
544,خلنت,لنت‌ ترمزايران‌,24,29352,2699796960,93850,91980,91980,-1870,-1.99,93750,-100,-0.11,91980,91980,1399-12-24
545,زشريف,كشت وصنعت شريف آباد,24,74834,377238194,5143,5041,5041,-102,-1.98,5142,-1,-0.02,5041,5041,1399-12-24
546,كفرا,فراورده‌ هاي‌ نسوزايران‌,24,16152,754136880,47640,46690,46690,-950,-1.99,47630,-10,-0.02,46690,46690,1399-12-24
547,كترام,توليدي‌ كاشي‌ تكسرام‌,23,27749,1331952000,48970,48000,48000,-970,-1.98,48940,-30,-0.06,48000,48000,1399-12-24
548,ضمخا7075,اختيارخ اخابر-9000-1400/07/28,23,282,713775000,3000,2800,2400,-600,-20.0,2531,-469,-15.63,2400,3000,1399-12-24
549,شدوص,دوده‌ صنعتي‌ پارس‌,23,287567,8279053930,29370,28790,28790,-580,-1.97,29270,-100,-0.34,28790,28790,1399-12-24
550,لپيام,گسترش صنايع پيام,23,12854,683781384,55412,53196,53196,-2216,-4.0,55333,-79,-0.14,53196,53196,1399-12-24
551,آپ,آسان پرداخت پرشين,23,72367,1293198290,18230,17870,17870,-360,-1.97,18220,-10,-0.05,17870,17870,1399-12-24
552,غگلستا,شير پاستوريزه پگاه گلستان,23,232867,6556836119,28731,28157,28157,-574,-2.0,28653,-78,-0.27,28157,28157,1399-12-24
553,لخزر,پارس‌ خزر,23,4884,898362960,187690,183940,183940,-3750,-2.0,187620,-70,-0.04,183940,183940,1399-12-24
554,دبالك,مواد اوليه دارويي البرز بالك,23,89018,1888071780,21642,21210,21210,-432,-2.0,21625,-17,-0.08,21210,21210,1399-12-24
555,غبهار,كشت وصنعت بهاران گلبهار خراسان,22,18054,596738862,34430,33053,33053,-1377,-4.0,34387,-43,-0.12,33053,33053,1399-12-24
556,ثنور,سرمايه گذاري كوه نور,22,167664,1635729984,9955,9756,9756,-199,-2.0,9938,-17,-0.17,9756,9756,1399-12-24
557,خموتور,موتورسازان‌تراكتورسازي‌ايران‌,22,71606,1061200920,15120,14820,14820,-300,-1.98,15110,-10,-0.07,14820,14820,1399-12-24
558,گنجين,صندوق س. گنجينه يكم آويد-د,22,91158,1131665289,12411,12411,12412,1,0.01,12414,3,0.02,12411,12420,1399-12-24
559,قاسم,قاسم ايران,22,211564,2837496368,13685,13412,13412,-273,-1.99,13669,-16,-0.12,13412,13412,1399-12-24
560,غاذر,كشت‌وصنعت‌پياذر,22,26412,1456357680,56260,55140,55140,-1120,-1.99,56230,-30,-0.05,55140,55140,1399-12-24
561,دجابر,داروسازي‌ جابرابن‌حيان‌,22,45077,897032300,20300,19900,19900,-400,-1.97,20290,-10,-0.05,19900,19900,1399-12-24
562,ثنوسا,نوسازي‌وساختمان‌تهران‌,22,449288,5854222640,13290,13030,13030,-260,-1.96,13260,-30,-0.23,13030,13030,1399-12-24
563,خزر,فنرسازي‌زر,21,20660,967714400,47790,46840,46840,-950,-1.99,47770,-20,-0.04,46840,46840,1399-12-24
564,دلقما,دارويي‌ لقمان‌,21,28400,691540000,24840,24350,24350,-490,-1.97,24830,-10,-0.04,24350,24350,1399-12-24
565,وتعاون,بيمه  تعاون,21,52036,313673008,6151,6028,6028,-123,-2.0,6149,-2,-0.03,6028,6028,1399-12-24
566,بايكا,كارخانجات كابلسازي ‌ايران‌,21,12061,495369392,42783,41072,41072,-1711,-4.0,42739,-44,-0.1,41072,41072,1399-12-24
567,ثنظام,س. ساختماني نظام مهندسي ايران,21,31482,1451918358,48040,46119,46119,-1921,-4.0,47895,-145,-0.3,46119,46119,1399-12-24
568,داوه,داروسازي آوه سينا,21,150438,2985141234,20247,19843,19843,-404,-2.0,20222,-25,-0.12,19843,19843,1399-12-24
569,تسه9805,امتياز تسهيلات مسكن مرداد98,21,198,112827463,592408,562789,566002,-26406,-4.46,569836,-22572,-3.81,562789,589999,1399-12-24
570,ثغرب,شركت سرمايه گذاري مسكن شمالغرب,21,507267,3984075018,8014,7854,7854,-160,-2.0,8001,-13,-0.16,7854,7854,1399-12-24
571,خنصير,مهندسي‌نصيرماشين‌,21,6329,683025680,110120,107920,107920,-2200,-2.0,110090,-30,-0.03,107920,107920,1399-12-24
572,قلرست,قند لرستان‌,21,96840,3413610000,35960,35250,35250,-710,-1.97,35910,-50,-0.14,35250,35250,1399-12-24
573,زعف0008پ20,زعفران0008نگين وحدت جام(پ),21,11200,1321814320,117501,118093,117980,479,0.41,118019,518,0.44,117500,118900,1399-12-24
574,غمارگ,مارگارين‌,21,14014,448588140,32660,32010,32010,-650,-1.99,32650,-10,-0.03,32010,32010,1399-12-24
575,قشير,قند شيروان قوچان و بجنورد,21,19906,505612400,25918,25400,25400,-518,-2.0,25913,-5,-0.02,25400,25400,1399-12-24
576,زقيام,كشت و دام قيام اصفهان,21,38126,1141339936,30546,29936,29936,-610,-2.0,30532,-14,-0.05,29936,29936,1399-12-24
577,ضجار2003,اختيارخ وتجارت-3000-1400/02/22,20,806,158202000,199,200,192,-7,-3.52,196,-3,-1.51,162,228,1399-12-24
578,ثالوند,سرمايه گذاري مسكن الوند,20,11464,380157704,33837,33161,33161,-676,-2.0,33832,-5,-0.01,33161,33161,1399-12-24
579,فسا,پتروشيمي فسا,20,155183,280881230,1846,1810,1810,-36,-1.95,1845,-1,-0.05,1810,1810,1399-12-24
580,حآسا,آسيا سير ارس,20,28752,1300912992,46169,45246,45246,-923,-2.0,46144,-25,-0.05,45246,45246,1399-12-24
581,بذر,صندوق س بذر اميد آفرين-سهام,20,2916,286900870,98030,98300,98000,-30,-0.03,98390,360,0.37,97900,99900,1399-12-24
582,كيا,كيا الكترود شرق,19,704632,5794893568,7833,8224,8224,391,4.99,8224,391,4.99,8224,8224,1399-12-24
583,زفكا,كشت و دامداري فكا,19,18838,245628682,13305,13039,13039,-266,-2.0,13304,-1,-0.01,13039,13039,1399-12-24
584,پاسا,ايران‌ياساتايرورابر,19,19006,501378280,26910,26380,26380,-530,-1.97,26900,-10,-0.04,26380,26380,1399-12-24
585,فپنتا,سپنتا,19,4117,1662691620,412100,403860,403860,-8240,-2.0,411820,-280,-0.07,403860,403860,1399-12-24
586,زنگان,صنعت روي زنگان,19,5287,546707522,105516,103406,103406,-2110,-2.0,105492,-24,-0.02,103406,103406,1399-12-24
587,ثپرديس,سرمايه گذاري مسكن پرديس,19,559840,5632550240,10266,10061,10061,-205,-2.0,10242,-24,-0.23,10061,10061,1399-12-24
588,كي بي سي,شركت كي بي سي,18,32655,898894185,28088,27527,27527,-561,-2.0,28078,-10,-0.04,27527,27527,1399-12-24
589,كاسپينح,ح .داروسازي كاسپين تامين,18,186825,3717888500,20042,20042,19900,-142,-0.71,19900,-142,-0.71,19900,20042,1399-12-24
590,دكوثر,داروسازي‌ كوثر,18,73372,1508528320,20970,20560,20560,-410,-1.96,20960,-10,-0.05,20560,20560,1399-12-24
591,ضترا3002,اختيارخ شتران-8000-1400/03/09,18,326,548850000,1861,1900,1500,-361,-19.4,1684,-177,-9.51,1500,1900,1399-12-24
592,گكيش,توريستي ورفاهي آبادگران كيش,18,16416,836329536,53068,50946,50946,-2122,-4.0,52976,-92,-0.17,50946,50946,1399-12-24
593,اشاد10,مشاركت دولتي10-شرايط خاص001226,18,15300,14479261600,945359,956000,945100,-259,-0.03,946357,998,0.11,945100,956000,1399-12-24
594,غشان,شيرپاستوريزه‌پگاه‌خراسان‌,17,35953,279714340,7930,7780,7780,-150,-1.89,7930,0,0.0,7780,7780,1399-12-24
595,زمگسا,كشاورزي‌ ودامپروي‌ مگسال‌,17,14425,463475250,32780,32130,32130,-650,-1.98,32770,-10,-0.03,32130,32130,1399-12-24
596,خكار,ايركا پارت صنعت,17,32992,711967360,22020,21580,21580,-440,-2.0,22010,-10,-0.05,21580,21580,1399-12-24
597,كتوكا,توليدي و خدمات صنايع نسوز توكا,16,21295,820751890,39328,38542,38542,-786,-2.0,39315,-13,-0.03,38542,38542,1399-12-24
598,اخزا721,اسنادخزانه-م21بودجه97-000728,16,17426,15507831070,886212,890950,889900,3688,0.42,889925,3713,0.42,886011,891000,1399-12-24
599,بكاب,صنايع‌جوشكاب‌يزد,16,2602,924178360,362420,355180,355180,-7240,-2.0,362280,-140,-0.04,355180,355180,1399-12-24
600,ولصنم,ليزينگ‌صنعت‌ومعدن‌,16,273128,2988020320,11160,10940,10940,-220,-1.97,11150,-10,-0.09,10940,10940,1399-12-24
601,غديس,پاكديس,16,33587,445531555,13535,13265,13265,-270,-1.99,13533,-2,-0.01,13265,13265,1399-12-24
602,رتكو,كنترل‌خوردگي‌تكين‌كو,16,338786,6301419600,18970,18600,18600,-370,-1.95,18920,-50,-0.26,18600,18600,1399-12-24
603,ولملت,واسپاري ملت,16,17247,139700700,8260,8100,8100,-160,-1.94,8260,0,0.0,8100,8100,1399-12-24
604,داسوه,داروسازي‌ اسوه‌,16,10281,377415510,37450,36710,36710,-740,-1.98,37440,-10,-0.03,36710,36710,1399-12-24
605,درهآور,دارويي ره آورد تامين,16,66357,3476443230,53459,52390,52390,-1069,-2.0,53383,-76,-0.14,52390,52390,1399-12-24
606,سبهان,سيمان‌ بهبهان‌,16,5566,792041800,145200,142300,142300,-2900,-2.0,145150,-50,-0.03,142300,142300,1399-12-24
607,سدور,سيمان‌ دورود,16,284943,5459507880,19550,19160,19160,-390,-1.99,19510,-40,-0.2,19160,19160,1399-12-24
608,كاسپين,داروسازي كاسپين تامين,16,23247,569342277,24990,24491,24491,-499,-2.0,24984,-6,-0.02,24491,24491,1399-12-24
609,زعف0008پ10,زعفران0008نگين طلاي سرخ(پ),16,4161,497086600,118041,120000,119400,1359,1.15,119463,1422,1.2,118800,120000,1399-12-24
610,كساوه,صنايع‌ كاشي‌ و سراميك‌ سينا,15,5971,428956640,73300,71840,71840,-1460,-1.99,73290,-10,-0.01,71840,71840,1399-12-24
611,خچرخش,چرخشگر,15,22401,406130130,18490,18130,18130,-360,-1.95,18490,0,0.0,18130,18130,1399-12-24
612,سفارود,كارخانه فارسيت درود,15,14600,264946200,18517,18147,18147,-370,-2.0,18507,-10,-0.05,18147,18147,1399-12-24
613,غشصفا,شيرپاستوريزه‌پگاه‌اصفهان‌,15,14640,408602400,28470,27910,27910,-560,-1.97,28470,0,0.0,27910,27910,1399-12-24
614,سخند,صندوق س.سپهرخبرگان نفت-د,15,101720,1022131260,10043,10050,10050,7,0.07,10048,5,0.05,10044,10050,1399-12-24
615,ضصاد3002,اختيارخ وبصادر-2500-1400/03/12,15,347,127347000,310,300,370,60,19.35,367,57,18.39,300,370,1399-12-24
616,ضملت3004,اختيارخ وبملت-5000-1400/03/19,15,383,113910000,245,250,201,-44,-17.96,297,52,21.22,201,350,1399-12-24
617,سخزر,سيمان‌ خزر,14,17905,541805300,30870,30260,30260,-610,-1.98,30860,-10,-0.03,30260,30260,1399-12-24
618,دتوزيع,توزيع دارو پخش,14,10493,486896186,47348,46402,46402,-946,-2.0,47339,-9,-0.02,46402,46402,1399-12-24
619,ضچاد2004,اختيارخ كچاد-20000-1400/02/05,14,106,369200000,2500,3150,3700,1200,48.0,3483,983,39.32,3100,4000,1399-12-24
620,هجرت,پخش هجرت,14,51628,1439543524,28452,27883,27883,-569,-2.0,28435,-17,-0.06,27883,27883,1399-12-24
621,وآوا,سرمايه گذاري آوا نوين,14,38970,340325010,8911,8733,8733,-178,-2.0,8910,-1,-0.01,8733,8733,1399-12-24
622,ولتجار,واسپاري تجارت وسرمايه ايرانيان,14,63372,553807908,8917,8739,8739,-178,-2.0,8912,-5,-0.06,8739,8739,1399-12-24
623,فماك,ماداكتو استيل كرد,13,535000,11235000000,22369,21000,21000,-1369,-6.12,21000,-1369,-6.12,21000,21000,1399-12-24
624,اعتلا,شركت سرمايه گذاري اعتلاء البرز,13,64539,534834693,8456,8287,8287,-169,-2.0,8454,-2,-0.02,8287,8287,1399-12-24
625,نمرينو,ايران‌ مرينوس‌,13,11200,928928000,84630,82940,82940,-1690,-2.0,84600,-30,-0.04,82940,82940,1399-12-24
626,غشهد,شهد ايران ‌,13,26533,199793490,7680,7530,7530,-150,-1.95,7680,0,0.0,7530,7530,1399-12-24
627,وزمين,بانك ايران زمين,13,17377,234189829,14038,13477,13477,-561,-4.0,14032,-6,-0.04,13477,13477,1399-12-24
628,آ س پ,آ.س.پ,13,73288,1178617616,16410,16082,16082,-328,-2.0,16402,-8,-0.05,16082,16082,1399-12-24
629,زعف0008پ11,زعفران0008نگين سحرخيز(پ),13,9260,1099300600,118879,120800,117400,-1479,-1.24,118715,-164,-0.14,117400,120800,1399-12-24
630,دكپسول,توليد ژلاتين كپسول ايران,13,8305,252912165,31074,30453,30453,-621,-2.0,31071,-3,-0.01,30453,30453,1399-12-24
631,زعف0008پ08,زعفران0008نگين روستا(پ),13,8206,968754858,117531,118999,118397,866,0.74,118054,523,0.44,117990,118999,1399-12-24
632,مداران,داده‌پردازي‌ايران‌,13,24164,615940360,26010,25490,25490,-520,-2.0,26000,-10,-0.04,25490,25490,1399-12-24
633,تكشا,گسترش‌صنايع‌وخدمات‌كشاورزي‌,13,8825,409744750,47370,46430,46430,-940,-1.98,47360,-10,-0.02,46430,46430,1399-12-24
634,ثاباد,توريستي ورفاهي آبادگران ايران,13,5840,315593600,55140,54040,54040,-1100,-1.99,55130,-10,-0.02,54040,54040,1399-12-24
635,غشاذر,پگاه‌آذربايجان‌غربي‌,12,64893,635951400,10000,9800,9800,-200,-2.0,10000,0,0.0,9800,9800,1399-12-24
636,كقزوي,شيشه‌ قزوين‌,12,20609,207882983,10292,10087,10087,-205,-1.99,10290,-2,-0.02,10087,10087,1399-12-24
637,ثامان,سامان‌ گستراصفهان‌,12,55336,1250593600,23060,22600,22600,-460,-1.99,23050,-10,-0.04,22600,22600,1399-12-24
638,سخواف,سيمان مجد خواف,12,25276,426835812,17231,16887,16887,-344,-2.0,17224,-7,-0.04,16887,16887,1399-12-24
639,وكادو,تكادو,12,158738,3241429960,20836,20420,20420,-416,-2.0,20767,-69,-0.33,20420,20420,1399-12-24
640,واحصا,احياء صنايع خراسان,12,10692,765344052,73041,71581,71581,-1460,-2.0,72984,-57,-0.08,71581,71581,1399-12-24
641,ضملي3004,اختيارخ فملي-14000-1400/03/02,12,271,208641000,727,750,789,62,8.53,770,43,5.91,750,800,1399-12-24
642,ثرود,سرمايه‌گذاري مسكن زاينده رود,12,31616,554671104,17902,17544,17544,-358,-2.0,17898,-4,-0.02,17544,17544,1399-12-24
643,گكيشح,ح.توريستي ورفاهي آبادگران كيش,12,72210,2642813790,37345,36599,36599,-746,-2.0,36599,-746,-2.0,36599,36599,1399-12-24
644,اخزا804,اسنادخزانه-م4بودجه98-000421,11,20767,19454090908,936812,938000,939999,3187,0.34,936779,-33,0.0,936501,939999,1399-12-24
645,وثخوز,سرمايه گذاري و توسعه خوزستان,11,5922,401831388,71425,67854,67854,-3571,-5.0,71349,-76,-0.11,67854,67854,1399-12-24
646,غپآذر,شير پگاه آذربايجان شرقي,11,27368,1772734832,66095,64774,64774,-1321,-2.0,66047,-48,-0.07,64774,64774,1399-12-24
647,آينده,بازرگاني آينده سازان بهشت پارس,11,12447,244658232,20057,19656,19656,-401,-2.0,20052,-5,-0.02,19656,19656,1399-12-24
648,ضصاد3003,اختيارخ وبصادر-3000-1400/03/12,11,418,68406000,149,170,159,10,6.71,164,15,10.07,133,170,1399-12-24
649,ضپنا2003,اختيارخ رمپنا-16000-1400/02/12,11,112,137110000,1800,1500,1200,-600,-33.33,1224,-576,-32.0,1111,1500,1399-12-24
650,دفارا,داروسازي‌ فارابي‌,11,14056,929242160,67450,66110,66110,-1340,-1.99,67420,-30,-0.04,66110,66110,1399-12-24
651,فيروزه2,صندوق شاخص30 شركت فيروزه- سهام,10,100000,100000,136750,1,1,-136749,-100.0,1,-136749,-100.0,1,1,1399-12-24
652,سبجنو,سيمان‌ بجنورد,10,15139,891989880,60120,58920,58920,-1200,-2.0,60100,-20,-0.03,58920,58920,1399-12-24
653,ددام,داروسازي زاگرس فارمد پارس,10,53300,1168869000,22370,21930,21930,-440,-1.97,22360,-10,-0.04,21930,21930,1399-12-24
654,طلا2,صندوق س.پشتوانه طلاي لوتوس,10,1000000,1000000,76628,1,1,-76627,-100.0,1,-76627,-100.0,1,1,1399-12-24
655,دقاضي,داروسازي شهيد قاضي,10,10343,436733175,43984,42225,42225,-1759,-4.0,43944,-40,-0.09,42225,42225,1399-12-24
656,پست0008پ08,پسته فندقي32-30مه ولات0008(پ),10,301,416229780,1375313,1380000,1380000,4687,0.34,1382823,7510,0.55,1380000,1395000,1399-12-24
657,حپارسا,توسعه حمل و نقل ريلي پارسيان,10,8703,301393593,35337,34631,34631,-706,-2.0,35333,-4,-0.01,34631,34631,1399-12-24
658,وپسا,س. پتروشيمي ساختمان  خليج فارس,10,46201,137124568,3028,2968,2968,-60,-1.98,3027,-1,-0.03,2968,2968,1399-12-24
659,ضملي3003,اختيارخ فملي-12000-1400/03/02,10,82,142924000,1705,1750,1650,-55,-3.23,1743,38,2.23,1650,1750,1399-12-24
660,فولاي,صنايع فولاد آلياژي يزد,10,1953,98530803,51480,50451,50451,-1029,-2.0,51478,-2,0.0,50451,50451,1399-12-24
661,ثعمرا,عمران و توسعه شاهد,10,19784,254343104,13118,12856,12856,-262,-2.0,13117,-1,-0.01,12856,12856,1399-12-24
662,ضخود2011,اختيارخ خودرو-5000-1400/02/08,10,386,4867000,13,25,10,-3,-23.08,13,0,0.0,10,25,1399-12-24
663,اراد50,مرابحه عام دولت5-ش.خ0302,10,190000,190000000000,1000000,1000000,1000000,0,0.0,1000000,0,0.0,1000000,1000000,1399-12-24
664,ضچاد2002,اختيارخ كچاد-16000-1400/02/05,10,51,375233000,4560,7200,7300,2740,60.09,7358,2798,61.36,7200,7400,1399-12-24
665,اراد77,مرابحه عام دولت77-ش.خ000812,10,2000000,1956480000000,1000000,978240,978240,-21760,-2.18,978240,-21760,-2.18,978240,978240,1399-12-24
666,زپارس,ملي كشت و صنعت و دامپروري پارس,10,11134,1862495520,170690,167280,167280,-3410,-2.0,170560,-130,-0.08,167280,167280,1399-12-24
667,فجام,جام‌دارو,9,9078,92595600,10400,10200,10200,-200,-1.92,10400,0,0.0,10200,10200,1399-12-24
668,ضسپا3005,اختيارخ خساپا-3000-1400/03/26,9,33,4837000,150,189,150,0,0.0,147,-3,-2.0,121,189,1399-12-24
669,قهكمت,قندهكمتان‌,9,2401,108933370,46290,45370,45370,-920,-1.99,46290,0,0.0,45370,45370,1399-12-24
670,زنجان,صنايع كشاورزي وكود زنجان,9,10873,100760091,9456,9267,9267,-189,-2.0,9455,-1,-0.01,9267,9267,1399-12-24
671,سنير,سيمان‌ سفيد ني‌ريز,9,685,169297750,252190,247150,247150,-5040,-2.0,252170,-20,-0.01,247150,247150,1399-12-24
672,غدشت,دشت‌ مرغاب‌,9,1038,296099880,291080,285260,285260,-5820,-2.0,291040,-40,-0.01,285260,285260,1399-12-24
673,اخزا807,اسنادخزانه-م7بودجه98-000719,9,10726,9578844548,893298,894000,893999,701,0.08,893049,-249,-0.03,891444,894000,1399-12-24
674,فنفت,صنايع تجهيزات نفت,9,107676,3564183276,33776,33101,33101,-675,-2.0,33653,-123,-0.36,33101,33101,1399-12-24
675,شتولي,تولي‌پرس‌,9,3998,140037946,35741,35027,35027,-714,-2.0,35731,-10,-0.03,35027,35027,1399-12-24
676,بسويچ,پارس‌سويچ‌,9,2595,134446950,52860,51810,51810,-1050,-1.99,52860,0,0.0,51810,51810,1399-12-24
677,اخزا713,اسنادخزانه-م13بودجه97-000518,9,4257,3932254621,923760,923760,923760,0,0.0,923715,-45,0.0,922501,924000,1399-12-24
678,غگز,گز سكه,9,430000,8686000000,20200,20200,20200,0,0.0,20200,0,0.0,20200,20200,1399-12-24
679,افرا,افرانت,8,1830,63735240,35538,34828,34828,-710,-2.0,35537,-1,0.0,34828,34828,1399-12-24
680,ضترا3003,اختيارخ شتران-9000-1400/03/09,8,163,154233000,976,1000,1000,24,2.46,946,-30,-3.07,900,1600,1399-12-24
681,خپويش,سازه‌ پويش‌,8,21162,1256811180,60600,59390,59390,-1210,-2.0,60570,-30,-0.05,59390,59390,1399-12-24
682,مفاخر,توسعه فناوري اطلاعات خوارزمي,8,17467,1150481422,67210,65866,65866,-1344,-2.0,67178,-32,-0.05,65866,65866,1399-12-24
683,زعف0008پ15,زعفران0008پوشالمعمول طلاسرخ(پ),8,3775,311458625,82144,85000,82395,251,0.31,82506,362,0.44,82395,86000,1399-12-24
684,چافست,افست‌,8,23267,379019430,16620,16290,16290,-330,-1.99,16620,0,0.0,16290,16290,1399-12-24
685,اراد78,مرابحه عام دولت78-ش.خ001112,8,1600000,1552000000000,1000000,970000,970000,-30000,-3.0,970000,-30000,-3.0,970000,970000,1399-12-24
686,وسكرد,شركت س استان كردستان,8,135892,99201160,740,730,730,-10,-1.35,740,0,0.0,730,730,1399-12-24
687,سفار,سيمان‌فارس‌,8,4309,655226540,155160,152060,152060,-3100,-2.0,155120,-40,-0.03,152060,152060,1399-12-24
688,قمرو,قند مرودشت‌,8,3038,110218640,37020,36280,36280,-740,-2.0,37020,0,0.0,36280,36280,1399-12-24
689,زعف0008پ18,زعفران0008نگين بهرامن(پ),7,3150,372222500,118332,119930,119900,1568,1.33,118166,-166,-0.14,118010,119930,1399-12-24
690,سنفت009,سلف موازي استاندارد سنفت009,7,680000,1007670240000,1477528,1481868,1481868,4340,0.29,1481868,4340,0.29,1481868,1481868,1399-12-24
691,كلوند,كاشي‌ الوند,7,55611,2545315470,46700,45770,45770,-930,-1.99,46650,-50,-0.11,45770,45770,1399-12-24
692,تملي612,تسهيلات مسكن بانك ملي-اسفند96,7,51,43129379,846504,888829,804179,-42325,-5.0,845674,-830,-0.1,804179,888829,1399-12-24
693,كطبس,ذغال‌سنگ‌ نگين‌ ط‌بس‌,7,1017,82417680,82690,81040,81040,-1650,-2.0,82690,0,0.0,81040,81040,1399-12-24
694,نگين,ص.س. زمين و ساختمان نگين شهرري,7,862,41545320,47610,48200,48260,650,1.37,48200,590,1.24,48160,48260,1399-12-24
695,وسخوز,شركت س استان خوزستان,7,140570,134947200,970,960,960,-10,-1.03,970,0,0.0,960,960,1399-12-24
696,ضسپا3002,اختيارخ خساپا-1800-1400/03/26,7,185,121450000,594,700,650,56,9.43,656,62,10.44,650,700,1399-12-24
697,تپولا,مهندسي مرآت پولاد,7,5062,177990044,36627,35162,35162,-1465,-4.0,36613,-14,-0.04,35162,35162,1399-12-24
698,اخزا810,اسنادخزانه-م10بودجه98-001006,7,11228,9607195850,855745,855671,855626,-119,-0.01,855646,-99,-0.01,855626,855700,1399-12-24
699,وسگيلا,شركت س استان گيلان,7,68019,52374630,780,770,770,-10,-1.28,780,0,0.0,770,770,1399-12-24
700,لازما,كارخانه هاي صنعتي آزمايش,7,10421,356356516,34893,34196,34196,-697,-2.0,34880,-13,-0.04,34196,34196,1399-12-24
701,اخزا718,اسنادخزانه-م18بودجه97-000525,7,100151,92538838500,918019,919050,924000,5981,0.65,923993,5974,0.65,919050,924000,1399-12-24
702,بشهاب,لامپ‌  پارس‌ شهاب‌,6,4926,724368300,150050,147050,147050,-3000,-2.0,150010,-40,-0.03,147050,147050,1399-12-24
703,اوان,مبين وان كيش,6,15450,832585050,54988,53889,53889,-1099,-2.0,54969,-19,-0.03,53889,53889,1399-12-24
704,كمرجان,بازرگاني و توليدي مرجان كار,6,1229,177129625,147066,144125,144125,-2941,-2.0,147055,-11,-0.01,144125,144125,1399-12-24
705,ضجار2000,اختيارخ وتجارت-1800-1400/02/22,6,46,41010000,950,921,860,-90,-9.47,892,-58,-6.11,860,921,1399-12-24
706,غشوكو,شوكو پارس,6,4368,171413424,40043,39243,39243,-800,-2.0,40036,-7,-0.02,39243,39243,1399-12-24
707,كيسون,شركت كيسون,6,12779,184388191,14723,14429,14429,-294,-2.0,14721,-2,-0.01,14429,14429,1399-12-24
708,ضخود2012,اختيارخ خودرو-6000-1400/02/08,6,216,1716000,11,12,5,-6,-54.55,8,-3,-27.27,5,12,1399-12-24
709,شزنگ,تجهيزنيروي‌زنگان‌,6,154,35574308,235716,231002,231002,-4714,-2.0,235707,-9,0.0,231002,231002,1399-12-24
710,شستا991,اجاره تامين اجتماعي-امين991226,6,213,214109772,1009196,980000,1008999,-197,-0.02,1005210,-3986,-0.39,980000,1009999,1399-12-24
711,گواهي ظرفيت,گواهي ظرفيت نقدي,6,35830000,381195370000,10639,10639,10639,0,0.0,10639,0,0.0,10639,10639,1399-12-24
712,حسير,ريل سير كوثر,6,5120,87408640,17420,17072,17072,-348,-2.0,17419,-1,-0.01,17072,17072,1399-12-24
713,غمهرا,توليدي‌مهرام‌,6,886,106514920,122670,120220,120220,-2450,-2.0,122660,-10,-0.01,120220,120220,1399-12-24
714,تملي706,تسهيلات مسكن ب. ملي-شهريور97,6,51,30801105,575186,603940,603945,28759,5.0,603943,28757,5.0,603940,603945,1399-12-24
715,سهرمز,سيمان‌هرمزگان‌,6,20430,501760800,25060,24560,24560,-500,-2.0,25050,-10,-0.04,24560,24560,1399-12-24
716,قجام,فرآوردههاي غذايي وقندتربت‌جام‌,6,8788,142717120,16571,16240,16240,-331,-2.0,16566,-5,-0.03,16240,16240,1399-12-24
717,دحاوي,الحاوي,6,4585,53869165,12238,11749,11749,-489,-4.0,12237,-1,-0.01,11749,11749,1399-12-24
718,اخزا723,اسنادخزانه-م23بودجه97-000824,6,5218,4567737860,874996,878999,877000,2004,0.23,875381,385,0.04,874405,878999,1399-12-24
719,ضسپا3000,اختيارخ خساپا-1400-1400/03/26,6,322,315030000,864,941,994,130,15.05,978,114,13.19,941,1000,1399-12-24
720,ضمخا7070,اختيارخ اخابر-20000-1400/07/28,5,6,8588000,2599,802,1590,-1009,-38.82,1431,-1168,-44.94,802,2198,1399-12-24
721,ياقوت2,صندوق س ياقوت آگاه-ثابت,5,118536000,118536000,12043,1,1,-12042,-99.99,1,-12042,-99.99,1,1,1399-12-24
722,اخزا722,اسنادخزانه-م22بودجه97-000428,5,100352,93928416352,931502,933001,936000,4498,0.48,935989,4487,0.48,933001,936000,1399-12-24
723,وشمال,س. چشم انداز توسعه شمال,5,983,83734889,88732,85183,85183,-3549,-4.0,88717,-15,-0.02,85183,85183,1399-12-24
724,نبروج,نساجي بروجرد,5,7628,45218784,5812,5928,5928,116,2.0,5813,1,0.02,5928,5928,1399-12-24
725,وسصفا,شركت س استان اصفهان,5,37595,39474750,1070,1050,1050,-20,-1.87,1070,0,0.0,1050,1050,1399-12-24
726,زر2,صندوق س.پشتوانه سكه طلاي زر,5,500000,500000,46459,1,1,-46458,-100.0,1,-46458,-100.0,1,1,1399-12-24
727,شسم,توليد سموم‌ علف‌ كش,5,645,58695645,89217,91001,91001,1784,2.0,89227,10,0.01,91001,91001,1399-12-24
728,ضجار2004,اختيارخ وتجارت-3500-1400/02/22,5,304,26360000,85,90,80,-5,-5.88,87,2,2.35,80,90,1399-12-24
729,لخانه,لوازم‌ خانگي‌ پارس‌,4,5904,174787920,30209,29605,29605,-604,-2.0,30204,-5,-0.02,29605,29605,1399-12-24
730,وجامي,سرمايه گذاري جامي,4,5707,88652538,15851,15534,15534,-317,-2.0,15850,-1,-0.01,15534,15534,1399-12-24
731,ضپنا2001,اختيارخ رمپنا-12000-1400/02/12,4,10,45006000,4786,4500,4501,-285,-5.95,4501,-285,-5.95,4500,4501,1399-12-24
732,وسفارس,شركت س استان فارس,4,98778,99765780,1030,1010,1010,-20,-1.94,1030,0,0.0,1010,1010,1399-12-24
733,ضخود2010,اختيارخ خودرو-4500-1400/02/08,4,278,4370000,16,16,15,-1,-6.25,16,0,0.0,15,16,1399-12-24
734,نهال2,صندوق س. طلاي سرخ نوويرا,4,400000,400000,9319,1,1,-9318,-99.99,1,-9318,-99.99,1,1,1399-12-24
735,وسيستا,شركت س استان سيستان وبلوچستان,4,48398,36782480,770,760,760,-10,-1.3,770,0,0.0,760,760,1399-12-24
736,نتوس,پشم‌ بافي‌ توس,4,1574,33979512,22028,21588,21588,-440,-2.0,22027,-1,0.0,21588,21588,1399-12-24
737,ضپاس2003,اختيارخ وپارس-3500-1400/02/29,4,55,11198000,242,260,200,-42,-17.36,204,-38,-15.7,188,260,1399-12-24
738,ضپاس2001,اختيارخ وپارس-2500-1400/02/29,4,58,44320000,793,780,755,-38,-4.79,764,-29,-3.66,755,790,1399-12-24
739,تملي803,تسهيلات مسكن ب. ملي-خرداد98,4,32,25210400,750310,787825,787825,37515,5.0,787825,37515,5.0,787825,787825,1399-12-24
740,تملي704,تسهيلات مسكن ب. ملي-تير97,4,25,14706475,619220,588259,588259,-30961,-5.0,588259,-30961,-5.0,588259,588259,1399-12-24
741,حخزر,كشتيراني درياي خزر,4,4272,123076320,29397,28810,28810,-587,-2.0,29396,-1,0.0,28810,28810,1399-12-24
742,تملي806,تسهيلات مسكن ب. ملي-شهريور98,4,22,18456394,798979,838927,838927,39948,5.0,838927,39948,5.0,838927,838927,1399-12-24
743,زير0003پ01,زيره سبز0003كيميابذر(پ),4,50,22874381,500674,460001,454874,-45800,-9.15,457488,-43186,-8.63,454874,460001,1399-12-24
744,سنفت010,سلف موازي استاندارد سنفت010,4,335320,500002358400,1485722,1491120,1491120,5398,0.36,1491120,5398,0.36,1491120,1491120,1399-12-24
745,اخزا720,اسنادخزانه-م20بودجه97-000324,4,1311,1250979919,952041,954999,952502,461,0.05,954218,2177,0.23,952502,954999,1399-12-24
746,تملي802,تسهيلات مسكن ب. ملي-ارديبهشت98,4,34,29950396,838947,880894,880894,41947,5.0,880894,41947,5.0,880894,880894,1399-12-24
747,اوصتا4,صندوق انديشه ورزان صباتامين -د,4,120730200,2188938461600,18088,18100,18108,20,0.11,18131,43,0.24,18100,18143,1399-12-24
748,قشهد,شهد,4,3740,75061800,20470,20070,20070,-400,-1.95,20470,0,0.0,20070,20070,1399-12-24
749,ضصاد3001,اختيارخ وبصادر-2000-1400/03/12,3,15,7953000,573,321,545,-28,-4.89,530,-43,-7.5,321,547,1399-12-24
750,كشرق,صنعتي و معدني شمال شرق شاهرود,3,400,37468800,95583,93672,93672,-1911,-2.0,95582,-1,0.0,93672,93672,1399-12-24
751,ثاژن,سخت آژند,3,7574,75118932,10120,9918,9918,-202,-2.0,10118,-2,-0.02,9918,9918,1399-12-24
752,ضملي3005,اختيارخ فملي-16000-1400/03/02,3,7,3239000,599,223,650,51,8.51,463,-136,-22.7,223,650,1399-12-24
753,داراب,پتروشيمي داراب,3,13000,31265000,2454,2405,2405,-49,-2.0,2454,0,0.0,2405,2405,1399-12-24
754,ضملي3000,اختيارخ فملي-8000-1400/03/02,3,3,13595000,5250,4555,4520,-730,-13.9,4532,-718,-13.68,4520,4555,1399-12-24
755,پا ر 3,بار پايه روز 3,3,17000,5950000,350,350,350,0,0.0,350,0,0.0,350,350,1399-12-24
756,اعتماد2,صندوق س.اعتماد آفرين پارسيان-د,3,28500000,28500000,35318,1,1,-35317,-100.0,1,-35317,-100.0,1,1,1399-12-24
757,ضترا3001,اختيارخ شتران-7000-1400/03/09,3,51,112662000,2944,2222,2200,-744,-25.27,2209,-735,-24.97,2200,2222,1399-12-24
758,ثنام,س ساختماني ب نام آوران مهندسي,3,1144,18763888,16736,16402,16402,-334,-2.0,16736,0,0.0,16402,16402,1399-12-24
759,شستا994,اجاره تامين اجتماعي-نوين991226,3,106,104558400,1013500,986400,986400,-27100,-2.67,986400,-27100,-2.67,986400,986400,1399-12-24
760,وسمازن,س.سهام عدالت استان مازندران,3,100000,96000000,970,960,960,-10,-1.03,970,0,0.0,960,960,1399-12-24
761,شستا992,اجاره تامين اجتماعي-سپهر991226,3,25250,25250000000,1000000,1000000,1000000,0,0.0,1000000,0,0.0,1000000,1000000,1399-12-24
762,زعف0008پ09,زعفران0008نگين نوين(پ),3,1045,124355000,117610,119000,119000,1390,1.18,119000,1390,1.18,119000,119000,1399-12-24
763,وساربيل,شركت س استان اردبيل,3,28000,35280000,1280,1260,1260,-20,-1.56,1280,0,0.0,1260,1260,1399-12-24
764,حپترو,حمل و نقل پتروشيمي( سهامي عام,3,20000,1065600000,54360,53280,53280,-1080,-1.99,54340,-20,-0.04,53280,53280,1399-12-24
765,قزوين,كارخانجات‌ قند قزوين‌,3,1430,56199000,40100,39300,39300,-800,-2.0,40100,0,0.0,39300,39300,1399-12-24
766,وسلرستا,شركت س استان لرستان,3,20962,18656180,900,890,890,-10,-1.11,900,0,0.0,890,890,1399-12-24
767,اراد744,مرابحه عام دولت74-ش.خ040226,3,13840000,13520000000000,980000,1000000,1000000,20000,2.04,976879,-3121,-0.32,960000,1000000,1399-12-24
768,تكشاح,ح . صنايع‌وخدمات‌كشاورزي‌,3,50235,2185222500,49110,43500,43500,-5610,-11.42,43500,-5610,-11.42,43500,43500,1399-12-24
769,تشتاد,صنايع توليدي اشتاد ايران‌,3,1812,27957348,15743,15429,15429,-314,-1.99,15743,0,0.0,15429,15429,1399-12-24
770,وساشرقي,شركت س استان آذربايجان شرقي,2,5397,5181120,970,960,960,-10,-1.03,970,0,0.0,960,960,1399-12-24
771,گپارس,امور رفاهي كارگزاران پارس,2,150,30694800,208808,204632,204632,-4176,-2.0,208801,-7,0.0,204632,204632,1399-12-24
772,ضملت3002,اختيارخ وبملت-4000-1400/03/19,2,12,8370000,527,700,685,158,29.98,697,170,32.26,685,700,1399-12-24
773,وسكرمان,س.سهام عدالت استان كرمان,2,14000,14140000,1030,1010,1010,-20,-1.94,1030,0,0.0,1010,1010,1399-12-24
774,پلاست,كارخانجات توليدي پلاستيران,2,154,10910284,72291,70846,70846,-1445,-2.0,72290,-1,0.0,70846,70846,1399-12-24
775,پا ر 1,بار پايه روز 1,2,20000,7000000,350,350,350,0,0.0,350,0,0.0,350,350,1399-12-24
776,صخود1404,صكوك رهني خودرو1404- 3ماهه 16%,2,20000,18494000000,919500,924700,924700,5200,0.57,924700,5200,0.57,924700,924700,1399-12-24
777,ضچاد2003,اختيارخ كچاد-18000-1400/02/05,2,12,64000000,3236,5000,7000,3764,116.32,5333,2097,64.8,5000,7000,1399-12-24
778,پافروردي,بار پايه فروردين,2,25000,8725000,345,350,345,0,0.0,349,4,1.16,345,350,1399-12-24
779,اخزا9052,اسنادخزانه-م5بودجه99-020218,2,1186022,772385885500,651664,651000,651500,-164,-0.03,651241,-423,-0.06,651000,651500,1399-12-24
780,وسرضوي,س.سهام عدالت استان خراسان رضوي,2,15294,15446940,1030,1010,1010,-20,-1.94,1030,0,0.0,1010,1010,1399-12-24
781,فبيرا,بسته‌ بندي‌ ايران‌,2,4726,14560806,3143,3081,3081,-62,-1.97,3143,0,0.0,3081,3081,1399-12-24
782,آگاس2,صندوق س.هستي بخش آگاه-س,2,200000,200000,66202,1,1,-66201,-100.0,1,-66201,-100.0,1,1,1399-12-24
783,زعف0008پ12,زعفران0008پوشالمعمول سحرخيز(پ),2,1008,83082000,82049,84000,82410,361,0.44,82423,374,0.46,82410,84000,1399-12-24
784,ميدكو2,هلدينگ صنايع  معدني خاورميانه,2,61835500,1900982750000,30394,30750,30500,106,0.35,30743,349,1.15,30500,30750,1399-12-24
785,ضشنا2005,اختيارخ شپنا-18000-1400/02/27,2,12,3600000,282,150,450,168,59.57,300,18,6.38,150,450,1399-12-24
786,اراد494,مرابحه عام دولت4-ش.خ 0206,2,21424000,19748396824000,990000,921827,921750,-68250,-6.89,921788,-68212,-6.89,921750,921827,1399-12-24
787,ضسپا3001,اختيارخ خساپا-1600-1400/03/26,2,116,97600000,705,850,840,135,19.15,841,136,19.29,840,850,1399-12-24
788,ضصاد3000,اختيارخ وبصادر-1800-1400/03/12,2,2,1800000,800,900,900,100,12.5,900,100,12.5,900,900,1399-12-24
789,شجمح,ح. صنايع پتروشيمي تخت جمشيد,2,2047,17341560,8815,8480,8463,-352,-3.99,8472,-343,-3.89,8463,8480,1399-12-24
790,وآتوس,س.آرين توسكا قيمت اسمي 350ريال,2,500,21549000,44893,43098,43098,-1795,-4.0,44891,-2,0.0,43098,43098,1399-12-24
791,زكشت,كشاورزي مكانيزه اصفهان كشت,2,700,27757800,40463,39654,39654,-809,-2.0,40463,0,0.0,39654,39654,1399-12-24
792,شستا002,اجاره تامين اجتماعي-تمدن000523,2,4000,4000000000,1000000,1000000,1000000,0,0.0,1000000,0,0.0,1000000,1000000,1399-12-24
793,اراد474,مرابحه عام دولت4-ش.خ 0008,2,5488000,5373457208000,960000,979057,979200,19200,2.0,979128,19128,1.99,979057,979200,1399-12-24
794,فملي2,ملي‌ صنايع‌ مس‌ ايران‌,2,30760118,387577486800,12470,12600,12600,130,1.04,12600,130,1.04,12600,12600,1399-12-24
795,ضجار2001,اختيارخ وتجارت-2000-1400/02/22,2,25,20020000,820,801,800,-20,-2.44,801,-19,-2.32,800,801,1399-12-24
796,وحافظ,بيمه حافظ,2,188,12511024,67906,66548,66548,-1358,-2.0,67904,-2,0.0,66548,66548,1399-12-24
797,ومعادن2,توسعه‌معادن‌وفلزات‌,2,24532645,303787492200,12300,12360,12600,300,2.44,12383,83,0.67,12360,12600,1399-12-24
798,اراد454,مرابحه عام دولت4-ش.خ 0107,2,6316000,5970236896000,978000,945312,945200,-32800,-3.35,945256,-32744,-3.35,945200,945312,1399-12-24
799,شتهران,داروسازي تهران شيمي,2,16050,128576550,7703,8011,8011,308,4.0,7707,4,0.05,8011,8011,1399-12-24
800,اراد644,مرابحه عام دولتي64-ش.خ0111,2,14000000,13040986000000,944500,931548,931450,-13050,-1.38,931499,-13001,-1.38,931450,931548,1399-12-24
801,ونوين2,بانك‌اقتصادنوين‌,2,296000000,1246160000000,4210,4210,4210,0,0.0,4210,0,0.0,4210,4210,1399-12-24
802,صينا205,صكوك منفعت سينا دارو-3ماهه 19%,2,84,82440000,980010,985000,980000,-10,0.0,981429,1419,0.14,980000,985000,1399-12-24
803,زعف0008پ19,زعفران0008نگين تروند قاينات(پ),2,130,15524200,118044,119990,118500,456,0.39,119417,1373,1.16,118500,119990,1399-12-24
804,شلرد02,كود شيميايي اوره لردگان,2,150,148950000,993000,993000,993000,0,0.0,993000,0,0.0,993000,993000,1399-12-24
805,تملي804,تسهيلات مسكن ب. ملي-تير98,2,11,9062138,820103,861108,779098,-41005,-5.0,823831,3728,0.45,779098,861108,1399-12-24
806,اراد584,مرابحه عام دولت5-ش.خ 0110,2,10602000,9912848796000,972287,935046,934950,-37337,-3.84,934998,-37289,-3.84,934950,935046,1399-12-24
807,كايتا,ايتالران‌,2,14008,133916480,9282,9560,9560,278,3.0,9284,2,0.02,9560,9560,1399-12-24
808,كشم0006پ02,كشمش تيزابي0006تاكستان(پ),2,1500,344975000,229498,229980,229990,492,0.21,229983,485,0.21,229980,229990,1399-12-24
809,بزاگرسح,ح . نيروگاه زاگرس كوثر,2,7311,43127589,6019,5899,5899,-120,-1.99,5899,-120,-1.99,5899,5899,1399-12-24
810,سفاسي,شركت فارسيت اهواز,2,990,14039190,14470,14181,14181,-289,-2.0,14470,0,0.0,14181,14181,1399-12-24
811,ضچاد2001,اختيارخ كچاد-14000-1400/02/05,2,14,120600000,6630,8500,9300,2670,40.27,8614,1984,29.92,8500,9300,1399-12-24
812,ضپيك2009,اختيارخ تاپيكو-10000-00/02/19,1,40,100000000,1770,2500,2500,730,41.24,2500,730,41.24,2500,2500,1399-12-24
813,اراد524,مرابحه عام دولت5-ش.خ 0108,1,6333000,5955173220000,1000000,940340,940340,-59660,-5.97,940340,-59660,-5.97,940340,940340,1399-12-24
814,چدن2,توليدي چدن سازان,1,2070000,50487300000,24880,24390,24390,-490,-1.97,24390,-490,-1.97,24390,24390,1399-12-24
815,شسپا2,نفت سپاهان,1,11793273,187866838890,15930,15930,15930,0,0.0,15930,0,0.0,15930,15930,1399-12-24
816,ضفار3001,اختيارخ فارس-9000-1400/03/05,1,3,3600000,944,1200,1200,256,27.12,1200,256,27.12,1200,1200,1399-12-24
817,اخزا805,اسنادخزانه-م5بودجه98-000422,1,40,37520000,935240,938000,938000,2760,0.3,938000,2760,0.3,938000,938000,1399-12-24
818,حريل02,اجاره ريل پردازسير021212,1,2500,2500000000,982701,1000000,1000000,17299,1.76,1000000,17299,1.76,1000000,1000000,1399-12-24
819,تفيرو,مهندسي فيروزا,1,48,954336,19118,19882,19882,764,4.0,19118,0,0.0,19882,19882,1399-12-24
820,غمارگ2,مارگارين‌,1,7600000,248216000000,32660,32660,32660,0,0.0,32660,0,0.0,32660,32660,1399-12-24
821,عيار2,صندوق س. پشتوانه طلاي مفيد,1,10000,10000,26986,1,1,-26985,-100.0,1,-26985,-100.0,1,1,1399-12-24
822,صخابر102,صكوك اجاره مخابرات-3 ماهه 16%,1,3000,2925000000,985085,975000,975000,-10085,-1.02,975000,-10085,-1.02,975000,975000,1399-12-24
823,كصدف,كاشي صدف سرام استقلال آباده,1,368,9214352,25549,25039,25039,-510,-2.0,25549,0,0.0,25039,25039,1399-12-24
824,كچاد2,معدني‌وصنعتي‌چادرملو,1,8316000,187858440000,21940,22590,22590,650,2.96,22590,650,2.96,22590,22590,1399-12-24
825,اراد35,مرابحه عام دولت3-ش.خ 0103,1,1000,980000000,1000000,980000,980000,-20000,-2.0,980000,-20000,-2.0,980000,980000,1399-12-24
826,حكمت01,مشاركت حكمت ايرانيان 140107,1,31,31377828,1012188,1012188,1012188,0,0.0,1012188,0,0.0,1012188,1012188,1399-12-24
827,اشاد102,مشاركت دولتي10-شرايط خاص001226,1,44,39908000,945359,907000,907000,-38359,-4.06,907000,-38359,-4.06,907000,907000,1399-12-24
828,صنفت0312,صكوك منفعت نفت0312-6ماهه 18/5%,1,300,300000000,1000000,1000000,1000000,0,0.0,1000000,0,0.0,1000000,1000000,1399-12-24
829,اخزا9042,اسنادخزانه-م4بودجه99-011215,1,143858,97823440000,670002,680000,680000,9998,1.49,680000,9998,1.49,680000,680000,1399-12-24
830,ضخوز2014,اختيارخ فخوز-14000-1400/02/15,1,10,22500000,2260,2250,2250,-10,-0.44,2250,-10,-0.44,2250,2250,1399-12-24
831,حرهشا,رهشاد سپاهان (سهامي عام,1,119,7610526,65259,63954,63954,-1305,-2.0,65258,-1,0.0,63954,63954,1399-12-24
832,ثجوان,تامين مسكن جوانان,1,886,9954210,11464,11235,11235,-229,-2.0,11464,0,0.0,11235,11235,1399-12-24
833,ضپنا2000,اختيارخ رمپنا-10000-1400/02/12,1,1,6500000,6200,6500,6500,300,4.84,6500,300,4.84,6500,6500,1399-12-24
834,تابان04,اجاره تابان سپهر14031126,1,20,19800000,1000000,990000,990000,-10000,-1.0,990000,-10000,-1.0,990000,990000,1399-12-24
835,سفانو,سيمان فارس نو,1,10940,424472000,42390,38800,38800,-3590,-8.47,42360,-30,-0.07,38800,38800,1399-12-24
836,اخزا8112,اسنادخزانه-م11بودجه98-001013,1,169300,144751500000,853241,855000,855000,1759,0.21,855000,1759,0.21,855000,855000,1399-12-24
837,غمينوح,ح . شركت صنايع غذايي مينو شرق,1,10000,99360000,10138,9936,9936,-202,-1.99,9936,-202,-1.99,9936,9936,1399-12-24
838,ثشاهد2,سرمايه‌ گذاري‌ شاهد,1,7825000,146249250000,19070,18690,18690,-380,-1.99,18690,-380,-1.99,18690,18690,1399-12-24
839,صنفت03122,صكوك منفعت نفت0312-6ماهه 18/5%,1,1000000,1000000000000,1000000,1000000,1000000,0,0.0,1000000,0,0.0,1000000,1000000,1399-12-24
840,آبين,كشت و صنعت آبشيرين,1,2400,10039200,4268,4183,4183,-85,-1.99,4268,0,0.0,4183,4183,1399-12-24
841,وسخراج,شركت س استان خراسان جنوبي,1,5000,10900000,2220,2180,2180,-40,-1.8,2220,0,0.0,2180,2180,1399-12-24
842,ضترا3000,اختيارخ شتران-6000-1400/03/09,1,5,16500000,3600,3300,3300,-300,-8.33,3300,-300,-8.33,3300,3300,1399-12-24
843,شرق1400,مشاركت ليزينگ ايران وشرق140010,1,8,8040000,1007990,1005000,1005000,-2990,-0.3,1005000,-2990,-0.3,1005000,1005000,1399-12-24
844,وسمركز,شركت س استان مركزي,1,5500,7590000,1400,1380,1380,-20,-1.43,1400,0,0.0,1380,1380,1399-12-24
845,صايپا1122,صكوك مرابحه سايپا112-3ماهه 16%,1,185000,185000000000,983371,1000000,1000000,16629,1.69,1000000,16629,1.69,1000000,1000000,1399-12-24
846,شپنا2,پالايش نفت اصفهان,1,16803617,225218878651,13270,13403,13403,133,1.0,13403,133,1.0,13403,13403,1399-12-24
847,افاد624,منفعت دولت6-ش.خاص ملت0109,1,2000000,2000000000000,1000000,1000000,1000000,0,0.0,1000000,0,0.0,1000000,1000000,1399-12-24
848,سلامت6,مرابحه سلامت6واجدشرايط خاص1400,1,25000,24999875000,999999,999995,999995,-4,0.0,999995,-4,0.0,999995,999995,1399-12-24
849,مداران4,داده‌پردازي‌ايران‌,1,3548719,13981952860,26010,3940,3940,-22070,-84.85,3940,-22070,-84.85,3940,3940,1399-12-24
850,ضخوز2012,اختيارخ فخوز-10000-1400/02/15,1,2,8800000,5400,4400,4400,-1000,-18.52,4400,-1000,-18.52,4400,4400,1399-12-24
851,شپاكسا2,پاكسان‌,1,30900000,799692000000,25880,25880,25880,0,0.0,25880,0,0.0,25880,25880,1399-12-24
852,صمسكن912,ص دين مسكن جنوب-ماهانه16درصد,1,650,32040450,49293,49293,49293,0,0.0,49293,0,0.0,49293,49293,1399-12-24
853,وسخراش,شركت س استان خراسان شمالي,1,3720,5022000,1370,1350,1350,-20,-1.46,1370,0,0.0,1350,1350,1399-12-24
854,ضخوز2013,اختيارخ فخوز-12000-1400/02/15,1,5,15950000,2946,3190,3190,244,8.28,3190,244,8.28,3190,3190,1399-12-24
855,تابا,تابان نيرو سپاهان,1,500,27770000,56673,55540,55540,-1133,-2.0,56671,-2,0.0,55540,55540,1399-12-24
856,تملي805,تسهيلات مسكن ب. ملي-مرداد98,1,10,8173670,860386,817367,817367,-43019,-5.0,817367,-43019,-5.0,817367,817367,1399-12-24
857,خفناور,مهندسي صنعتي روان فن آور,1,100,5071500,51749,50715,50715,-1034,-2.0,51749,0,0.0,50715,50715,1399-12-24
858,وسقم,شركت س استان قم,1,16000,22240000,1410,1390,1390,-20,-1.42,1410,0,0.0,1390,1390,1399-12-24
859,تملي703,تسهيلات مسكن ب. ملي-خرداد97,1,21,11339958,516793,539998,539998,23205,4.49,539998,23205,4.49,539998,539998,1399-12-24
860,ريل1401,اجاره ريل كوثر14010509,1,12,12384924,1011840,1032077,1032077,20237,2.0,1032077,20237,2.0,1032077,1032077,1399-12-24
861,حاريا,كشتيراني آريا,1,200,5682200,28990,28411,28411,-579,-2.0,28990,0,0.0,28411,28411,1399-12-24
862,ضصاد3004,اختيارخ وبصادر-3500-1400/03/12,1,10,840000,79,84,84,5,6.33,84,5,6.33,84,84,1399-12-24
863,اخزا8142,اسنادخزانه-م14بودجه98-010318,1,150000,117600000000,784921,784000,784000,-921,-0.12,784000,-921,-0.12,784000,784000,1399-12-24
864,نوآور,ص.اعتبارسرمايه نوآفرين35%تاديه,1,2000,650000000,326666,325000,325000,-1666,-0.51,325000,-1666,-0.51,325000,325000,1399-12-24
865,ضملت3000,اختيارخ وبملت-3000-1400/03/19,1,5,7775000,1345,1555,1555,210,15.61,1555,210,15.61,1555,1555,1399-12-24
866,ثعتما,س. ساختماني اعتماد گستر,1,100,6642400,67779,66424,66424,-1355,-2.0,67779,0,0.0,66424,66424,1399-12-24
867,ضمخا7066,اختيارخ اخابر-12000-1400/07/28,1,2,4000000,2500,2000,2000,-500,-20.0,2000,-500,-20.0,2000,2000,1399-12-24
868,وصندوق2,سرمايه‌گذاري‌صندوق‌بازنشستگي‌,1,16300000,225217100000,13680,13817,13817,137,1.0,13817,137,1.0,13817,13817,1399-12-24
869,اراد51,مرابحه عام دولت5-ش.خ 0010,1,10000,10000000000,1000000,1000000,1000000,0,0.0,1000000,0,0.0,1000000,1000000,1399-12-24
870,اخزا9092,اسنادخزانه-م9بودجه99-020316,1,125827,80403453000,635377,639000,639000,3623,0.57,639000,3623,0.57,639000,639000,1399-12-24
871,تملي705,تسهيلات مسكن ب. ملي-مرداد97,1,10,5808110,611379,580811,580811,-30568,-5.0,580811,-30568,-5.0,580811,580811,1399-12-24
872,وبملت2,بانك ملت,1,12497000,50487880000,3940,4040,4040,100,2.54,4040,100,2.54,4040,4040,1399-12-24
873,غدشت4,دشت‌ مرغاب‌,1,1375520,400331340800,291080,291040,291040,-40,-0.01,291040,-40,-0.01,291040,291040,1399-12-24
874,اطلس2,صندوق س.توسعه اندوخته آينده-س,1,10000,10000,210337,1,1,-210336,-100.0,1,-210336,-100.0,1,1,1399-12-24
875,ضمخا7069,اختيارخ اخابر-18000-1400/07/28,1,2,1400000,1033,700,700,-333,-32.24,700,-333,-32.24,700,700,1399-12-24
876,شوينده2,مديريت صنعت شوينده ت.ص.بهشهر,1,6660000,199866600000,30010,30010,30010,0,0.0,30010,0,0.0,30010,30010,1399-12-24
877,ضفار3000,اختيارخ فارس-8000-1400/03/05,1,10,23000000,1572,2300,2300,728,46.31,2300,728,46.31,2300,2300,1399-12-24
878,سپ4,پرداخت الكترونيك سامان كيش,1,8550974,16930928520,17010,1980,1980,-15030,-88.36,1980,-15030,-88.36,1980,1980,1399-12-24
