,نماد,نام,تعداد,حجم,ارزش,دیروز,اولین,آخرین معامله - مقدار,آخرین معامله - تغییر,آخرین معامله - درصد,قیمت پایانی - مقدار,قیمت پایانی - تغییر,قیمت پایانی - درصد,کمترین,بیشترین,تاریخ
0,ثاميد,توسعه و عمران اميد,5180466,4238037410,7416565467500,1000,1750,1750,750,75.0,1750,750,75.0,1750,1750,1399-6-19
1,امين,تامين سرمايه امين,336598,230371004,3515658333170,15440,14670,16000,560,3.63,15260,-180,-1.17,14670,16200,1399-6-19
2,ثبهساز,بهساز كاشانه تهران,220633,605763904,2298814260380,3800,3610,3990,190,5.0,3790,-10,-0.26,3610,3990,1399-6-19
3,بگيلان,توسعه مسير برق گيلان,199564,37846615,1393568684738,36925,35079,38771,1846,5.0,36821,-104,-0.28,35079,38771,1399-6-19
4,سيتا,سرمايه گذاري سيمان تامين,141985,128345617,2853469488170,23130,21980,22450,-680,-2.94,22230,-900,-3.89,21980,23040,1399-6-19
5,غزر,صنعتي زر ماكارون,121287,20592304,1430692777990,68200,64790,71610,3410,5.0,69480,1280,1.88,64790,71610,1399-6-19
6,فملي,ملي‌ صنايع‌ مس‌ ايران‌,103499,360085244,11285341631750,31700,30120,32780,1080,3.41,31340,-360,-1.14,30120,33260,1399-6-19
7,آبادا,توليد نيروي برق آبادان,97440,28385080,813385479200,29910,28420,28450,-1460,-4.88,28660,-1250,-4.18,28420,29690,1399-6-19
8,دارا يكم,صندوق واسطه گري مالي يكم-سهام,96029,29822229,5812561642450,184990,180000,203480,18490,10.0,194910,9920,5.36,166500,203480,1399-6-19
9,وتجارت,بانك تجارت,68823,1920962207,5763463849420,3050,2900,3140,90,2.95,3000,-50,-1.64,2900,3170,1399-6-19
10,فولاد,فولاد مباركه اصفهان,62947,375517715,6286764740350,17130,16280,17370,240,1.4,16740,-390,-2.28,16280,17580,1399-6-19
11,آريا,پليمر آريا ساسول,58376,5554080,761503941510,131063,133300,137616,6553,5.0,137107,6044,4.61,133300,137616,1399-6-19
12,زملارد,كشاورزي و دامپروري ملارد شير,50019,9916863,331048085808,31937,33533,33533,1596,5.0,33382,1445,4.52,30550,33533,1399-6-19
13,شاروم,پتروشيمي اروميه,47277,848975,11838107400,13280,13944,13944,664,5.0,13421,141,1.06,13944,13944,1399-6-19
14,وبصادر,بانك صادرات ايران,45070,1049118210,3488151869270,3340,3180,3500,160,4.79,3320,-20,-0.6,3180,3500,1399-6-19
15,شگويا,پتروشيمي تندگويان,37632,165245826,2474163588353,15623,14842,15190,-433,-2.77,14973,-650,-4.16,14842,15500,1399-6-19
16,ذوب,سهامي ذوب آهن  اصفهان,36657,381070017,2369639424025,6469,6146,6352,-117,-1.81,6218,-251,-3.88,6146,6459,1399-6-19
17,وغدير,سرمايه‌گذاري‌غدير(هلدينگ‌,34424,200349589,3070838742800,15800,15010,15900,100,0.63,15330,-470,-2.97,15010,16270,1399-6-19
18,گدنا,تهيه توزيع غذاي دنا آفرين فدك,34242,326596,2111116544,6157,6464,6464,307,4.99,6169,12,0.19,6464,6464,1399-6-19
19,رافزا,رايان هم افزا,28360,167942,4906929356,27827,29218,29218,1391,5.0,27954,127,0.46,29218,29218,1399-6-19
20,ولپارس,ليزينگ پارسيان,22571,1659172,6503954240,3740,3920,3920,180,4.81,3760,20,0.53,3920,3920,1399-6-19
21,شصدفح,ح . صنعتي دوده فام,21940,4947910,100323514637,19460,19300,20433,973,5.0,20276,816,4.19,19001,20433,1399-6-19
22,بپيوند,برق و انرژي پيوندگستر پارس,21154,2700442,61364844008,21642,22724,22724,1082,5.0,22723,1081,4.99,22724,22724,1399-6-19
23,فخوز,فولاد  خوزستان,17296,58984588,2682026297580,46020,43720,47700,1680,3.65,45470,-550,-1.2,43720,48110,1399-6-19
24,بجهرم,توسعه مولد نيروگاهي جهرم,17012,127910120,567666943054,4583,4354,4580,-3,-0.07,4438,-145,-3.16,4354,4583,1399-6-19
25,فارس,صنايع پتروشيمي خليج فارس,14979,40533248,1041612003830,25840,24550,26890,1050,4.06,25700,-140,-0.54,24550,26920,1399-6-19
26,چكاپا,گروه صنايع كاغذ پارس,13825,141971639,1305351729640,8860,8650,9300,440,4.97,9190,330,3.72,8650,9300,1399-6-19
27,اخابر,مخابرات ايران,11261,79271446,1490488399050,19590,18620,19030,-560,-2.86,18800,-790,-4.03,18620,19600,1399-6-19
28,وبانك,سرمايه گذاري گروه توسعه ملي,11040,70996877,1247173600540,18250,17340,18300,50,0.27,17570,-680,-3.73,17340,18530,1399-6-19
29,وخارزم,سرمايه گذاري خوارزمي,10375,128349577,1498224239160,12270,11660,11660,-610,-4.97,11670,-600,-4.89,11660,11870,1399-6-19
30,ونوين,بانك‌اقتصادنوين‌,9102,209568028,899309170820,4500,4280,4300,-200,-4.44,4290,-210,-4.67,4280,4400,1399-6-19
31,ومعادن,توسعه‌معادن‌وفلزات‌,8198,90789343,1373746328470,14970,14230,15710,740,4.94,15130,160,1.07,14230,15710,1399-6-19
32,ثاخت,بين‌المللي‌توسعه‌ساختمان,8129,59410317,309749839920,5590,5210,5310,-280,-5.01,5210,-380,-6.8,4950,5470,1399-6-19
33,غگيلا,شيرپاستوريزه پگاه گيلان,8073,128087,2034661995,15129,15885,15885,756,5.0,15158,29,0.19,15885,15885,1399-6-19
34,بترانس,ايران‌ ترانسفو,7504,14116700,618329009920,45830,43540,43990,-1840,-4.01,43800,-2030,-4.43,43540,45600,1399-6-19
35,فروي,ذوب روي اصفهان,7462,9978215,611991720292,64199,60990,61900,-2299,-3.58,61333,-2866,-4.46,60990,63900,1399-6-19
36,وصنعت,سرمايه گذاري توسعه صنعت وتجارت,6993,42277807,400371518330,9900,9410,9740,-160,-1.62,9470,-430,-4.34,9410,9800,1399-6-19
37,شيران,س. صنايع‌شيميايي‌ايران,6832,25387724,885375091900,36360,34550,35300,-1060,-2.92,34870,-1490,-4.1,34550,36200,1399-6-19
38,وپاسار,بانك  پاسارگاد,6735,79604973,776288503750,10010,9510,10150,140,1.4,9750,-260,-2.6,9510,10200,1399-6-19
39,پارسان,گسترش نفت و گاز پارسيان,6640,41913796,1039774878530,24930,23690,26170,1240,4.97,24810,-120,-0.48,23690,26170,1399-6-19
40,وسينا,بانك سينا,6389,90572760,1133717561240,13160,12510,12510,-650,-4.94,12520,-640,-4.86,12510,12720,1399-6-19
41,كاما,باما,6355,5836299,1090782563800,195900,186110,186400,-9500,-4.85,186900,-9000,-4.59,186110,195000,1399-6-19
42,ومهان,گروه توسعه مالي مهر آيندگان,6261,22443162,365180230186,16706,15871,16800,94,0.56,16271,-435,-2.6,15871,17250,1399-6-19
43,تماوند,تامين سرمايه دماوند,6215,117393214,1623635924305,14506,13781,13800,-706,-4.87,13831,-675,-4.65,13781,14500,1399-6-19
44,دي,بانك دي,5739,17122485,734486116560,45153,42896,42896,-2257,-5.0,42896,-2257,-5.0,42896,42896,1399-6-19
45,غسالم,سالمين‌,5728,27820105,160970468700,6070,5770,5770,-300,-4.94,5790,-280,-4.61,5770,5950,1399-6-19
46,كگل,معدني و صنعتي گل گهر,5435,29783325,592056825370,19080,18710,20030,950,4.98,19880,800,4.19,18710,20030,1399-6-19
47,دماوند,توليد نيروي برق دماوند,5349,7252703,406463856713,53900,53000,56595,2695,5.0,56043,2143,3.98,52997,56595,1399-6-19
48,ارزش,صندوق س ارزش آفرين بيدار-سهام,5279,35272408,377847013360,10080,9970,11080,1000,9.92,10710,630,6.25,9910,11080,1399-6-19
49,ماديرا,صنايع ماشين هاي اداري ايران,5158,15198061,660334741333,45610,43330,43330,-2280,-5.0,43449,-2161,-4.74,43330,44470,1399-6-19
50,ثاختح,ح . بين‌المللي‌توسعه‌ساختمان,5081,88959933,318137773330,3480,3770,3610,130,3.74,3580,100,2.87,3420,3850,1399-6-19
51,كويرح,ح. توليدي فولاد سپيد فراب كوير,5051,26028062,273942156250,10290,9550,11090,800,7.77,10520,230,2.24,9350,11250,1399-6-19
52,وملل,اعتباري ملل,4985,68941330,1026864329759,15461,14688,15200,-261,-1.69,14895,-566,-3.66,14688,15425,1399-6-19
53,ونيكي,سرمايه‌گذاري‌ ملي‌ايران‌,4973,17531048,746828680240,44640,42410,42410,-2230,-5.0,42600,-2040,-4.57,42410,43900,1399-6-19
54,شصدف,صنعتي دوده فام,4887,190131,3710596596,18587,19516,19516,929,5.0,18650,63,0.34,19516,19516,1399-6-19
55,زكوثر,سرمايه گذاري كشاورزي كوثر,4875,9018083,212043574250,24560,23340,23980,-580,-2.36,23510,-1050,-4.28,23340,24550,1399-6-19
56,ارفع,شركت آهن و فولاد ارفع,4785,20310405,302227045356,15387,14618,15700,313,2.03,14880,-507,-3.29,14618,15727,1399-6-19
57,كچاد,معدني‌وصنعتي‌چادرملو,4697,28104894,473008553090,16350,15650,17160,810,4.95,16830,480,2.94,15650,17160,1399-6-19
58,سمگا,گروه سرمايه گذاري ميراث فرهنگي,4569,13899548,233028188515,16448,15850,17130,682,4.15,16765,317,1.93,15802,17200,1399-6-19
59,رمپنا,گروه مپنا (سهامي عام),4412,30383349,965873916380,33380,31720,31840,-1540,-4.61,31790,-1590,-4.76,31720,32700,1399-6-19
60,همراه,شركت ارتباطات سيار ايران,4359,11172747,487665901190,45790,43510,44000,-1790,-3.91,43650,-2140,-4.67,43510,44910,1399-6-19
61,قرن,پديده شيمي قرن,4128,2505442,127650300960,49960,48200,52440,2480,4.96,50950,990,1.98,48000,52450,1399-6-19
62,طلا,صندوق س.پشتوانه طلاي لوتوس,4112,3148515,385169100077,125663,128900,122000,-3663,-2.91,122334,-3329,-2.65,117000,128900,1399-6-19
63,شسپا,نفت سپاهان,4096,18325334,376058790390,21470,20400,21100,-370,-1.72,20520,-950,-4.42,20400,21430,1399-6-19
64,بكهنوج,توليد برق ماهتاب كهنوج,3975,5925530,434932259576,76400,72580,75548,-852,-1.12,73400,-3000,-3.93,72580,77418,1399-6-19
65,كمند,صندوق س. با درآمد ثابت كمند,3743,287039449,2895417914260,10130,10140,10100,-30,-0.3,10090,-40,-0.39,10070,10150,1399-6-19
66,هرمز,فولاد هرمزگان جنوب,3736,22397772,255348442691,11581,11002,11880,299,2.58,11401,-180,-1.55,11002,12044,1399-6-19
67,پتاير,ايران‌ تاير,3713,5945206,657321549610,106100,103500,111400,5300,5.0,110560,4460,4.2,100870,111400,1399-6-19
68,وسپه,سرمايه‌گذاري‌ سپه‌,3685,19070003,288364474420,15100,14350,15850,750,4.97,15120,20,0.13,14350,15850,1399-6-19
69,نوري,پتروشيمي نوري,3667,3456897,563201783380,156580,151000,164400,7820,4.99,162920,6340,4.05,151000,164400,1399-6-19
70,تاصيكو,سرمايه گذاري صدرتامين,3642,39164649,478087678870,12640,12010,12460,-180,-1.42,12210,-430,-3.4,12010,12700,1399-6-19
71,كاوه,فولاد كاوه جنوب كيش,3586,47747526,928667366040,18700,18600,19630,930,4.97,19450,750,4.01,18320,19630,1399-6-19
72,وهور,مديريت انرژي اميد  تابان هور,3464,14519685,653845467755,46727,44391,46600,-127,-0.27,45032,-1695,-3.63,44391,46900,1399-6-19
73,خگستر,گسترش‌سرمايه‌گذاري‌ايران‌خودرو,3357,14759062,95786312380,6830,6490,6490,-340,-4.98,6510,-320,-4.69,6490,6490,1399-6-19
74,بركت,گروه دارويي بركت,3321,25728270,560361720600,22920,21780,21780,-1140,-4.97,21780,-1140,-4.97,21780,21780,1399-6-19
75,حريل,ريل پردازسير,3312,25653669,127619847683,5215,4955,4955,-260,-4.99,4975,-240,-4.6,4955,5189,1399-6-19
76,والبر,سرمايه‌ گذاري‌ البرز(هلدينگ‌,3196,10201067,180853956810,18160,17260,18250,90,0.5,17730,-430,-2.37,17260,19000,1399-6-19
77,فرابورس,فرابورس ايران,3156,5106510,223673622179,46025,43724,43800,-2225,-4.83,43802,-2223,-4.83,43724,45600,1399-6-19
78,قثابت,قند ثابت‌ خراسان‌,3089,3405923,349120741120,107680,102300,102550,-5130,-4.76,102500,-5180,-4.81,102300,107590,1399-6-19
79,كدماح,ح . معدني‌ دماوند,2962,5506852,411141983410,71370,67300,78510,7140,10.0,74660,3290,4.61,67300,78510,1399-6-19
80,ونفت,سرمايه‌گذاري‌ صنعت‌ نفت‌,2948,12743542,179682204350,14820,14080,14100,-720,-4.86,14100,-720,-4.86,14080,14480,1399-6-19
81,فاسمين,كالسيمين‌,2875,11418465,682189836530,62830,59690,59690,-3140,-5.0,59740,-3090,-4.92,59690,61500,1399-6-19
82,البرز,بيمه البرز,2850,34161367,500573457590,15390,14630,14750,-640,-4.16,14650,-740,-4.81,14630,15380,1399-6-19
83,ولصنم,ليزينگ‌صنعت‌ومعدن‌,2792,25973428,309960573560,12490,11870,12040,-450,-3.6,11930,-560,-4.48,11870,12670,1399-6-19
84,سفارس,سيمان فارس و خوزستان,2788,17800054,317377612590,18680,17750,18100,-580,-3.1,17830,-850,-4.55,17750,18350,1399-6-19
85,سرو,صندوق س سروسودمند مدبران-سهام,2787,4694614,300073256260,59050,58000,64950,5900,9.99,63920,4870,8.25,58000,64950,1399-6-19
86,تليسه,دامداري تليسه نمونه,2722,1745980,131414724131,77724,73838,76940,-784,-1.01,75267,-2457,-3.16,73838,77550,1399-6-19
87,بزاگرسح,ح . نيروگاه زاگرس كوثر,2653,18407066,158383041058,8989,8540,8650,-339,-3.77,8604,-385,-4.28,8540,8980,1399-6-19
88,امين يكم,صندوق درآمد ثابت امين يكم فردا,2641,89711108,952817034470,10650,10650,10640,-10,-0.09,10620,-30,-0.28,10600,10660,1399-6-19
89,وسكاب,س.ص.بازنشستگي كاركنان بانكها,2625,25203618,177527855970,7250,6890,7260,10,0.14,7040,-210,-2.9,6890,7440,1399-6-19
90,فسازان,غلتك سازان سپاهان,2604,9491509,350775634030,38630,36700,37210,-1420,-3.68,36960,-1670,-4.32,36700,38740,1399-6-19
91,رانفور,خدمات‌انفورماتيك‌,2602,8834548,266462207570,31370,29810,30500,-870,-2.77,30160,-1210,-3.86,29810,31900,1399-6-19
92,شپديس,پتروشيمي پرديس,2564,7695952,795579614750,104870,99630,107900,3030,2.89,103380,-1490,-1.42,99630,109600,1399-6-19
93,آپ,آسان پرداخت پرشين,2515,7660171,152049465020,20400,19380,20620,220,1.08,19850,-550,-2.7,19380,21250,1399-6-19
94,كلر,كلر پارس,2502,1157824,83378054375,75284,71520,71520,-3764,-5.0,72013,-3271,-4.34,71520,75046,1399-6-19
95,تنوين,تامين سرمايه نوين,2491,15442854,156419115520,10060,9560,10560,500,4.97,10130,70,0.7,9560,10560,1399-6-19
96,ثنظام,س. ساختماني نظام مهندسي ايران,2446,3795221,209458926263,55779,58565,53640,-2139,-3.83,55190,-589,-1.06,52991,58565,1399-6-19
97,وساخت,سرمايه‌ گذاري‌ ساختمان‌ايران‌,2373,7392140,337186816320,45480,43210,46170,690,1.52,45610,130,0.29,43210,47600,1399-6-19
98,شبهرن,نفت‌ بهران‌,2349,4962628,351059337930,74370,70660,70660,-3710,-4.99,70740,-3630,-4.88,70660,72500,1399-6-19
99,وخاور,بانك خاورميانه,2305,15882533,160607250030,9720,9700,10200,480,4.94,10110,390,4.01,9700,10200,1399-6-19
100,كرازي,كارخانجات‌توليدي‌شيشه‌رازي‌,2273,12515726,252213686180,20800,19760,20700,-100,-0.48,20150,-650,-3.13,19760,21000,1399-6-19
101,رتاپ,تجارت الكترونيك  پارسيان,2270,7014621,79141053780,11510,10940,11720,210,1.82,11280,-230,-2.0,10940,11920,1399-6-19
102,ارفعح,ح.شركت آهن و فولاد ارفع,2259,4190596,45491927131,10378,10090,10896,518,4.99,10856,478,4.61,10090,10896,1399-6-19
103,عيار,صندوق س. پشتوانه طلاي مفيد,2222,2805125,110093566769,39207,40909,38960,-247,-0.63,39247,40,0.1,38450,40950,1399-6-19
104,اطلس,صندوق س.توسعه اندوخته آينده-س,2221,728898,137100991137,182208,178900,193820,11612,6.37,188094,5886,3.23,175000,194000,1399-6-19
105,واميد,گروه مديريت سرمايه گذاري اميد,2212,6819403,278497847780,40530,38510,41780,1250,3.08,40840,310,0.76,38510,42030,1399-6-19
106,شپلي,پلي اكريل ايران,2198,28657844,272652206378,10010,9510,9510,-500,-5.0,9514,-496,-4.96,9510,9690,1399-6-19
107,حكشتي,كشتيراني جمهوري اسلامي ايران,2166,1486606,76277753860,54010,51310,51310,-2700,-5.0,51980,-2030,-3.76,51310,51310,1399-6-19
108,وتوكا,سرمايه‌گذاري‌توكافولاد(هلدينگ,2157,16479500,182930200780,11460,10890,11690,230,2.01,11100,-360,-3.14,10890,11770,1399-6-19
109,وبشهر,توسعه‌ صنايع‌ بهشهر(هلدينگ,2157,15929183,250060341660,16430,15610,16070,-360,-2.19,15700,-730,-4.44,15610,16490,1399-6-19
110,شكلر,نيروكلر,2156,3696473,171410579140,46150,43850,47950,1800,3.9,46370,220,0.48,43850,48450,1399-6-19
111,دتمادح,ح . توليدمواداوليه‌داروپخش‌,2065,1715807,56904066605,7405,35700,33250,25845,349.02,33165,25760,347.87,32200,36100,1399-6-19
112,ختوقا,قطعات‌ اتومبيل‌ ايران‌,2058,12054200,57257450000,5000,4750,4750,-250,-5.0,4750,-250,-5.0,4750,4750,1399-6-19
113,تاصيكوح,ح . سرمايه گذاري صدرتامين,2056,15495429,149772724530,9190,8600,10110,920,10.01,9670,480,5.22,8600,10110,1399-6-19
114,كبافق,معادن‌ بافق‌,2056,2165511,83144669620,40180,38180,38270,-1910,-4.75,38390,-1790,-4.45,38180,39800,1399-6-19
115,سرچشمه,سرمايه گذاري مس سرچشمه,2037,14965094,134803303105,9400,8930,9140,-260,-2.77,9008,-392,-4.17,8930,9400,1399-6-19
116,وصندوق,سرمايه‌گذاري‌صندوق‌بازنشستگي‌,1968,22279566,371260873280,17270,16410,17040,-230,-1.33,16660,-610,-3.53,16410,17500,1399-6-19
117,وسبحان,سرمايه گذاري سبحان,1956,14475106,137375138144,9149,9030,9606,457,5.0,9490,341,3.73,9000,9606,1399-6-19
118,ختورح,ح . رادياتور ايران‌,1941,4618585,97541285830,19950,18180,21950,2000,10.03,21120,1170,5.86,18180,21950,1399-6-19
119,آوا,صندوق س.سهام آواي معيار-س,1940,16500045,145042688315,8271,8030,9290,1019,12.32,8790,519,6.27,8022,9290,1399-6-19
120,شاراك,پتروشيمي شازند,1932,7389484,164826319280,21440,20500,22510,1070,4.99,22310,870,4.06,20500,22510,1399-6-19
121,كنور,توسعه معدني و صنعتي صبانور,1926,3412781,144779481490,43060,40910,44000,940,2.18,42420,-640,-1.49,40910,44800,1399-6-19
122,سدبير,س. تدبيرگران فارس وخوزستان,1907,9351873,251661464112,28115,26710,27150,-965,-3.43,26910,-1205,-4.29,26710,28400,1399-6-19
123,وتوكاح,ح . ‌توكافولاد(هلدينگ‌,1874,6576008,54534424354,7905,7370,8700,795,10.06,8293,388,4.91,7370,8700,1399-6-19
124,وايران,ليزينگ ايرانيان,1846,10276103,130095050830,13290,12630,12680,-610,-4.59,12660,-630,-4.74,12630,13000,1399-6-19
125,وتوسم,سرمايه‌گذاري‌توسعه‌ملي‌,1844,7993162,97487382990,12590,11970,12550,-40,-0.32,12200,-390,-3.1,11970,12680,1399-6-19
126,سيمرغ,سيمرغ,1842,4340535,84990367940,20300,19290,19590,-710,-3.5,19580,-720,-3.55,19290,20770,1399-6-19
127,آتيمس,صندوق س.آرمان آتيه درخشان مس-س,1816,572235,136979714902,222077,217990,251999,29922,13.47,239377,17300,7.79,202000,251999,1399-6-19
128,كگهر,سنگ آهن گهرزمين,1786,2818240,123637146856,44028,41827,45800,1772,4.02,43870,-158,-0.36,41827,45900,1399-6-19
129,ودي,بيمه  دي,1780,15956993,370863970622,24438,23217,23217,-1221,-5.0,23241,-1197,-4.9,23217,23950,1399-6-19
130,شپاكسا,پاكسان‌,1743,6439280,184682979420,29800,28310,29800,0,0.0,28680,-1120,-3.76,28310,29980,1399-6-19
131,آسيا,بيمه آسيا,1738,6474450,189134878660,30710,29180,29220,-1490,-4.85,29210,-1500,-4.88,29180,29900,1399-6-19
132,وآوا,سرمايه گذاري آوا نوين,1725,4612965,66209317933,14944,14197,14300,-644,-4.31,14353,-591,-3.95,14197,14930,1399-6-19
133,سپ,پرداخت الكترونيك سامان كيش,1680,3528970,81718397950,23970,23050,23590,-380,-1.59,23160,-810,-3.38,22780,23940,1399-6-19
134,فجر,فولاد اميركبيركاشان,1663,3411293,173990090480,51770,49190,53520,1750,3.38,51000,-770,-1.49,49190,53660,1399-6-19
135,وزمين,بانك ايران زمين,1655,27289227,524662987519,20003,19203,19400,-603,-3.01,19226,-777,-3.88,19203,19603,1399-6-19
136,چكارن,كارتن‌ ايران‌,1651,7995781,43656964260,5740,5460,5460,-280,-4.88,5460,-280,-4.88,5460,5460,1399-6-19
137,فولاژ,فولاد آلياژي ايران,1615,3811617,97681039940,26330,25020,26720,390,1.48,25630,-700,-2.66,25020,27150,1399-6-19
138,كاردان,صندوق س تجارت شاخصي كاردان,1612,1053012,188898303310,172290,170000,187990,15700,9.11,179390,7100,4.12,160000,188610,1399-6-19
139,پاكشو,گروه صنعتي پاكشو,1592,4811593,291497417200,57820,58410,60710,2890,5.0,60580,2760,4.77,58410,60710,1399-6-19
140,ريشمك,توليد و صادرات ريشمك,1589,5822856,192820055806,34567,32839,33750,-817,-2.36,33114,-1453,-4.2,32839,34220,1399-6-19
141,وسين,بيمه سينا,1556,12920366,290359639188,21704,22700,22789,1085,5.0,22473,769,3.54,21000,22789,1399-6-19
142,تسه9905,امتياز تسهيلات مسكن مرداد99,1554,72661,54023052593,774564,745000,735836,-38728,-5.0,743494,-31070,-4.01,735836,753999,1399-6-19
143,شخارك,پتروشيمي‌ خارك‌,1518,2325237,94783061480,39480,39000,41450,1970,4.99,40720,1240,3.14,39000,41450,1399-6-19
144,فيروزه,صندوق شاخص30 شركت فيروزه- سهام,1517,1169570,219354811770,179670,170000,195000,15330,8.53,187550,7880,4.39,168200,195600,1399-6-19
145,دتوزيع,توزيع دارو پخش,1515,977892,56749179505,60627,57596,58500,-2127,-3.51,58032,-2595,-4.28,57596,60600,1399-6-19
146,فزرين,زرين معدن آسيا,1500,5192892,102279650052,20675,19642,19720,-955,-4.62,19696,-979,-4.74,19642,20332,1399-6-19
147,تاپكيش,تجارت الكترونيك پارسيان كيش,1458,2309621,79875227848,34294,32580,36008,1714,5.0,34584,290,0.85,32580,36008,1399-6-19
148,تيپيكو,سرمايه گذاري دارويي تامين,1421,1815129,88333064020,49120,46670,50980,1860,3.79,48660,-460,-0.94,46670,51360,1399-6-19
149,فباهنر,مس‌ شهيدباهنر,1404,2571175,140753942650,57210,54350,55600,-1610,-2.81,54740,-2470,-4.32,54350,57470,1399-6-19
150,مبين,مبين انرژي خليج فارس,1402,7882029,190953811100,23300,22440,24460,1160,4.98,24230,930,3.99,22440,24460,1399-6-19
151,شغدير,پتروشيمي غدير,1402,5058940,188538556304,35818,35818,37608,1790,5.0,37268,1450,4.05,35818,37608,1399-6-19
152,كاريس,صندوق س.سپهر كاريزما-س,1386,2578158,542773925597,189695,197000,215000,25305,13.34,210528,20833,10.98,195510,216998,1399-6-19
153,غگل,گلوكوزان‌,1368,5581564,41471020520,7820,7430,7430,-390,-4.99,7430,-390,-4.99,7430,7430,1399-6-19
154,گكوثر,هتل پارسيان كوثر اصفهان,1361,1440933,308207290414,224939,213693,213693,-11246,-5.0,213894,-11045,-4.91,213693,223000,1399-6-19
155,اعتلاح,ح سرمايه گذاري اعتلاء البرز,1344,3162495,24030665789,7686,7302,7700,14,0.18,7599,-87,-1.13,7302,8040,1399-6-19
156,وپست,پست بانك ايران,1341,7772673,97965184870,13240,12580,12650,-590,-4.46,12600,-640,-4.83,12580,12890,1399-6-19
157,لوتوس,تامين سرمايه لوتوس پارسيان,1336,8053841,121886319300,15810,15020,15320,-490,-3.1,15130,-680,-4.3,15020,16600,1399-6-19
158,كهمدا,شيشه‌ همدان‌,1334,3393579,82636321340,25180,23930,24890,-290,-1.15,24350,-830,-3.3,23930,26390,1399-6-19
159,جم,پتروشيمي جم,1323,5845040,226475010270,37340,36100,39200,1860,4.98,38750,1410,3.78,36100,39200,1399-6-19
160,ميدكو,هلدينگ صنايع  معدني خاورميانه,1299,23335176,490700054165,22045,20943,21550,-495,-2.25,21028,-1017,-4.61,20943,22090,1399-6-19
161,پارس,پتروشيمي پارس,1296,1775108,253481392590,136460,136000,143280,6820,5.0,142800,6340,4.65,135980,143280,1399-6-19
162,دفارا,داروسازي‌ فارابي‌,1278,1471416,91591313080,62700,59570,65000,2300,3.67,62250,-450,-0.72,59570,65830,1399-6-19
163,سيدكو,سرمايه گذاري توسعه صنايع سيمان,1273,7914671,59087809070,7760,7460,7590,-170,-2.19,7470,-290,-3.74,7380,7760,1399-6-19
164,واحيا,م .صنايع و معادن احياء سپاهان,1228,2677522,581302002533,223471,216767,222000,-1471,-0.66,217104,-6367,-2.85,216767,222900,1399-6-19
165,شوينده,مديريت صنعت شوينده ت.ص.بهشهر,1224,2117398,73410555520,35630,33850,36050,420,1.18,34670,-960,-2.69,33850,36530,1399-6-19
166,افق ملت,صندوق س در سهام افق ملت,1210,568948,83312832230,138940,132000,150000,11060,7.96,146430,7490,5.39,132000,151000,1399-6-19
167,اعتماد,صندوق س.اعتماد آفرين پارسيان-د,1160,27987140,903044587620,32261,32277,32266,5,0.02,32266,5,0.02,32265,32283,1399-6-19
168,فخاس,فولاد خراسان,1145,3353679,119393668030,36340,34530,37300,960,2.64,35600,-740,-2.04,34530,38150,1399-6-19
169,بموتو,موتوژن‌,1142,1838895,83798165460,46360,44050,46390,30,0.06,45570,-790,-1.7,44050,47400,1399-6-19
170,غبشهر,صنعتي‌ بهشهر,1131,5392731,115166076300,22130,21030,22200,70,0.32,21360,-770,-3.48,21030,22560,1399-6-19
171,فخاسح,ح . فولاد خراسان,1130,2831663,79521378310,27460,24710,29950,2490,9.07,28080,620,2.26,24710,30190,1399-6-19
172,شنفت,نفت‌ پارس‌,1108,1068505,68816729720,64350,61140,67560,3210,4.99,64400,50,0.08,61140,67560,1399-6-19
173,شپارسح,ح . بين‌ المللي‌محصولات پارس‌,1099,2952086,34006671732,10642,11100,11710,1068,10.04,11520,878,8.25,10780,11710,1399-6-19
174,غشهداب,كشت و صنعت شهداب ناب خراسان,1075,5198915,33137884210,6709,6374,6374,-335,-4.99,6485,-224,-3.34,6374,6374,1399-6-19
175,شيراز,پتروشيمي‌شيراز,1062,5094128,301305922060,57680,54800,60560,2880,4.99,59150,1470,2.55,54800,60560,1399-6-19
176,پكرمان,گروه‌ صنعتي‌ بارز,1057,2738575,56645508020,20940,19900,21500,560,2.67,20680,-260,-1.24,19900,21980,1399-6-19
177,دعبيد,لابراتوارداروسازي‌  دكترعبيدي‌,1051,1044366,34761453100,34450,32730,33500,-950,-2.76,33770,-680,-1.97,32730,36160,1399-6-19
178,شساخت,مهندسي و ساختمان صنايع نفت,1049,1980477,83590424643,43324,41158,44200,876,2.02,42207,-1117,-2.58,41158,44663,1399-6-19
179,زر,صندوق س.پشتوانه سكه طلاي زر,1032,957584,63381044900,66171,68677,66301,130,0.2,66188,17,0.03,64000,68700,1399-6-19
180,خودكفا,اقتصادي و خودكفايي آزادگان,1027,463966,65472562090,145479,141115,141115,-4364,-3.0,141115,-4364,-3.0,141115,141115,1399-6-19
181,كيميا,معدني كيمياي زنجان گستران,1022,1500292,49541497623,34694,32960,32960,-1734,-5.0,33021,-1673,-4.82,32960,34000,1399-6-19
182,فروس,فروسيليس‌ ايران‌,1018,2137440,55207655010,27160,25810,25810,-1350,-4.97,25830,-1330,-4.9,25810,26400,1399-6-19
183,خپارس,پارس‌ خودرو,1013,3551891,39674622470,11750,11170,11170,-580,-4.94,11520,-230,-1.96,11170,11170,1399-6-19
184,غدام,خوراك‌  دام‌ پارس‌,1009,589857,71410677600,126430,120110,120110,-6320,-5.0,121060,-5370,-4.25,120110,126500,1399-6-19
185,مفاخر,توسعه فناوري اطلاعات خوارزمي,1004,1797895,84036217117,45600,45000,47880,2280,5.0,46741,1141,2.5,43330,47880,1399-6-19
186,بنو,بيمه تجارت نو,992,6756815,146825929119,20882,21500,21926,1044,5.0,21730,848,4.06,20882,21926,1399-6-19
187,سجام,مجتمع سيمان غرب آسيا,977,6463782,85986141106,13225,13225,13700,475,3.59,13303,78,0.59,13225,13886,1399-6-19
188,سخوز,سيمان خوزستان,977,11155004,193438799560,17010,16610,17860,850,5.0,17340,330,1.94,16610,17860,1399-6-19
189,ساروم,سيمان‌اروميه‌,974,2269003,55635380860,24930,23690,24980,50,0.2,24520,-410,-1.64,23690,25900,1399-6-19
190,زفكا,كشت و دامداري فكا,970,901507,34122427042,39317,37360,38000,-1317,-3.35,38130,-1187,-3.02,37352,38950,1399-6-19
191,گوهران,سرمايه گذاري توسعه گوهران اميد,965,4227165,41443407606,10129,9623,9990,-139,-1.37,9861,-268,-2.65,9623,10195,1399-6-19
192,قنيشا,قند  نيشابور,950,3886337,409750500590,110720,105190,110000,-720,-0.65,105430,-5290,-4.78,105190,114500,1399-6-19
193,ثشرقح,ح. سرمايه گذاري مسكن شمال شرق,949,2341714,11422276700,4580,4580,5040,460,10.04,4880,300,6.55,4580,5040,1399-6-19
194,حپارسا,توسعه حمل و نقل ريلي پارسيان,927,1974452,71449885514,37499,35625,36420,-1079,-2.88,36187,-1312,-3.5,35625,39373,1399-6-19
195,فايرا,آلومينيوم‌ايران‌,920,3474218,67625522070,20350,19340,19340,-1010,-4.96,19460,-890,-4.37,19340,21000,1399-6-19
196,زاگرس,پتروشيمي زاگرس,911,1958372,279641679455,136161,141800,142969,6808,5.0,142793,6632,4.87,139000,142969,1399-6-19
197,شفن,پتروشيمي فناوران,898,595525,144306781960,234840,223100,246580,11740,5.0,242320,7480,3.19,223100,246580,1399-6-19
198,شگل,گلتاش‌,895,1920316,54929005600,28810,27370,29420,610,2.12,28600,-210,-0.73,27370,29900,1399-6-19
199,خمحركه,نيرو محركه‌,891,2217552,23328647040,11070,10520,10520,-550,-4.97,10770,-300,-2.71,10520,10520,1399-6-19
200,وپترو,سرمايه‌گذاري صنايع پتروشيمي‌,878,5860914,95904606480,17220,16360,16430,-790,-4.59,16360,-860,-4.99,16360,16530,1399-6-19
201,لوتوسح,ح . تامين سرمايه لوتوس پارسيان,872,3513038,37340013340,10670,9600,10900,230,2.16,10630,-40,-0.37,9600,11200,1399-6-19
202,ثپرديسح,ح.سرمايه گذاري مسكن پرديس,871,2574101,20771539976,8249,7837,8110,-139,-1.69,8069,-180,-2.18,7837,8661,1399-6-19
203,خراسان,پتروشيمي خراسان,867,1755773,131729655100,76950,73110,78450,1500,1.95,75030,-1920,-2.5,73110,79000,1399-6-19
204,پرديس,سرمايه گذاري پرديس,854,5287675,48911254020,9730,9250,9260,-470,-4.83,9250,-480,-4.93,9250,9260,1399-6-19
205,بفجر,فجر انرژي خليج فارس,843,3704045,94078412770,24530,23550,25750,1220,4.97,25400,870,3.55,23550,25750,1399-6-19
206,واتي,سرمايه‌ گذاري‌ آتيه‌ دماوند,830,7521550,107544605380,15040,14290,14290,-750,-4.99,14300,-740,-4.92,14290,14750,1399-6-19
207,گوهر,صندوق سكه طلاي كيان,820,922848,68559675615,74507,76000,75149,642,0.86,74291,-216,-0.29,71020,78000,1399-6-19
208,شرانل,نفت ايرانول,815,1795442,46600547605,26960,25612,26130,-830,-3.08,25958,-1002,-3.72,25612,26995,1399-6-19
209,جم پيلن,پلي پروپيلن جم - جم پيلن,814,1099540,85950829610,74950,71610,78690,3740,4.99,78170,3220,4.3,71610,78690,1399-6-19
210,كرماشا,صنايع پتروشيمي كرمانشاه,812,2588245,99204424430,36840,35400,38680,1840,4.99,38330,1490,4.04,35400,38680,1399-6-19
211,دتماد,توليدمواداوليه‌داروپخش‌,807,1334913,52672921740,40850,38810,38810,-2040,-4.99,39460,-1390,-3.4,38810,42580,1399-6-19
212,ما,بيمه  ما,781,8206676,58350424320,7480,7110,7120,-360,-4.81,7110,-370,-4.95,7110,7130,1399-6-19
213,كرمان,س. توسعه و عمران استان كرمان,771,522587,51490497110,103715,98530,98530,-5185,-5.0,98530,-5185,-5.0,98530,98530,1399-6-19
214,پارند,صندوق س. پارند پايدار سپهر,771,16891960,198948421990,11780,11800,11810,30,0.25,11780,0,0.0,11710,11830,1399-6-19
215,وپويا,سرمايه گذاري پويا,767,1041088,14060934528,14216,13506,13506,-710,-4.99,13998,-218,-1.53,13506,13506,1399-6-19
216,سباقر,سيمان باقران,755,2458696,38323107623,15262,14950,15719,457,2.99,15587,325,2.13,14950,15719,1399-6-19
217,كسرام,پارس‌ سرام‌,749,290256,32427400320,117600,111720,111720,-5880,-5.0,113510,-4090,-3.48,111720,111720,1399-6-19
218,بكاب,صنايع‌جوشكاب‌يزد,742,304452,39268237530,134750,128020,129900,-4850,-3.6,130080,-4670,-3.47,128020,134750,1399-6-19
219,ولساپا,ليزينگ رايان‌ سايپا,731,3965998,20742169540,5500,5230,5230,-270,-4.91,5370,-130,-2.36,5230,5230,1399-6-19
220,ثشاهد,سرمايه‌ گذاري‌ شاهد,717,449906,25055265140,58620,55690,55690,-2930,-5.0,57800,-820,-1.4,55690,55690,1399-6-19
221,دامين,داروسازي‌ امين‌,712,2564086,36457812100,14950,14210,14230,-720,-4.82,14360,-590,-3.95,14210,14500,1399-6-19
222,كفرآور,فرآورده هاي سيمان شرق,710,4692328,89978554464,18620,19177,19178,558,3.0,19176,556,2.99,19010,19178,1399-6-19
223,بكام,كارخانجات توليدي شهيد قندي,701,2724080,21956084800,8480,8060,8060,-420,-4.95,8270,-210,-2.48,8060,8060,1399-6-19
224,غپينو,پارس‌ مينو,699,3723698,25805227140,7290,6930,6930,-360,-4.94,7080,-210,-2.88,6930,6930,1399-6-19
225,وآرين,شركت توسعه اقتصادي آرين,699,9729681,55434627251,5982,5683,5805,-177,-2.96,5697,-285,-4.76,5683,5900,1399-6-19
226,بخاور,بيمه زندگي خاورميانه,696,4805814,38838284267,8413,7993,8002,-411,-4.89,8163,-250,-2.97,7993,8387,1399-6-19
227,حتوكا,حمل‌ونقل‌توكا,690,3765589,69821284750,19360,18400,19200,-160,-0.83,18540,-820,-4.24,18400,19250,1399-6-19
228,آساس,صندوق س.آسمان آرماني سهام-س,680,448737,68519682031,145151,140000,157220,12069,8.31,152695,7544,5.2,137799,158999,1399-6-19
229,قجام,فرآوردههاي غذايي وقندتربت‌جام‌,676,2473980,55534892831,23095,22403,22403,-692,-3.0,22448,-647,-2.8,22403,23400,1399-6-19
230,ثقزوي,شركت عمران و سازندگي قزوين,672,3956576,70626822126,18345,17795,17800,-545,-2.97,17850,-495,-2.7,17795,18345,1399-6-19
231,سهگمت,سيمان‌هگمتان‌,661,2249312,39648402430,18260,17360,18290,30,0.16,17650,-610,-3.34,17350,18800,1399-6-19
232,بميلا,توسعه بازرگاني آهن وفولادميلاد,658,4971467,192997646221,40440,38418,40000,-440,-1.09,38821,-1619,-4.0,38418,40600,1399-6-19
233,شسينا,صنايع‌شيميايي‌سينا,655,65261,29440778410,451160,428630,458900,7740,1.72,451140,-20,0.0,428630,467970,1399-6-19
234,دسانكو,داروسازي سبحان انكولوژي,651,1926564,37627790059,20557,19530,19675,-882,-4.29,19669,-888,-4.32,19530,19675,1399-6-19
235,دالبر,البرزدارو,648,1355406,28755814040,22270,21160,21190,-1080,-4.85,21600,-670,-3.01,21160,22000,1399-6-19
236,شبصير,توليدات پتروشيمي قائد بصير,627,986755,117938178549,125664,119381,119381,-6283,-5.0,119521,-6143,-4.89,119381,124000,1399-6-19
237,فاراك,ماشين‌ سازي‌ اراك‌,626,2531597,30201952210,12550,11930,11930,-620,-4.94,12120,-430,-3.43,11930,11930,1399-6-19
238,غشوكوح,ح . شوكو پارس,621,1193306,25709369669,21793,20704,20705,-1088,-4.99,21545,-248,-1.14,20704,22860,1399-6-19
239,تسه9904,امتياز تسهيلات مسكن تير99,613,16857,12626609565,780560,755000,741532,-39028,-5.0,749042,-31518,-4.04,741532,797900,1399-6-19
240,مارون,پتروشيمي مارون,609,430331,50682749905,113220,107560,118881,5661,5.0,115649,2429,2.15,107560,118881,1399-6-19
241,كوثر,بيمه كوثر,604,2359006,36872740605,16369,15551,15850,-519,-3.17,15783,-586,-3.58,15551,16400,1399-6-19
242,پارسيان,بيمه پارسيان,600,7199136,98645387810,14390,13680,13800,-590,-4.1,13700,-690,-4.79,13680,14270,1399-6-19
243,فسرب,ملي‌ سرب‌وروي‌ ايران‌,597,742915,94673741430,134120,127420,127420,-6700,-5.0,127440,-6680,-4.98,127420,128650,1399-6-19
244,وكار,بانك‌ كارآفرين‌,596,6189249,84923749990,14290,13580,13600,-690,-4.83,13720,-570,-3.99,13580,14230,1399-6-19
245,آكورد,صندوق س. آرمان آتي كوثر-د,593,11414774,324720991741,28439,28510,28443,4,0.01,28447,8,0.03,28433,28515,1399-6-19
246,خصدرا,صنعتي‌ دريايي‌ ايران‌,589,3425795,23514656880,7225,6864,6864,-361,-5.0,7107,-118,-1.63,6864,6864,1399-6-19
247,دسبحان,سبحان دارو,581,1587079,32984444560,21870,20780,20780,-1090,-4.98,21000,-870,-3.98,20780,21040,1399-6-19
248,كيان,صندوق س. با درآمد ثابت كيان,578,13639944,342664074860,25330,25410,25200,-130,-0.51,25120,-210,-0.83,24960,25410,1399-6-19
249,غصينو,صنعتي مينو,575,357678,12218280480,35957,34160,34160,-1797,-5.0,35585,-372,-1.03,34160,34160,1399-6-19
250,پرداخت,به پرداخت ملت,556,1087452,47666990360,44530,42310,44500,-30,-0.07,43860,-670,-1.5,42310,45990,1399-6-19
251,سخاش,سيمان‌خاش‌,551,244851,19669690360,82010,77910,83000,990,1.21,81320,-690,-0.84,77910,84500,1399-6-19
252,وساپا,سرمايه‌گذاري‌ سايپا,544,1316050,17385020500,13900,13210,13210,-690,-4.96,13690,-210,-1.51,13210,13210,1399-6-19
253,اتكاي,بيمه اتكايي ايرانيان,540,3297424,49073688024,15258,14496,15500,242,1.59,14882,-376,-2.46,14496,15700,1399-6-19
254,فاما,صنعتي‌ آما,539,1176943,23136869560,20630,19600,20000,-630,-3.05,20130,-500,-2.42,19600,20950,1399-6-19
255,سلار,شركت سيمان لارستان,537,3000646,96086644485,32005,31300,31850,-155,-0.48,32022,17,0.05,31090,32850,1399-6-19
256,ساينا,صنايع بهداشتي ساينا,537,194521,32547706109,162630,154520,170600,7970,4.9,165652,3022,1.86,154520,170700,1399-6-19
257,خبهمن,گروه‌بهمن‌,527,908593,27639399060,32020,30420,30420,-1600,-5.0,31520,-500,-1.56,30420,30420,1399-6-19
258,تسه9902,امتياز تسهيلات مسكن ارديبهشت99,523,6555,4849002628,773607,770000,734927,-38680,-5.0,739741,-33866,-4.38,734927,810000,1399-6-19
259,درهآور,دارويي ره آورد تامين,519,416673,13867102043,34961,33213,34210,-751,-2.15,34445,-516,-1.48,33213,34913,1399-6-19
260,دسبحاح,ح .گروه دارويي سبحان,516,387541,5311096700,13190,12180,14290,1100,8.34,13700,510,3.87,12180,14300,1399-6-19
261,صايند,صندوق س. گنجينه آينده روشن-د,511,13153660,128884771000,9687,9700,9856,169,1.74,9798,111,1.15,9510,9860,1399-6-19
262,هاي وب,داده گسترعصرنوين-هاي وب,511,904413,28172464950,32780,31150,31150,-1630,-4.97,31860,-920,-2.81,31150,31150,1399-6-19
263,كوير,توليدي فولاد سپيد فراب كوير,508,3027226,47376086900,16470,15650,15650,-820,-4.98,15900,-570,-3.46,15650,15650,1399-6-19
264,كالا,بورس كالاي ايران,505,704319,29194022550,43630,41450,41450,-2180,-5.0,42140,-1490,-3.42,41450,41450,1399-6-19
265,پيزد,مجتمع صنايع لاستيك يزد,501,101719,11580402993,119838,113847,113847,-5991,-5.0,118311,-1527,-1.27,113847,113847,1399-6-19
266,كي بي سي,شركت كي بي سي,497,1588927,55844438031,36830,34989,35152,-1678,-4.56,35146,-1684,-4.57,34989,36360,1399-6-19
267,دسبحا,گروه دارويي سبحان,495,1699242,28829306870,17710,16830,17500,-210,-1.19,17220,-490,-2.77,16830,17500,1399-6-19
268,كاسپينح,ح .داروسازي كاسپين تامين,493,826107,15015697376,17672,17020,18555,883,5.0,18176,504,2.85,16789,18555,1399-6-19
269,وآفري,بيمه كارآفرين,491,4139003,50237303451,12052,11692,12413,361,3.0,12138,86,0.71,11692,12413,1399-6-19
270,غويتا,ويتانا,466,1645288,96843296968,61958,58861,58861,-3097,-5.0,58861,-3097,-5.0,58861,58861,1399-6-19
271,سيستم,همكاران سيستم,464,2664651,68893243570,27160,25810,25810,-1350,-4.97,25850,-1310,-4.82,25810,27150,1399-6-19
272,حآسا,آسيا سير ارس,460,1056954,13614175130,13556,12879,12879,-677,-4.99,13350,-206,-1.52,12879,12981,1399-6-19
273,ثعتما,س. ساختماني اعتماد گستر,457,1753247,47913791753,26563,27359,27359,796,3.0,27329,766,2.88,26564,27359,1399-6-19
274,بذر,صندوق س بذر اميد آفرين-سهام,452,309036,36591359880,111930,113690,119990,8060,7.2,118400,6470,5.78,110000,120110,1399-6-19
275,بسويچ,پارس‌سويچ‌,446,358528,17752692190,51440,48870,49030,-2410,-4.69,50720,-720,-1.4,48870,53000,1399-6-19
276,سهرمز,سيمان‌هرمزگان‌,441,986748,16252126800,17310,16450,16690,-620,-3.58,17020,-290,-1.68,16450,17310,1399-6-19
277,وصنا,گروه‌صنايع‌بهشهرايران‌,440,2607578,30326132140,12240,11630,11630,-610,-4.98,11840,-400,-3.27,11630,11630,1399-6-19
278,شفا,سرمايه گذاري شفادارو,437,517369,28170079270,56970,54130,54130,-2840,-4.99,55330,-1640,-2.88,54130,58880,1399-6-19
279,دارا,صندوق س. دارا الگوريتم-د,435,10099979,102201638083,10140,10136,10160,20,0.2,10119,-21,-0.21,10082,10160,1399-6-19
280,شلرد,كود شيميايي اوره لردگان,430,3957553,47736004286,12696,12062,12062,-634,-4.99,12062,-634,-4.99,12062,12062,1399-6-19
281,وسديد,گروه ‌صنعتي‌سديد,430,1675450,43757727650,27491,26117,26117,-1374,-5.0,26117,-1374,-5.0,26117,26117,1399-6-19
282,ولراز,ليزينگ رازي,428,1223512,27412668780,22549,23220,21900,-649,-2.88,22405,-144,-0.64,21873,23225,1399-6-19
283,بالبر,كابل‌ البرز,425,621272,17234123980,29060,27610,27720,-1340,-4.61,28610,-450,-1.55,27610,28990,1399-6-19
284,دابور,داروسازي‌ ابوريحان‌,424,377319,14330425350,38950,37040,38600,-350,-0.9,38650,-300,-0.77,37020,39000,1399-6-19
285,غمارگ,مارگارين‌,418,1226050,38669617000,33190,31540,31540,-1650,-4.97,31740,-1450,-4.37,31540,31540,1399-6-19
286,غشهد,شهد ايران ‌,413,1896687,16216673850,9000,8550,8550,-450,-5.0,8840,-160,-1.78,8550,8550,1399-6-19
287,سيلامح,ح . سيمان‌ ايلام‌,409,15582897,85893388640,5510,6060,5510,0,0.0,5510,0,0.0,5510,6060,1399-6-19
288,دزهراوي,داروسازي‌زهراوي‌,402,740536,10448962960,14850,14110,14110,-740,-4.98,14670,-180,-1.21,14110,14110,1399-6-19
289,دارو,كارخانجات‌داروپخش‌,398,495756,26619501890,54930,52190,53990,-940,-1.71,54250,-680,-1.24,52190,57670,1399-6-19
290,قچار,فراوردههاي غذايي وقند چهارمحال,393,128219,22186897100,179137,170181,179840,703,0.39,176349,-2788,-1.56,170181,179859,1399-6-19
291,ثفارس,عمران‌وتوسعه‌فارس‌,391,1221047,14115303320,12160,11560,11560,-600,-4.93,11960,-200,-1.64,11560,11560,1399-6-19
292,خزاميا,زامياد,386,583856,10976492800,19780,18800,18800,-980,-4.95,19540,-240,-1.21,18800,18800,1399-6-19
293,ضجار7022,اختيارخ وتجارت-2800-1399/07/22,385,17292,10616129000,424,549,780,356,83.96,614,190,44.81,430,780,1399-6-19
294,غنوش,نوش‌ مازندران‌,375,175896,16205298480,96970,92130,92130,-4840,-4.99,95140,-1830,-1.89,92130,92130,1399-6-19
295,غاذر,كشت‌وصنعت‌پياذر,372,552112,47978532800,82770,86900,86900,4130,4.99,86220,3450,4.17,86900,86900,1399-6-19
296,دلر,داروسازي‌ اكسير,371,296871,28928980390,93950,90000,98390,4440,4.73,95910,1960,2.09,90000,98640,1399-6-19
297,تسه9810,امتياز تسهيلات مسكن دي98,370,5701,4206050568,765269,803532,728000,-37269,-4.87,737774,-27495,-3.59,727006,803532,1399-6-19
298,تسه9707,امتياز تسهيلات مسكن مهر97,369,3663,2675104069,763413,732000,725243,-38170,-5.0,730304,-33109,-4.34,725243,749999,1399-6-19
299,قشرين,قند شيرين خراسان,368,3237812,77882329848,24797,24054,24054,-743,-3.0,24054,-743,-3.0,24054,24054,1399-6-19
300,تسه9708,امتياز تسهيلات مسكن آبان97,367,3856,2847365847,774409,739010,735689,-38720,-5.0,738425,-35984,-4.65,735689,770000,1399-6-19
301,سفانو,سيمان فارس نو,365,618166,18571788980,30990,29450,30530,-460,-1.48,30630,-360,-1.16,29450,32530,1399-6-19
302,خكرمان,گروه اقتصادي كرمان خودرو,363,1204872,9430533144,8238,7827,7827,-411,-4.99,8009,-229,-2.78,7827,7827,1399-6-19
303,سبهان,سيمان‌ بهبهان‌,356,220827,12792484050,60790,57760,57990,-2800,-4.61,60000,-790,-1.3,57760,59470,1399-6-19
304,ستران,سيمان‌ تهران‌,355,745715,33154488900,46790,44460,44460,-2330,-4.98,45000,-1790,-3.83,44460,44460,1399-6-19
305,زپارس,ملي كشت و صنعت و دامپروري پارس,352,387900,31880669380,86290,81980,81980,-4310,-4.99,83340,-2950,-3.42,81980,88000,1399-6-19
306,غشان,شيرپاستوريزه‌پگاه‌خراسان‌,343,185535,11432666700,64860,61620,61620,-3240,-5.0,64060,-800,-1.23,61620,61620,1399-6-19
307,تسه9903,امتياز تسهيلات مسكن خرداد99,333,3764,2793397668,775262,745000,736499,-38763,-5.0,742135,-33127,-4.27,736499,800000,1399-6-19
308,مرقام,ايران‌ارقام‌,332,380298,11047656900,30570,29050,29050,-1520,-4.97,30180,-390,-1.28,29050,29050,1399-6-19
309,دتوليد,داروسازي توليد دارو,327,317222,13030210872,43237,41076,41076,-2161,-5.0,42582,-655,-1.51,41076,41076,1399-6-19
310,حفارس,حمل و نقل بين المللي خليج فارس,324,1842084,10757770560,6140,5840,5840,-300,-4.89,6070,-70,-1.14,5840,5840,1399-6-19
311,قصفها,قنداصفهان‌,313,126611,25032260810,208110,197710,197710,-10400,-5.0,202160,-5950,-2.86,197710,197710,1399-6-19
312,غفارس,شير پاستوريزه پگاه فارس,309,1190908,12674833844,11203,10643,10643,-560,-5.0,11046,-157,-1.4,10643,10643,1399-6-19
313,كساوه,صنايع‌ كاشي‌ و سراميك‌ سينا,308,912642,36283240530,41600,39520,39520,-2080,-5.0,40110,-1490,-3.58,39520,41980,1399-6-19
314,شاملا,معدني‌ املاح‌  ايران‌,303,768966,57132362550,78200,74290,74290,-3910,-5.0,74300,-3900,-4.99,74290,75000,1399-6-19
315,غپونه,نوش پونه مشهد,301,1250780,24629658922,20722,19686,19720,-1002,-4.84,19691,-1031,-4.98,19686,20000,1399-6-19
316,حاريا,كشتيراني آريا,301,1657959,35252997521,20773,20800,21396,623,3.0,21263,490,2.36,20800,21396,1399-6-19
317,وآتوس,س.آرين توسكا قيمت اسمي 350ريال,299,923204,26637956382,28093,28935,28935,842,3.0,28854,761,2.71,27533,28935,1399-6-19
318,سشرق,سيمان‌ شرق‌,296,1028322,8792153100,9000,8550,8550,-450,-5.0,8910,-90,-1.0,8550,8550,1399-6-19
319,حبندر,دريايي و کشتيراني خط دريابندر,296,768272,18973020979,25980,24681,24681,-1299,-5.0,24696,-1284,-4.94,24681,25493,1399-6-19
320,زنجان,صنايع كشاورزي وكود زنجان,285,2567107,20156924164,8265,7852,7852,-413,-5.0,7852,-413,-5.0,7852,7852,1399-6-19
321,كمرجان,بازرگاني و توليدي مرجان كار,278,556159,23020297738,43284,41120,41980,-1304,-3.01,42352,-932,-2.15,41120,42200,1399-6-19
322,تسه9901,امتياز تسهيلات مسكن فروردين99,276,2884,2133459951,770294,731781,770294,0,0.0,739757,-30537,-3.96,731780,808808,1399-6-19
323,دپارس,پارس‌ دارو,276,163030,14419042310,92810,88170,88170,-4640,-5.0,91380,-1430,-1.54,88170,92360,1399-6-19
324,بهپاك,صنعتي بهپاك,274,727912,30487866208,44088,41884,41884,-2204,-5.0,42579,-1509,-3.42,41884,41884,1399-6-19
325,ضجار7036,اختيارخ وتجارت-6500-1399/07/22,274,14641,1259403000,52,80,88,36,69.23,86,34,65.38,63,110,1399-6-19
326,وملي,گروه‌ صنعتي‌ ملي‌ (هلدينگ‌,269,18952,11493440400,638360,606450,606450,-31910,-5.0,632250,-6110,-0.96,606450,606450,1399-6-19
327,تسه9812,امتياز تسهيلات مسكن اسفند98,267,2673,1980111707,761378,724001,723560,-37818,-4.97,740783,-20595,-2.7,723311,799446,1399-6-19
328,كماسه,تامين‌ ماسه‌ ريخته‌گري‌,266,561570,41365246200,77530,73660,73660,-3870,-4.99,74060,-3470,-4.48,73660,73660,1399-6-19
329,لپارس,پارس‌ الكتريك‌,263,28029,11376690810,427250,405890,405890,-21360,-5.0,422260,-4990,-1.17,405890,405890,1399-6-19
330,وبوعلي,سرمايه‌گذاري‌بوعلي‌,262,1138065,11050611150,10220,9710,9710,-510,-4.99,10090,-130,-1.27,9710,9710,1399-6-19
331,نوين,بيمه نوين,256,2958325,20613608600,7334,6968,6968,-366,-4.99,7173,-161,-2.2,6968,6968,1399-6-19
332,سبجنو,سيمان‌ بجنورد,250,310294,10166539800,34410,32690,32690,-1720,-5.0,34050,-360,-1.05,32690,34000,1399-6-19
333,درازك,دارويي‌ رازك‌,250,436472,18620186650,44820,42580,42580,-2240,-5.0,43890,-930,-2.07,42580,44600,1399-6-19
334,شلعاب,لعابيران‌,247,249022,8359668540,35330,33570,33570,-1760,-4.98,35020,-310,-0.88,33570,33570,1399-6-19
335,تسه9709,امتياز تسهيلات مسكن آذر97,245,1599,1187754346,776937,768970,738091,-38846,-5.0,742811,-34126,-4.39,738091,779998,1399-6-19
336,داوه,داروسازي آوه سينا,239,451615,9301914155,21681,20597,20597,-1084,-5.0,21460,-221,-1.02,20597,20597,1399-6-19
337,دروز,داروسازي‌ روزدارو,232,1162209,23897876700,21600,20520,20980,-620,-2.87,21060,-540,-2.5,20520,21390,1399-6-19
338,وآرينح,ح. شركت توسعه اقتصادي آرين,229,2237632,8606658960,3944,3826,3831,-113,-2.87,3846,-98,-2.48,3826,4062,1399-6-19
339,ياقوت,صندوق س ياقوت آگاه-ثابت,222,5602473,61438643890,10940,10940,10940,0,0.0,10970,30,0.27,10940,10980,1399-6-19
340,چدن,توليدي چدن سازان,221,515635,16056873900,32770,31140,31140,-1630,-4.97,32160,-610,-1.86,31140,31140,1399-6-19
341,دفرا,فرآورده‌هاي‌ تزريقي‌ ايران‌,219,668586,18983967010,29880,28390,28390,-1490,-4.99,29280,-600,-2.01,28390,29000,1399-6-19
342,ميهن,بيمه ميهن,219,6554868,42822952644,6876,6533,6533,-343,-4.99,6540,-336,-4.89,6533,6533,1399-6-19
343,پكوير,كوير تاير,217,200073,3193165080,16790,15960,15960,-830,-4.94,16730,-60,-0.36,15960,15960,1399-6-19
344,كحافظ,كاشي‌ وسراميك‌ حافظ‌,216,1294104,18363335760,14930,14190,14190,-740,-4.96,14640,-290,-1.94,14190,14190,1399-6-19
345,كمنگنز,معادن‌منگنزايران‌,216,261741,22431203700,90210,85700,85700,-4510,-5.0,87830,-2380,-2.64,85700,85700,1399-6-19
346,ولملت,واسپاري ملت,215,679573,8698534400,13470,12800,12800,-670,-4.97,13340,-130,-0.97,12800,12800,1399-6-19
347,اميد,تامين سرمايه اميد,213,2154624,43329488640,21160,20110,20110,-1050,-4.96,20560,-600,-2.84,20110,20110,1399-6-19
348,تسه9711,امتياز تسهيلات مسكن بهمن 97,213,1536,1118363060,763546,725369,726000,-37546,-4.92,728101,-35445,-4.64,725369,740000,1399-6-19
349,سدشت,صنايع سيمان دشتستان,208,93738,3447115060,36480,35000,38010,1530,4.19,36500,20,0.05,35000,38200,1399-6-19
350,ورنا,سرمايه‌گذاري‌ رنا(هلدينگ‌,208,446730,5561788500,13100,12450,12450,-650,-4.96,13020,-80,-0.61,12450,12450,1399-6-19
351,گپارس,امور رفاهي كارگزاران پارس,207,208568,20037153131,91864,96455,96457,4593,5.0,95471,3607,3.93,92120,96457,1399-6-19
352,فرآور,فرآوري‌موادمعدني‌ايران‌,206,955248,25094364960,27650,26270,26270,-1380,-4.99,26900,-750,-2.71,26270,26270,1399-6-19
353,الماس,صندوق س.امين تدبيرگران فردا-س,205,112959,14159928600,120746,120000,127000,6254,5.18,125355,4609,3.82,120000,129660,1399-6-19
354,سپاها,سيمان‌سپاهان‌,203,656673,6862232850,10990,10450,10450,-540,-4.91,10910,-80,-0.73,10450,10450,1399-6-19
355,آسام,صندوق س.آرمان سپهر آشنا-م,200,127030,14422342500,109713,105011,114197,4484,4.09,113535,3822,3.48,105011,130000,1399-6-19
356,سصفها,سيمان‌اصفهان‌,198,328555,42623440150,136550,129730,129730,-6820,-4.99,130400,-6150,-4.5,129730,129730,1399-6-19
357,تسه9712,امتياز تسهيلات مسكن اسفند97,198,1370,999510034,755112,718000,725050,-30062,-3.98,729569,-25543,-3.38,718000,750000,1399-6-19
358,صنوين,صندوق سرمايه‌گذاري صنوين-مختلط,193,65522,7383088030,108600,108000,114790,6190,5.7,112680,4080,3.76,108000,115000,1399-6-19
359,كسرا,سراميك‌هاي‌صنعتي‌اردكان‌,191,321191,8909838340,29200,27740,27740,-1460,-5.0,28920,-280,-0.96,27740,27740,1399-6-19
360,داناح,ح . بيمه دانا,190,1416340,7818196800,5520,5520,5520,0,0.0,5520,0,0.0,5520,5520,1399-6-19
361,شپترو,پتروشيمي آبادان,190,1302198,10068594936,8138,7732,7732,-406,-4.99,7904,-234,-2.88,7732,7732,1399-6-19
362,فسپا,گروه‌صنعتي‌سپاهان‌,189,387918,20365695000,55260,52500,52500,-2760,-4.99,53960,-1300,-2.35,52500,52500,1399-6-19
363,ضصاد8024,اختيارخ وبصادر-5500-1399/08/11,187,5772,1547813000,128,180,289,161,125.78,268,140,109.38,180,300,1399-6-19
364,تسه9802,امتياز تسهيلات مسكن ارديبهشت98,182,1206,882369440,761916,724100,730500,-31416,-4.12,731650,-30266,-3.97,723821,750000,1399-6-19
365,تسه9801,امتياز تسهيلات مسكن فروردين98,182,959,701079478,766753,730000,750000,-16753,-2.18,731053,-35700,-4.66,728416,750000,1399-6-19
366,سامان,بانك سامان,181,661268,10007629912,15602,15134,15134,-468,-3.0,15505,-97,-0.62,15134,15134,1399-6-19
367,زمگسا,كشاورزي‌ ودامپروي‌ مگسال‌,180,283803,8803569060,32650,31020,31020,-1630,-4.99,32340,-310,-0.95,31020,31020,1399-6-19
368,تسه9811,امتياز تسهيلات مسكن بهمن98,180,1396,1037784533,765009,744500,726999,-38010,-4.97,743399,-21610,-2.82,726777,799000,1399-6-19
369,تسه9803,امتياز تسهيلات مسكن خرداد98,178,1428,1049499411,761381,724000,739999,-21382,-2.81,734944,-26437,-3.47,723400,760000,1399-6-19
370,توريل,توکاريل,178,379714,6509816816,18046,17144,17144,-902,-5.0,17911,-135,-0.75,17144,17144,1399-6-19
371,آساميد,صندوق س.مشترك آسمان اميد -د,177,6212388,66060560270,10633,10640,10636,3,0.03,10634,1,0.01,10625,10640,1399-6-19
372,كصدف,كاشي صدف سرام استقلال آباده,175,867362,11760925204,13344,13078,13610,266,1.99,13559,215,1.61,13078,13610,1399-6-19
373,خاهن,آهنگري‌ تراكتورسازي‌ ايران‌,173,330166,9297474560,29640,28160,28160,-1480,-4.99,29330,-310,-1.05,28160,28160,1399-6-19
374,قهكمت,قندهكمتان‌,172,513682,25624115890,52490,49870,50000,-2490,-4.74,51010,-1480,-2.82,49870,51000,1399-6-19
375,غبهنوش,بهنوش‌ ايران‌,170,314225,22093159750,74010,70310,70310,-3700,-5.0,72130,-1880,-2.54,70310,70310,1399-6-19
376,سنوين,سرمايه گذاري اقتصاد نوين,169,1188889,13609573432,11630,11398,11410,-220,-1.89,11447,-183,-1.57,11398,11850,1399-6-19
377,نگين,ص.س. زمين و ساختمان نگين شهرري,168,340338,17347584570,50630,51000,51000,370,0.73,50970,340,0.67,50020,51000,1399-6-19
378,زگلدشت,كشت و دام گلدشت نمونه اصفهان,166,177191,7630021651,45327,43061,43061,-2266,-5.0,44958,-369,-0.81,43061,43061,1399-6-19
379,سپاس,صندوق س. پاداش سهامداري توسعه1,166,3447114,34791986370,10080,10090,10090,10,0.1,10090,10,0.1,10080,10110,1399-6-19
380,زشگزا,شير و گوشت زاگرس شهركرد,165,61652,6436037236,109887,104393,104393,-5494,-5.0,109124,-763,-0.69,104393,104393,1399-6-19
381,دانا,بيمه دانا,161,510624,4130948160,8510,8090,8090,-420,-4.94,8470,-40,-0.47,8090,8090,1399-6-19
382,ساوه,سيمان ساوه,158,55849,4390178192,82745,78608,78608,-4137,-5.0,82356,-389,-0.47,78608,78608,1399-6-19
383,وسرمد,بيمه  سرمد,158,1356222,10838926224,8239,7992,7992,-247,-3.0,8089,-150,-1.82,7992,7992,1399-6-19
384,تمحركه,ماشين‌سازي‌نيرومحركه‌,158,568581,12468981330,23080,21930,21930,-1150,-4.98,22780,-300,-1.3,21930,21930,1399-6-19
385,وشهر,بانك شهر,155,639098,6273385968,10016,9816,9816,-200,-2.0,9995,-21,-0.21,9816,9816,1399-6-19
386,كدما,معدني‌ دماوند,150,229804,29054119720,120410,126430,126430,6020,5.0,123360,2950,2.45,126430,126430,1399-6-19
387,غگرجي,بيسكويت‌  گرجي‌,147,123118,5159875380,44110,41910,41910,-2200,-4.99,43860,-250,-0.57,41910,41910,1399-6-19
388,فاهواز,نورد و لوله اهواز,146,867333,18657200163,22407,21511,21511,-896,-4.0,22063,-344,-1.54,21511,21511,1399-6-19
389,فولاي,صنايع فولاد آلياژي يزد,146,118820,6305183300,55857,53065,53065,-2792,-5.0,55478,-379,-0.68,53065,53065,1399-6-19
390,شفارس,صنايع‌ شيميايي‌ فارس‌,144,230399,9015512870,41180,39130,39130,-2050,-4.98,40760,-420,-1.02,39130,39130,1399-6-19
391,نيرو,نيرو سرمايه,144,411429,24415842576,62467,59344,59344,-3123,-5.0,59344,-3123,-5.0,59344,59344,1399-6-19
392,تسه9809,امتياز تسهيلات مسكن آذر98,144,1380,1014678078,762731,725199,726100,-36631,-4.8,735274,-27457,-3.6,725199,799999,1399-6-19
393,شكف,كف,144,310774,11203091926,36784,36049,36049,-735,-2.0,36049,-735,-2.0,36049,36049,1399-6-19
394,خاور,ايران خودرو ديزل,143,571397,4377472417,8064,7661,7661,-403,-5.0,7967,-97,-1.2,7661,7661,1399-6-19
395,ثمسكن,سرمايه‌گذاري‌ مسكن‌,143,379606,3260815540,9040,8590,8590,-450,-4.98,9010,-30,-0.33,8590,8590,1399-6-19
396,وتوس,توسعه‌شهري‌توس‌گستر,142,222527,8008746730,37880,35990,35990,-1890,-4.99,37530,-350,-0.92,35990,35990,1399-6-19
397,زعف9908پ10,زعفران9908نگين طلاي سرخ(پ),141,56030,5209402360,91545,90200,93320,1775,1.94,92975,1430,1.56,88000,95000,1399-6-19
398,سصوفي,سيمان‌ صوفيان‌,138,203562,4433580360,22920,21780,21780,-1140,-4.97,22810,-110,-0.48,21780,21780,1399-6-19
399,ولشرق,ليزينگ ايران و شرق,138,1789189,17655717052,10387,9868,9868,-519,-5.0,10175,-212,-2.04,9868,9868,1399-6-19
400,اخزا808,اسنادخزانه-م8بودجه98-000817,133,127354,104508538296,819063,819066,820000,937,0.11,820614,1551,0.19,817211,842784,1399-6-19
401,حتايد,تايدواترخاورميانه,133,229025,4967552250,22830,21690,21690,-1140,-4.99,22700,-130,-0.57,21690,21690,1399-6-19
402,خرينگ,رينگ‌سازي‌مشهد,128,462062,14176062160,32290,30680,30680,-1610,-4.99,31800,-490,-1.52,30680,30680,1399-6-19
403,بساما,بيمه سامان,128,5688060,167501990880,30997,29448,29448,-1549,-5.0,29448,-1549,-5.0,29448,29448,1399-6-19
404,شدوص,دوده‌ صنعتي‌ پارس‌,127,279767,5959037100,22420,21300,21300,-1120,-5.0,22280,-140,-0.62,21300,21300,1399-6-19
405,آبين,كشت و صنعت آبشيرين,127,425698,2022065500,5000,4750,4750,-250,-5.0,4972,-28,-0.56,4750,4750,1399-6-19
406,كاذر,فرآورده‌هاي‌نسوزآذر,127,356507,11287011620,33320,31660,31660,-1660,-4.98,32880,-440,-1.32,31660,31660,1399-6-19
407,وسخراج,شركت س استان خراسان جنوبي,123,3936028,7517813480,1820,1910,1910,90,4.95,1830,10,0.55,1910,1910,1399-6-19
408,پخش,پخش البرز,122,325819,10746488077,34718,32983,32983,-1735,-5.0,34282,-436,-1.26,32983,32983,1399-6-19
409,تسه9808,امتياز تسهيلات مسكن آبان98,121,1441,1060429011,773231,760000,734570,-38661,-5.0,735898,-37333,-4.83,734570,760000,1399-6-19
410,خمهر,مهركام‌پارس‌,121,374372,3361860560,9450,8980,8980,-470,-4.97,9410,-40,-0.42,8980,8980,1399-6-19
411,ثاصفا,شركت‌ ساختمان‌ اصفهان‌,121,357486,8398061112,24728,23492,23492,-1236,-5.0,24179,-549,-2.22,23492,23492,1399-6-19
412,نمرينو,ايران‌ مرينوس‌,121,516883,38781731490,78970,75030,75030,-3940,-4.99,75830,-3140,-3.98,75030,75030,1399-6-19
413,دمعيار,صندوق س. توازن معيار-د,121,3640696,36686496594,10076,10071,10071,-5,-0.05,10077,1,0.01,10071,10087,1399-6-19
414,رنيك,جنرال مكانيك,120,174788,4789365988,28843,27401,27401,-1442,-5.0,28682,-161,-0.56,27401,27401,1399-6-19
415,كتوكا,توليدي و خدمات صنايع نسوز توكا,119,28133,4304433399,161055,153003,153003,-8052,-5.0,160322,-733,-0.46,153003,153003,1399-6-19
416,ضجار7023,اختيارخ وتجارت-3000-1399/07/22,117,4516,2575044000,336,369,645,309,91.96,570,234,69.64,300,645,1399-6-19
417,قشهد,شهد,115,531493,18283377290,36210,34400,34420,-1790,-4.94,35500,-710,-1.96,34400,34420,1399-6-19
418,اخزا815,اسنادخزانه-م15بودجه98-010406,115,126319,92641494097,733032,734400,735000,1968,0.27,733393,361,0.05,731659,735000,1399-6-19
419,فجام,جام‌دارو,114,93081,5601614580,63340,60180,60180,-3160,-4.99,62970,-370,-0.58,60180,60180,1399-6-19
420,قاسم,قاسم ايران,114,180005,2810598070,16435,15614,15614,-821,-5.0,16386,-49,-0.3,15614,15614,1399-6-19
421,تايرا,تراكتورسازي‌ايران‌,114,392373,10189926810,27330,25970,25970,-1360,-4.98,27010,-320,-1.17,25970,25970,1399-6-19
422,ديران,ايران‌دارو,112,384758,9988317680,27320,25960,25960,-1360,-4.98,27030,-290,-1.06,25960,25960,1399-6-19
423,ثروتم,صندوق س. ثروت آفرين پارسيان-س,111,50590,5105484910,100272,99900,102990,2718,2.71,100919,647,0.65,99700,103000,1399-6-19
424,وتوصا,گروه س توسعه صنعتي ايران,110,190218,2999737860,16600,15770,15770,-830,-5.0,16550,-50,-0.3,15770,15770,1399-6-19
425,سمازن,سيمان‌مازندران‌,110,190264,2073877600,11470,10900,10900,-570,-4.97,11440,-30,-0.26,10900,10900,1399-6-19
426,اپرداز,آتيه داده پرداز,109,595902,16897397112,29848,28356,28356,-1492,-5.0,29282,-566,-1.9,28356,28356,1399-6-19
427,خاذين,سايپاآذين‌,108,373668,3265858320,9200,8740,8740,-460,-5.0,9170,-30,-0.33,8740,8740,1399-6-19
428,شكربن,كربن‌ ايران‌,107,71014,4857357600,71990,68400,68400,-3590,-4.99,71610,-380,-0.53,68400,68400,1399-6-19
429,وآذر,سرمايه‌گذاري‌توسعه‌آذربايجان‌,107,45342,5788359720,134370,127660,127660,-6710,-4.99,133480,-890,-0.66,127660,127660,1399-6-19
430,تسه9710,امتياز تسهيلات مسكن دي 97,107,904,680243334,789720,769000,750234,-39486,-5.0,752482,-37238,-4.72,750234,769000,1399-6-19
431,تكمبا,كمباين‌ سازي‌ ايران‌,106,261836,2898524520,11650,11070,11070,-580,-4.98,11610,-40,-0.34,11070,11070,1399-6-19
432,قشكر,شكرشاهرود,106,646505,33669980400,54820,52080,52080,-2740,-5.0,52740,-2080,-3.79,52080,52080,1399-6-19
433,كيسون,شركت كيسون,105,204492,4637060592,23869,22676,22676,-1193,-5.0,23748,-121,-0.51,22676,22676,1399-6-19
434,تبرك,گروه كارخانجات صنعتي تبرك,105,112174,3610208016,33877,32184,32184,-1693,-5.0,33746,-131,-0.39,32184,32184,1399-6-19
435,ثعمرا,عمران و توسعه شاهد,104,128831,3557925727,29070,27617,27617,-1453,-5.0,28961,-109,-0.37,27617,27617,1399-6-19
436,آكورد2,صندوق س. آرمان آتي كوثر-د,103,10300000,10300000,28439,1,1,-28438,-100.0,1,-28438,-100.0,1,1,1399-6-19
437,كيان2,صندوق س. با درآمد ثابت كيان,101,10100000,10100000,25330,1,1,-25329,-100.0,1,-25329,-100.0,1,1,1399-6-19
438,وليز,ليزينگ‌ايران‌,100,318807,3497312790,11540,10970,10970,-570,-4.94,11500,-40,-0.35,10970,10970,1399-6-19
439,تصميم,صندوق س با درآمد ثابت تصميم,99,1701416,24687425150,14480,14550,14540,60,0.41,14510,30,0.21,14470,14550,1399-6-19
440,فوكا,فولاد كاويان,98,514756,10913341956,22084,21201,21201,-883,-4.0,21894,-190,-0.86,21201,21201,1399-6-19
441,ثنوسا,نوسازي‌وساختمان‌تهران‌,98,395441,5251456480,13970,13280,13280,-690,-4.94,13890,-80,-0.57,13280,13280,1399-6-19
442,سكرد,سيمان كردستان,97,577987,6664190110,12130,11530,11530,-600,-4.95,12050,-80,-0.66,11530,11530,1399-6-19
443,تسه9807,امتياز تسهيلات مسكن مهر98,96,738,550360648,769930,740000,732000,-37930,-4.93,745746,-24184,-3.14,731434,760000,1399-6-19
444,وپخش,داروپخش‌ (هلدينگ‌,95,45234,5330374560,124040,117840,117840,-6200,-5.0,123330,-710,-0.57,117840,117840,1399-6-19
445,تسه9806,امتياز تسهيلات مسكن شهريور98,94,781,575860514,766518,728193,740000,-26518,-3.46,737337,-29181,-3.81,728193,799990,1399-6-19
446,لكما,كارخانجات‌مخابراتي‌ايران‌,93,289140,3528086280,12579,12202,12202,-377,-3.0,12510,-69,-0.55,12202,12202,1399-6-19
447,تكنار,مجتمع معادن مس تكنار,92,121286,8471147358,66565,69700,69893,3328,5.0,67795,1230,1.85,69000,69893,1399-6-19
448,دبالك,مواد اوليه دارويي البرز بالك,91,182329,3661166320,21136,20080,20080,-1056,-5.0,21051,-85,-0.4,20080,20080,1399-6-19
449,بزاگرس,نيروگاه زاگرس كوثر,91,269031,4498198320,17599,16720,16720,-879,-4.99,17514,-85,-0.48,16720,16720,1399-6-19
450,كهرام,توليدي گرانيت بهسرام,91,338825,20041837575,56335,59151,59151,2816,5.0,58722,2387,4.24,59151,59151,1399-6-19
451,زبينا,كشاورزي و دامپروري بينالود,90,75994,4400964528,60959,57912,57912,-3047,-5.0,60675,-284,-0.47,57912,57912,1399-6-19
452,لابسا,آبسال‌,90,177811,6584341330,38970,37030,37030,-1940,-4.98,38700,-270,-0.69,37030,37030,1399-6-19
453,خكاوه,سايپا ديزل,89,477423,3337186770,7357,6990,6990,-367,-4.99,7291,-66,-0.9,6990,6990,1399-6-19
454,فلوله,لوله‌وماشين‌سازي‌ايران‌,89,337388,9834860200,30680,29150,29150,-1530,-4.99,30360,-320,-1.04,29150,29150,1399-6-19
455,دجابر,داروسازي‌ جابرابن‌حيان‌,88,665086,28558792840,45190,42940,42940,-2250,-4.98,43670,-1520,-3.36,42940,42940,1399-6-19
456,گنجين,صندوق س. گنجينه يكم آويد-د,87,2306689,25936521541,11245,11251,11250,5,0.04,11244,-1,-0.01,11200,11251,1399-6-19
457,خشرق,الكتريك‌ خودرو شرق‌,86,101514,2037385980,21120,20070,20070,-1050,-4.97,21070,-50,-0.24,20070,20070,1399-6-19
458,نطرين,عطرين نخ قم,86,479795,9200069125,20184,19175,19175,-1009,-5.0,19978,-206,-1.02,19175,19175,1399-6-19
459,زدشت,كشت و صنعت دشت خرم دره,86,75636,4037827860,56194,53385,53385,-2809,-5.0,55933,-261,-0.46,53385,53385,1399-6-19
460,فيروزا,صندوق بادرآمد ثابت فيروزه آسيا,86,575613,11840824210,20600,20520,20570,-30,-0.15,20570,-30,-0.15,20520,20700,1399-6-19
461,ثباغ,شهر سازي و خانه سازي باغميشه,85,2296536,36530998152,16744,15907,15907,-837,-5.0,15956,-788,-4.71,15907,15907,1399-6-19
462,افران,صندوق س افرا نماد پايدار-ثابت,84,2460813,28471847700,11640,11640,11580,-60,-0.52,11570,-70,-0.6,11550,11660,1399-6-19
463,سنير,سيمان‌ سفيد ني‌ريز,83,27770,2577333700,97690,92810,92810,-4880,-5.0,97420,-270,-0.28,92810,92810,1399-6-19
464,دشيمي,شيمي‌ داروئي‌ داروپخش‌,83,668450,37774109500,59480,56510,56510,-2970,-4.99,57030,-2450,-4.12,56510,56510,1399-6-19
465,سمايه,بانك سرمايه,82,851200,8694156800,10751,10214,10214,-537,-4.99,10487,-264,-2.46,10214,10214,1399-6-19
466,ختور,رادياتور ايران‌,82,67004,2639287560,41460,39390,39390,-2070,-4.99,41340,-120,-0.29,39390,39390,1399-6-19
467,ساربيل,سيمان آرتا اردبيل,81,24062,2732480720,119530,113560,113560,-5970,-4.99,119180,-350,-0.29,113560,113560,1399-6-19
468,زعف9908پ05,زعفران9908نگين زرين(پ),81,55118,5167952688,91571,91500,95000,3429,3.74,93762,2191,2.39,91500,95607,1399-6-19
469,خنصير,مهندسي‌نصيرماشين‌,81,45762,2352166800,54100,51400,51400,-2700,-4.99,53970,-130,-0.24,51400,51400,1399-6-19
470,غمينو,شركت صنايع غذايي مينو شرق,80,158301,2603418246,17311,16446,16446,-865,-5.0,17262,-49,-0.28,16446,16446,1399-6-19
471,وبهمن,سرمايه‌گذاري‌بهمن‌,79,190589,3954721750,21840,20750,20750,-1090,-4.99,21750,-90,-0.41,20750,20750,1399-6-19
472,وگستر,گسترش سرمايه گذاري ايرانيان,79,132924,3299838300,26131,24825,24825,-1306,-5.0,26031,-100,-0.38,24825,24825,1399-6-19
473,شپاس,نفت پاسارگاد,77,114430,2823674680,25974,24676,24676,-1298,-5.0,25894,-80,-0.31,24676,24676,1399-6-19
474,غديس,پاكديس,77,142255,5707270600,42231,40120,40120,-2111,-5.0,41963,-268,-0.63,40120,40120,1399-6-19
475,وثوق,سرمايه گذاري وثوق امين,77,171894,2683093446,16430,15609,15609,-821,-5.0,16313,-117,-0.71,15609,15609,1399-6-19
476,تسه9805,امتياز تسهيلات مسكن مرداد98,76,849,650122044,783626,822000,744445,-39181,-5.0,765750,-17876,-2.28,744445,822807,1399-6-19
477,ثتران,سرمايه گذاري مسكن تهران,75,162647,1581254134,10233,9722,9722,-511,-4.99,10216,-17,-0.17,9722,9722,1399-6-19
478,قشير,قند شيروان قوچان و بجنورد,74,44952,1336422960,31294,29730,29730,-1564,-5.0,31249,-45,-0.14,29730,29730,1399-6-19
479,ثجوان,تامين مسكن جوانان,73,584870,5592526940,10065,9562,9562,-503,-5.0,9904,-161,-1.6,9562,9562,1399-6-19
480,كفرا,فراورده‌ هاي‌ نسوزايران‌,73,59526,2456042760,43430,41260,41260,-2170,-5.0,43310,-120,-0.28,41260,41260,1399-6-19
481,سدور,سيمان‌ دورود,73,442274,4073343540,9690,9210,9210,-480,-4.95,9650,-40,-0.41,9210,9210,1399-6-19
482,ولتجار,واسپاري تجارت وسرمايه ايرانيان,71,800721,5883697908,7734,7348,7348,-386,-4.99,7610,-124,-1.6,7348,7348,1399-6-19
483,ضصاد8017,اختيارخ وبصادر-3800-1399/08/11,71,1917,1055538000,477,601,600,123,25.79,551,74,15.51,80,619,1399-6-19
484,ومعلم,بيمه معلم,71,345314,6535412764,19922,18926,18926,-996,-5.0,19780,-142,-0.71,18926,18926,1399-6-19
485,شفارا,پتروشيمي فارابي,70,208365,1133297235,5725,5439,5439,-286,-5.0,5708,-17,-0.3,5439,5439,1399-6-19
486,غالبر,لبنيات‌ كالبر,70,243275,3561546000,15410,14640,14640,-770,-5.0,15350,-60,-0.39,14640,14640,1399-6-19
487,فلامي,لاميران‌,69,16474,1916585160,122460,116340,116340,-6120,-5.0,122200,-260,-0.21,116340,116340,1399-6-19
488,تسه9804,امتياز تسهيلات مسكن تير98,68,1010,743619776,765752,727465,727465,-38287,-5.0,736257,-29495,-3.85,727465,800000,1399-6-19
489,خكار,ايركا پارت صنعت,67,42002,1659919040,41590,39520,39520,-2070,-4.98,41510,-80,-0.19,39520,39520,1399-6-19
490,اعتلا,شركت سرمايه گذاري اعتلاء البرز,67,247495,3266934000,13894,13200,13200,-694,-4.99,13846,-48,-0.35,13200,13200,1399-6-19
491,ركيش,كارت اعتباري ايران كيش,66,73106,1401442020,20170,19170,19170,-1000,-4.96,20140,-30,-0.15,19170,19170,1399-6-19
492,كاسپين,داروسازي كاسپين تامين,66,259762,7447376540,30178,28670,28670,-1508,-5.0,29941,-237,-0.79,28670,28670,1399-6-19
493,واعتبار,سرمايه گذاري اعتبار ايران,66,598475,4769845750,8380,7970,7970,-410,-4.89,8340,-40,-0.48,7970,7970,1399-6-19
494,غشاذر,پگاه‌آذربايجان‌غربي‌,65,38990,873765900,23580,22410,22410,-1170,-4.96,23560,-20,-0.08,22410,22410,1399-6-19
495,سيلام,سيمان‌ ايلام‌,63,58204,629185240,11370,10810,10810,-560,-4.93,11360,-10,-0.09,10810,10810,1399-6-19
496,خديزل,بهمن  ديزل,62,104845,4300846745,43180,41021,41021,-2159,-5.0,42974,-206,-0.48,41021,41021,1399-6-19
497,اخزا814,اسنادخزانه-م14بودجه98-010318,62,83166,61447904988,739631,738209,740500,869,0.12,738858,-773,-0.1,738012,740700,1399-6-19
498,ددام,داروسازي زاگرس فارمد پارس,62,102159,1550773620,15970,15180,15180,-790,-4.95,15940,-30,-0.19,15180,15180,1399-6-19
499,قپيرا,فرآورده‌هاي‌غدايي‌وقندپيرانشهر,62,101650,8216389480,85080,80830,80830,-4250,-5.0,84330,-750,-0.88,80830,80850,1399-6-19
500,اوان,مبين وان كيش,61,524747,29507048557,59190,56231,56231,-2959,-5.0,57303,-1887,-3.19,56231,56231,1399-6-19
501,وبرق,س.کارکنان صنعت برق زنجان وقزوي,60,15872,3500966400,227396,220575,220575,-6821,-3.0,226151,-1245,-0.55,220575,220575,1399-6-19
502,شجم,صنايع پتروشيمي تخت جمشيد,60,418135,4372855830,10781,10458,10458,-323,-3.0,10729,-52,-0.48,10458,10458,1399-6-19
503,فبيرا,بسته‌ بندي‌ ايران‌,60,789521,4202620283,5603,5323,5323,-280,-5.0,5540,-63,-1.12,5323,5323,1399-6-19
504,كمينا,شيشه سازي مينا,60,61829,2359456469,40169,38161,38161,-2008,-5.0,39898,-271,-0.67,38161,38161,1399-6-19
505,اخزا816,اسنادخزانه-م16بودجه98-010503,60,60801,43922417813,722348,724000,723002,654,0.09,722396,48,0.01,721000,726649,1399-6-19
506,غچين,كشت‌ و صنعت‌ چين‌ چين,60,30799,1701336760,58140,55240,55240,-2900,-4.99,58040,-100,-0.17,55240,55240,1399-6-19
507,ثنور,سرمايه گذاري كوه نور,59,254180,2263727080,9181,8906,8906,-275,-3.0,9149,-32,-0.35,8906,8906,1399-6-19
508,اخزا817,اسنادخزانه-م17بودجه98-010512,58,108572,78124782315,719738,720000,719016,-722,-0.1,719567,-171,-0.02,718900,721100,1399-6-19
509,اخزا811,اسنادخزانه-م11بودجه98-001013,58,147998,118330605794,800728,798000,800000,-728,-0.09,799542,-1186,-0.15,793335,806998,1399-6-19
510,خفولا,خدمات فني فولاد يزد,58,89865,2829758985,32462,31489,31489,-973,-3.0,32336,-126,-0.39,31489,31489,1399-6-19
511,پسهند,صنايع‌ لاستيكي‌  سهند,57,71243,3823611810,56490,53670,53670,-2820,-4.99,56250,-240,-0.42,53670,53670,1399-6-19
512,خوساز,محورسازان‌ايران‌خودرو,57,143054,1486331060,10930,10390,10390,-540,-4.94,10910,-20,-0.18,10390,10390,1399-6-19
513,ارمغان,ص سرمايه گذاري ارمغان ايرانيان,56,807927,8095712380,10020,10020,10040,20,0.2,10020,0,0.0,10010,10040,1399-6-19
514,غپاك,لبنيات‌ پاك‌,56,77244,1326279480,18070,17170,17170,-900,-4.98,18040,-30,-0.17,17170,17170,1399-6-19
515,غدشت,دشت‌ مرغاب‌,56,27570,8479153500,323730,307550,307550,-16180,-5.0,320650,-3080,-0.95,307550,307550,1399-6-19
516,اخزا818,اسنادخزانه-م18بودجه98-010614,56,20962,14852552064,707892,707900,709000,1108,0.16,708546,654,0.09,707900,709989,1399-6-19
517,دكپسول,توليد ژلاتين كپسول ايران,56,193567,7820687501,42529,40403,40403,-2126,-5.0,42173,-356,-0.84,40403,40403,1399-6-19
518,وشمال,س. چشم انداز توسعه شمال,55,105047,11725241093,108368,111619,111619,3251,3.0,110218,1850,1.71,111619,111619,1399-6-19
519,حسير,ريل سير كوثر,55,168330,4520165490,28266,26853,26853,-1413,-5.0,28130,-136,-0.48,26853,26853,1399-6-19
520,شتوكا,توكا رنگ فولاد سپاهان,55,42780,1512529680,37216,35356,35356,-1860,-5.0,37155,-61,-0.16,35356,35356,1399-6-19
521,دكوثر,داروسازي‌ كوثر,55,72206,2049928340,29880,28390,28390,-1490,-4.99,29820,-60,-0.2,28390,28390,1399-6-19
522,شرنگي,شيميايي رنگين,54,69486,8470829802,125677,121907,121907,-3770,-3.0,124022,-1655,-1.32,121907,121907,1399-6-19
523,فپنتا,سپنتا,54,4878,1384376400,298730,283800,283800,-14930,-5.0,298310,-420,-0.14,283800,283800,1399-6-19
524,پاسا,ايران‌ياساتايرورابر,53,54164,1331892760,25880,24590,24590,-1290,-4.98,25840,-40,-0.15,24590,24590,1399-6-19
525,ضملي8077,اختيارخ فملي -29750-1399/08/06,53,209,1440666000,4853,6400,8390,3537,72.88,6893,2040,42.04,5999,9000,1399-6-19
526,فسا,پتروشيمي فسا,53,376313,1132325817,3102,3009,3009,-93,-3.0,3097,-5,-0.16,3009,3009,1399-6-19
527,آريان,سرمايه گذاري پارس آريان,52,2204460,38483258220,17996,17457,17457,-539,-3.0,17770,-226,-1.26,17457,17457,1399-6-19
528,لبوتان,گروه‌صنعتي‌بوتان‌,52,25030,2050457600,86230,81920,81920,-4310,-5.0,86040,-190,-0.22,81920,81920,1399-6-19
529,شپارس,بين‌ المللي‌ محصولات‌  پارس‌,52,77202,1293905520,17640,16760,16760,-880,-4.99,17620,-20,-0.11,16760,16760,1399-6-19
530,فنوال,نورد آلومينيوم‌,52,121095,4498679250,39100,37150,37150,-1950,-4.99,38910,-190,-0.49,37150,37150,1399-6-19
531,زقيام,كشت و دام قيام اصفهان,51,76163,2596853648,35890,34096,34096,-1794,-5.0,35784,-106,-0.3,34096,34096,1399-6-19
532,آ س پ,آ.س.پ,51,207440,3044389440,15448,14676,14676,-772,-5.0,15397,-51,-0.33,14676,14676,1399-6-19
533,اخزا809,اسنادخزانه-م9بودجه98-000923,51,76029,61343384661,806812,806800,806501,-311,-0.04,806842,30,0.0,806501,807500,1399-6-19
534,ختراك,ريخته‌گري‌ تراكتورسازي‌ ايران‌,50,32885,733993200,23490,22320,22320,-1170,-4.98,23470,-20,-0.09,22320,22320,1399-6-19
535,قزوين,كارخانجات‌ قند قزوين‌,50,949621,44280827230,49080,46630,46630,-2450,-4.99,46630,-2450,-4.99,46630,46630,1399-6-19
536,وكادو,تكادو,50,47331,1012646745,22521,21395,21395,-1126,-5.0,22456,-65,-0.29,21395,21395,1399-6-19
537,واحصا,احياء صنايع خراسان,49,142417,2354295427,17042,16531,16531,-511,-3.0,16979,-63,-0.37,16531,16531,1399-6-19
538,ثزاگرس,سرمايه گذاري توسعه عمران زاگرس,49,107247,2590815865,25266,24003,24450,-816,-3.23,25113,-153,-0.61,24003,25000,1399-6-19
539,كشرق,صنعتي و معدني شمال شرق شاهرود,48,15321,1317360864,90509,85984,85984,-4525,-5.0,90383,-126,-0.14,85984,85984,1399-6-19
540,وحكمت,بيمه حكمت صبا,48,133997,791788273,6091,5909,5909,-182,-2.99,6084,-7,-0.11,5909,5909,1399-6-19
541,اخزا821,اسنادخزانه-م21بودجه98-020906,48,53537,31316394508,584078,583000,585000,922,0.16,584949,871,0.15,583000,588000,1399-6-19
542,رتكو,كنترل‌خوردگي‌تكين‌كو,48,73484,1474823880,21120,20070,20070,-1050,-4.97,21090,-30,-0.14,20070,20070,1399-6-19
543,شزنگ,تجهيزنيروي‌زنگان‌,48,164872,13333363512,82521,80871,80871,-1650,-2.0,80871,-1650,-2.0,80871,80871,1399-6-19
544,چفيبر,فيبر ايران‌,47,323478,3652066620,11880,11290,11290,-590,-4.97,11830,-50,-0.42,11290,11290,1399-6-19
545,اوصتا,صندوق انديشه ورزان صباتامين -د,47,464759,7707527078,16535,16695,16600,65,0.39,16584,49,0.3,16504,16695,1399-6-19
546,پلاسك,پلاسكوكار,47,84348,787810320,9830,9340,9340,-490,-4.98,9820,-10,-0.1,9340,9340,1399-6-19
547,زماهان,مجتمع توليد گوشت مرغ ماهان,47,38571,1069728114,29193,27734,27734,-1459,-5.0,29160,-33,-0.11,27734,27734,1399-6-19
548,خلنت,لنت‌ ترمزايران‌,47,15990,1533441000,100940,95900,95900,-5040,-4.99,100770,-170,-0.17,95900,95900,1399-6-19
549,خزر,فنرسازي‌زر,46,98649,941111460,10040,9540,9540,-500,-4.98,10030,-10,-0.1,9540,9540,1399-6-19
550,اخزا806,اسنادخزانه-م6بودجه98-000519,46,36820,31465004864,855016,854005,854276,-740,-0.09,854563,-453,-0.05,854005,859998,1399-6-19
551,ثامان,سامان‌ گستراصفهان‌,46,93637,2086232360,23450,22280,22280,-1170,-4.99,23400,-50,-0.21,22280,22280,1399-6-19
552,جهرم,پتروشيمي جهرم,45,168446,550481528,3439,3268,3268,-171,-4.97,3434,-5,-0.15,3268,3268,1399-6-19
553,سرود,سيمان‌شاهرود,45,130557,2163329490,17440,16570,16570,-870,-4.99,17400,-40,-0.23,16570,16570,1399-6-19
554,بنيرو,نيروترانس‌,45,24894,1816515180,76810,72970,72970,-3840,-5.0,76660,-150,-0.2,72970,72970,1399-6-19
555,فنرژي,گسترش صنايع انرژي آذرآب,44,172751,1902852265,11473,11015,11015,-458,-3.99,11381,-92,-0.8,11015,11015,1399-6-19
556,كقزوي,شيشه‌ قزوين‌,44,154292,1635649492,10928,10601,10601,-327,-2.99,10900,-28,-0.26,10601,10601,1399-6-19
557,غشصفا,شيرپاستوريزه‌پگاه‌اصفهان‌,44,35149,1033029110,30930,29390,29390,-1540,-4.98,30900,-30,-0.1,29390,29390,1399-6-19
558,كگاز,شيشه‌ و گاز,44,30532,772459600,26630,25300,25300,-1330,-4.99,26610,-20,-0.08,25300,25300,1399-6-19
559,سخند,صندوق س.سپهرخبرگان نفت-د,44,52920,531296660,10005,10000,10050,45,0.45,10040,35,0.35,10000,10050,1399-6-19
560,داريك,صندوق س.اعتماد داريك-د,43,549686,5454831308,9898,10010,9920,22,0.22,9924,26,0.26,9870,10010,1399-6-19
561,ولغدر,ليزينگ‌خودروغدير,43,63879,1209229470,19920,18930,18930,-990,-4.97,19890,-30,-0.15,18930,18930,1399-6-19
562,ضغدر8042,اختيارخ وغدير-15000-1399/08/26,43,1333,5337624000,2968,3400,4000,1032,34.77,4004,1036,34.91,3399,4500,1399-6-19
563,ثغربح,ح.شركت سرمايه گذاري مسكن شمالغ,42,338139,3027340800,9410,9410,8940,-470,-4.99,8953,-457,-4.86,8940,9410,1399-6-19
564,ساراب,سيمان‌ داراب‌,42,94841,1240520280,13760,13080,13080,-680,-4.94,13740,-20,-0.15,13080,13080,1399-6-19
565,بالاس,مهندسي ساختمان تاسيسات راه آهن,42,15227,773364103,53462,50789,50789,-2673,-5.0,53418,-44,-0.08,50789,50789,1399-6-19
566,فلات,گروه صنايع معادن فلات ايرانيان,42,385820,5690845000,15526,14750,14750,-776,-5.0,15273,-253,-1.63,14750,14750,1399-6-19
567,سخزر,سيمان‌ خزر,41,25548,883449840,36400,34580,34580,-1820,-5.0,36370,-30,-0.08,34580,34580,1399-6-19
568,سغرب,سيمان‌غرب‌,40,71019,1614261870,23920,22730,22730,-1190,-4.97,23880,-40,-0.17,22730,22730,1399-6-19
569,داراب,پتروشيمي داراب,40,214930,660909750,3236,3075,3075,-161,-4.98,3230,-6,-0.19,3075,3075,1399-6-19
570,چكاوه,صنايع‌كاغذسازي‌كاوه‌,39,26413,1007655950,40150,38150,38150,-2000,-4.98,40110,-40,-0.1,38150,38150,1399-6-19
571,كابگن,توليدي و صنعتي آبگينه‌,39,208780,923433940,4380,4423,4423,43,0.98,4388,8,0.18,4423,4423,1399-6-19
572,اخزا812,اسنادخزانه-م12بودجه98-001111,38,24904,19610350398,790416,785029,788002,-2414,-0.31,787438,-2978,-0.38,785029,789900,1399-6-19
573,زكشت,كشاورزي مكانيزه اصفهان كشت,38,236572,8559884676,38087,36183,36183,-1904,-5.0,37738,-349,-0.92,36183,36183,1399-6-19
574,ثپرديس,سرمايه گذاري مسكن پرديس,38,113382,1582359192,14690,13956,13956,-734,-5.0,14665,-25,-0.17,13956,13956,1399-6-19
575,هجرت,پخش هجرت,37,49248,3294641952,70420,66899,66899,-3521,-5.0,70170,-250,-0.36,66899,66899,1399-6-19
576,داسوه,داروسازي‌ اسوه‌,37,24010,895813100,39270,37310,37310,-1960,-4.99,39230,-40,-0.1,37310,37310,1399-6-19
577,ثالوند,سرمايه گذاري مسكن الوند,37,58005,894147075,16226,15415,15415,-811,-5.0,16211,-15,-0.09,15415,15415,1399-6-19
578,پلوله,گازلوله‌,37,805535,15923815880,19381,19768,19768,387,2.0,19768,387,2.0,19768,19768,1399-6-19
579,دسينا,داروسازي‌ سينا,36,41887,1399444670,35160,33410,33410,-1750,-4.98,35110,-50,-0.14,33410,33410,1399-6-19
580,اخزا807,اسنادخزانه-م7بودجه98-000719,36,10459,8676633569,830344,828007,831650,1306,0.16,829585,-759,-0.09,828007,832200,1399-6-19
581,ثشرق,سرمايه گذاري مسكن شمال شرق,36,112160,824376000,7730,7350,7350,-380,-4.92,7720,-10,-0.13,7350,7350,1399-6-19
582,فالوم,آلومتك‌,35,46135,1662013375,37921,36025,36025,-1896,-5.0,37754,-167,-0.44,36025,36025,1399-6-19
583,حخزر,كشتيراني درياي خزر,35,45858,1398347994,32097,30493,30493,-1604,-5.0,32047,-50,-0.16,30493,30493,1399-6-19
584,ضچاد7024,اختيارخ كچاد-23300-1399/07/07,34,171,86949000,225,120,625,400,177.78,508,283,125.78,120,1284,1399-6-19
585,ولبهمن,شركت بهمن ليزينگ,34,72279,779890410,11357,10790,10790,-567,-4.99,11347,-10,-0.09,10790,10790,1399-6-19
586,سشمال,سيمان‌ شمال‌,33,57891,755477550,13730,13050,13050,-680,-4.95,13720,-10,-0.07,13050,13050,1399-6-19
587,ضجار7024,اختيارخ وتجارت-3200-1399/07/22,33,1071,477580000,234,440,499,265,113.25,446,212,90.6,400,500,1399-6-19
588,وجامي,سرمايه گذاري جامي,32,193860,2252653200,11979,11620,11620,-359,-3.0,11940,-39,-0.33,11620,11620,1399-6-19
589,شتولي,تولي‌پرس‌,31,54415,977728720,18334,17968,17968,-366,-2.0,18298,-36,-0.2,17968,17968,1399-6-19
590,وهنر,گروه توسعه هنر ايران,31,120177,699189786,5997,5818,5818,-179,-2.98,5990,-7,-0.12,5818,5818,1399-6-19
591,بشهاب,لامپ‌  پارس‌ شهاب‌,31,15286,1123979580,77390,73530,73530,-3860,-4.99,77300,-90,-0.12,73530,73530,1399-6-19
592,غگلپا,شير پاستوريزه پگاه گلپايگان,31,72827,5423936479,78396,74477,74477,-3919,-5.0,77948,-448,-0.57,74477,74477,1399-6-19
593,زعف9908پ09,زعفران9908نگين نوين(پ),31,19320,1822439143,91156,93900,95863,4707,5.16,94329,3173,3.48,91084,95863,1399-6-19
594,بايكا,كارخانجات كابلسازي ‌ايران‌,31,39421,1652528320,44126,41920,41920,-2206,-5.0,43921,-205,-0.46,41920,41920,1399-6-19
595,چافست,افست‌,31,70460,1847461200,27600,26220,26220,-1380,-5.0,27550,-50,-0.18,26220,26220,1399-6-19
596,كسعدي,كاشي‌ سعدي‌,31,38196,2508331320,69120,65670,65670,-3450,-4.99,68940,-180,-0.26,65670,65670,1399-6-19
597,وثنو,سرمايه گذاري ساختماني نوين,31,27453,512382792,19241,18664,18664,-577,-3.0,19226,-15,-0.08,18664,18664,1399-6-19
598,بمپنا,توليد برق عسلويه  مپنا,31,8636,969511904,118172,112264,112264,-5908,-5.0,118050,-122,-0.1,112264,112264,1399-6-19
599,فيروزه2,صندوق شاخص30 شركت فيروزه- سهام,30,300000,300000,179670,1,1,-179669,-100.0,1,-179669,-100.0,1,1,1399-6-19
600,لازما,كارخانه هاي صنعتي آزمايش,30,42031,1354995378,32895,32238,32238,-657,-2.0,32803,-92,-0.28,32238,32238,1399-6-19
601,تپولا,مهندسي مرآت پولاد,29,120770,1936788490,16881,16037,16037,-844,-5.0,16797,-84,-0.5,16037,16037,1399-6-19
602,ثغرب,شركت سرمايه گذاري مسكن شمالغرب,28,71771,991659907,14544,13817,13817,-727,-5.0,14529,-15,-0.1,13817,13817,1399-6-19
603,حپترو,حمل و نقل پتروشيمي( سهامي عام,28,15761,487330120,32540,30920,30920,-1620,-4.98,32520,-20,-0.06,30920,30920,1399-6-19
604,اخزا820,اسنادخزانه-م20بودجه98-020806,28,133010,78671749281,590964,587258,588000,-2964,-0.5,591472,508,0.09,587258,592469,1399-6-19
605,سمتاز,سيمان ممتازان كرمان,28,21442,467864440,22494,21820,21820,-674,-3.0,22477,-17,-0.08,21820,21820,1399-6-19
606,تشتاد,صنايع توليدي اشتاد ايران‌,28,56431,766332980,13999,13580,13580,-419,-2.99,13982,-17,-0.12,13580,13580,1399-6-19
607,وتوشه,سرمايه‌ گذاري‌ پارس‌ توشه‌,27,72462,1824593160,26500,25180,25180,-1320,-4.98,26450,-50,-0.19,25180,25180,1399-6-19
608,افرا,افرانت,27,20696,1466249512,74575,70847,70847,-3728,-5.0,74457,-118,-0.16,70847,70847,1399-6-19
609,اخزا703,اسنادخزانه-م3بودجه97-990721,27,44850,44136952503,983437,983606,984500,1063,0.11,984101,664,0.07,983606,984997,1399-6-19
610,ضغدر8043,اختيارخ وغدير-16000-1399/08/26,27,412,1485150000,2612,3700,3890,1278,48.93,3605,993,38.02,3200,3890,1399-6-19
611,خفنر,فنرسازي‌خاور,26,33925,684267250,21230,20170,20170,-1060,-4.99,21210,-20,-0.09,20170,20170,1399-6-19
612,كساپا,سايپاشيشه‌,26,69791,1434205050,21630,20550,20550,-1080,-4.99,21600,-30,-0.14,20550,20550,1399-6-19
613,زعف9908پ16,زعفران9908نگين بيرجند(پ),26,9809,928651470,91678,93900,94510,2832,3.09,94673,2995,3.27,91401,95599,1399-6-19
614,دلقما,دارويي‌ لقمان‌,25,16370,570167100,36660,34830,34830,-1830,-4.99,36640,-20,-0.05,34830,34830,1399-6-19
615,غپآذر,شير پگاه آذربايجان شرقي,25,8615,482629530,58970,56022,56022,-2948,-5.0,58940,-30,-0.05,56022,56022,1399-6-19
616,وپسا,س. پتروشيمي ساختمان  خليج فارس,25,215105,1119191315,5476,5203,5203,-273,-4.99,5460,-16,-0.29,5203,5203,1399-6-19
617,لپيام,گسترش صنايع پيام,25,15278,486237628,32475,31826,31826,-649,-2.0,32442,-33,-0.1,31826,31826,1399-6-19
618,خكمك,كمك‌فنرايندامين‌,24,25117,1450255580,60770,57740,57740,-3030,-4.99,60680,-90,-0.15,57740,57740,1399-6-19
619,كلوند,كاشي‌ الوند,24,15089,396086250,27630,26250,26250,-1380,-4.99,27620,-10,-0.04,26250,26250,1399-6-19
620,اطلس2,صندوق س.توسعه اندوخته آينده-س,24,240000,240000,182208,1,1,-182207,-100.0,1,-182207,-100.0,1,1,1399-6-19
621,لخزر,پارس‌ خزر,24,7303,1640618950,236470,224650,224650,-11820,-5.0,236050,-420,-0.18,224650,224650,1399-6-19
622,وارس,سرمايه گذاري ارس صبا,23,16157,1947047756,124235,120508,120508,-3727,-3.0,123841,-394,-0.32,120508,120508,1399-6-19
623,سفار,سيمان‌فارس‌,23,9423,1010710980,112900,107260,107260,-5640,-5.0,112780,-120,-0.11,107260,107260,1399-6-19
624,ضصاد8020,اختيارخ وبصادر-4400-1399/08/11,23,493,176355000,202,210,410,208,102.97,358,156,77.23,200,590,1399-6-19
625,كپرور,فرآوري زغال سنگ پروده طبس,22,16198,739438700,48052,45650,45650,-2402,-5.0,48014,-38,-0.08,45650,45650,1399-6-19
626,نتوس,پشم‌ بافي‌ توس,22,29442,322595994,11295,10957,10957,-338,-2.99,11289,-6,-0.05,10957,10957,1399-6-19
627,تكنو,تكنوتار,22,52481,772520320,15490,14720,14720,-770,-4.97,15480,-10,-0.06,14720,14720,1399-6-19
628,سرو2,صندوق س سروسودمند مدبران-سهام,22,2200000,2200000,59050,1,1,-59049,-100.0,1,-59049,-100.0,1,1,1399-6-19
629,شمواد,توليد مواداوليه الياف مصنوعي,22,31430,2027675020,66509,64514,64514,-1995,-3.0,66297,-212,-0.32,64514,64514,1399-6-19
630,لخانه,لوازم‌ خانگي‌ پارس‌,22,37962,2208818970,59984,58185,58185,-1799,-3.0,59779,-205,-0.34,58185,58185,1399-6-19
631,پارتا,مجتمع‌صنعتي‌آرتاويل‌تاير,22,5078,329648526,68333,64917,64917,-3416,-5.0,68297,-36,-0.05,64917,64917,1399-6-19
632,اخزا704,اسنادخزانه-م4بودجه97-991022,21,74616,70669286707,947655,945000,950000,2345,0.25,947106,-549,-0.06,943007,950000,1399-6-19
633,شسم,توليد سموم‌ علف‌ كش,21,6463,498277911,75586,77097,77097,1511,2.0,75660,74,0.1,77097,77097,1399-6-19
634,فنفت,صنايع تجهيزات نفت,21,104789,1807610250,17783,17250,17250,-533,-3.0,17730,-53,-0.3,17250,17250,1399-6-19
635,ساذري,آذريت‌,21,4656,811927248,169304,174383,174383,5079,3.0,169489,185,0.11,174383,174383,1399-6-19
636,ضجار7018,اختيارخ وتجارت-2000-1399/07/22,21,374,468184000,1073,901,1391,318,29.64,1252,179,16.68,901,1391,1399-6-19
637,سكرما,سيمان‌ كرمان‌,21,51814,940424100,19100,18150,18150,-950,-4.97,19080,-20,-0.1,18150,18150,1399-6-19
638,ضصاد8000,اختيارخ وبصادر-1200-1399/08/11,20,345,783587000,2027,2000,2299,272,13.42,2271,244,12.04,2000,2400,1399-6-19
639,فمراد,آلومراد,20,4733,716481540,159340,151380,151380,-7960,-5.0,159220,-120,-0.08,151380,151380,1399-6-19
640,زعف9908پ08,زعفران9908نگين روستا(پ),20,7106,654506520,90975,88200,94640,3665,4.03,92106,1131,1.24,88000,94640,1399-6-19
641,ضغدر8044,اختيارخ وغدير-17000-1399/08/26,20,257,797440000,2983,3000,3000,17,0.57,3103,120,4.02,3000,3200,1399-6-19
642,سفاسي,شركت فارسيت اهواز,20,37867,432024603,11761,11409,11409,-352,-2.99,11753,-8,-0.07,11409,11409,1399-6-19
643,وثخوز,سرمايه گذاري و توسعه خوزستان,20,18434,671071336,38320,36404,36404,-1916,-5.0,38251,-69,-0.18,36404,36404,1399-6-19
644,اخزا902,اسنادخزانه-م2بودجه99-011019,20,33803,22473471000,1000000,663000,666003,-333997,-33.4,664837,-335163,-33.52,663000,666005,1399-6-19
645,سقاين,سيمان‌ قائن‌,20,5251,238185360,47740,45360,45360,-2380,-4.99,47730,-10,-0.02,45360,45360,1399-6-19
646,مداران,داده‌پردازي‌ايران‌,20,18725,662490500,37240,35380,35380,-1860,-4.99,37210,-30,-0.08,35380,35380,1399-6-19
647,معيار,سرمايه گذاري معيار صنعت پارس,20,11115,328470480,30155,29552,29552,-603,-2.0,30136,-19,-0.06,29552,29552,1399-6-19
648,گنجين2,صندوق س. گنجينه يكم آويد-د,20,2000000,2000000,11245,1,1,-11244,-99.99,1,-11244,-99.99,1,1,1399-6-19
649,كرونا2,تامين مالي جمعي صرفا اهداي سود,19,20000,200000000,10000,10000,10000,0,0.0,10000,0,0.0,10000,10000,1399-6-19
650,اخزا813,اسنادخزانه-م13بودجه98-010219,19,33088,24804286031,751104,748031,751002,-102,-0.01,749646,-1458,-0.19,748031,752000,1399-6-19
651,دكيمي,كيميدارو,19,7697,226137860,30920,29380,29380,-1540,-4.98,30910,-10,-0.03,29380,29380,1399-6-19
652,ضجار7010,اختيارخ وتجارت-1200-1399/07/22,18,151,279391000,1710,1600,2099,389,22.75,1850,140,8.19,1600,2099,1399-6-19
653,اخزا624,اسنادخزانه-م24بودجه96-990625,18,5099,5076296834,995627,997450,997250,1623,0.16,995547,-80,-0.01,995521,997450,1399-6-19
654,وتعاون,بيمه  تعاون,18,22547,133027300,6082,5900,5900,-182,-2.99,6081,-1,-0.02,5900,5900,1399-6-19
655,تملي704,تسهيلات مسكن ب. ملي-تير97,18,276,146570575,505765,531053,531000,25235,4.99,531053,25288,5.0,531000,531053,1399-6-19
656,خچرخش,چرخشگر,18,84105,1823396400,22820,21680,21680,-1140,-5.0,22780,-40,-0.18,21680,21680,1399-6-19
657,ضصاد8012,اختيارخ وبصادر-2800-1399/08/11,17,121,122080000,1061,1000,1200,139,13.1,1009,-52,-4.9,900,1200,1399-6-19
658,وايرا,سرمايه گذاري صنايع ايران,17,37971,339840450,9421,8950,8950,-471,-5.0,9413,-8,-0.08,8950,8950,1399-6-19
659,ثرود,سرمايه‌گذاري مسكن زاينده رود,17,66845,835361965,13154,12497,12497,-657,-4.99,13142,-12,-0.09,12497,12497,1399-6-19
660,ضغدر8045,اختيارخ وغدير-18000-1399/08/26,17,112,341790000,3500,2990,2700,-800,-22.86,3052,-448,-12.8,2700,3200,1399-6-19
661,اخزا810,اسنادخزانه-م10بودجه98-001006,17,29108,23511810310,804600,805000,802950,-1650,-0.21,807744,3144,0.39,802564,814999,1399-6-19
662,ولانا,شركت ليزينگ آريا دانا,17,25813,710967459,28394,27543,27543,-851,-3.0,28362,-32,-0.11,27543,27543,1399-6-19
663,خموتور,موتورسازان‌تراكتورسازي‌ايران‌,17,37950,505494000,14020,13320,13320,-700,-4.99,14010,-10,-0.07,13320,13320,1399-6-19
664,فنورد,نوردوقطعات‌ فولادي‌,17,11068,1336018280,114970,120710,120710,5740,4.99,115110,140,0.12,120710,120710,1399-6-19
665,اخزا721,اسنادخزانه-م21بودجه97-000728,17,23435,19378333273,828086,825022,827013,-1073,-0.13,826897,-1189,-0.14,825022,829000,1399-6-19
666,ضفلا8085,اختيارخ فولاد-16775-1399/08/28,16,208,764760000,2838,2900,4590,1752,61.73,3677,839,29.56,2900,4880,1399-6-19
667,غبهار,كشت وصنعت بهاران گلبهار خراسان,16,6486,269220888,42791,41508,41508,-1283,-3.0,42773,-18,-0.04,41508,41508,1399-6-19
668,زعف9908پ13,زعفران9908پوشالمعمول روستا(پ),16,2790,191649421,66924,68990,68600,1676,2.5,68692,1768,2.64,64416,68990,1399-6-19
669,ضصاد8016,اختيارخ وبصادر-3600-1399/08/11,16,262,172300000,791,650,700,-91,-11.5,658,-133,-16.81,649,700,1399-6-19
670,تملي612,تسهيلات مسكن بانك ملي-اسفند96,16,139,231793375,1591441,1671013,1671013,79572,5.0,1667578,76137,4.78,1511869,1671013,1399-6-19
671,ضجار7016,اختيارخ وتجارت-1800-1399/07/22,16,118,163020000,1002,1100,1500,498,49.7,1382,380,37.92,1100,1500,1399-6-19
672,زعف9908پ11,زعفران9908نگين سحرخيز(پ),16,1000,95256448,94681,95000,96122,1441,1.52,95256,575,0.61,94000,96122,1399-6-19
673,گكيش,توريستي ورفاهي آبادگران كيش,15,13981,989938686,72995,70806,70806,-2189,-3.0,72883,-112,-0.15,70806,70806,1399-6-19
674,تپمپي,پمپ‌ سازي‌ ايران‌,15,4178,206852780,52110,49510,49510,-2600,-4.99,52100,-10,-0.02,49510,49510,1399-6-19
675,كطبس,ذغال‌سنگ‌ نگين‌ ط‌بس‌,15,14143,764146290,56870,54030,54030,-2840,-4.99,56820,-50,-0.09,54030,54030,1399-6-19
676,سكه0012پ01,سكه تمام بهارتحويلي 1روزه رفاه,15,32400,37770073200,1154201,1165743,1165743,11542,1.0,1165743,11542,1.0,1165743,1165743,1399-6-19
677,ضگل8057,اختيارخ كگل-13100-1399/08/21,14,115,1020750000,6550,8850,8800,2250,34.35,8876,2326,35.51,8800,9000,1399-6-19
678,صايپا908,صكوك مرابحه سايپا908-3ماهه 18%,14,89,89076008,999409,999000,1005000,5591,0.56,1000854,1445,0.14,998000,1008000,1399-6-19
679,قمرو,قند مرودشت‌,14,3673,130464960,37380,35520,35520,-1860,-4.98,37370,-10,-0.03,35520,35520,1399-6-19
680,دقاضي,داروسازي شهيد قاضي,14,42677,4246788270,102587,99510,99510,-3077,-3.0,101908,-679,-0.66,99510,99510,1399-6-19
681,ثتوسا,س.توسعه و عمران استان اردبيل,14,8351,639753408,78977,76608,76608,-2369,-3.0,78899,-78,-0.1,76608,76608,1399-6-19
682,ضغدر8041,اختيارخ وغدير-14000-1399/08/26,14,185,927685000,5100,4999,4800,-300,-5.88,5015,-85,-1.67,4800,5200,1399-6-19
683,زعف9908پ14,زعفران9908پوشالمعمول نوين(پ),13,1211,82748254,65886,68990,67998,2112,3.21,68331,2445,3.71,65006,68999,1399-6-19
684,قلرست,قند لرستان‌,13,16382,453289940,29120,27670,27670,-1450,-4.98,29110,-10,-0.03,27670,27670,1399-6-19
685,كپشير,پشم‌شيشه‌ايران‌,13,13513,719432120,56040,53240,53240,-2800,-5.0,56000,-40,-0.07,53240,53240,1399-6-19
686,ثنام,س ساختماني ب نام آوران مهندسي,13,43939,947544535,22231,21565,21565,-666,-3.0,22197,-34,-0.15,21565,21565,1399-6-19
687,شجمح,ح. صنايع پتروشيمي تخت جمشيد,13,71120,537311600,7788,7555,7555,-233,-2.99,7555,-233,-2.99,7555,7555,1399-6-19
688,ضملي8082,اختيارخ فملي-39750-1399/08/06,13,140,565300000,3286,4800,3700,414,12.6,4038,752,22.88,3700,4800,1399-6-19
689,فسديد,لوله‌وتجهيزات‌ سديد - ورشكسته,12,46216,5235440912,111061,113282,113282,2221,2.0,113282,2221,2.0,113282,113282,1399-6-19
690,استارز,ص.ج.ستاره برتر20%تاديه,12,16750,3350000000,200000,200000,200000,0,0.0,200000,0,0.0,200000,200000,1399-6-19
691,سفارود,كارخانه فارسيت درود,12,17713,121050642,7118,6834,6834,-284,-3.99,7114,-4,-0.06,6834,6834,1399-6-19
692,ضملي8078,اختيارخ فملي-31750-1399/08/06,12,59,345950000,3000,5000,6000,3000,100.0,5864,2864,95.47,5000,6000,1399-6-19
693,سكه9912پ04,سكه تمام بهارتحويل1روزه صادرات,12,17900,20866799700,1154201,1165743,1165743,11542,1.0,1165743,11542,1.0,1165743,1165743,1399-6-19
694,ضصاد8008,اختيارخ وبصادر-2000-1399/08/11,12,77,120314000,1774,1750,1500,-274,-15.45,1563,-211,-11.89,1500,1900,1399-6-19
695,پدرخش,درخشان‌ تهران‌,12,2506,551520480,231660,220080,220080,-11580,-5.0,231530,-130,-0.06,220080,220080,1399-6-19
696,شكبير,پتروشيمي اميركبير,12,3272,204450920,64417,62485,62485,-1932,-3.0,64413,-4,-0.01,62485,62485,1399-6-19
697,اخزا713,اسنادخزانه-م13بودجه97-000518,12,17024,14546402361,855873,854500,862000,6127,0.72,854464,-1409,-0.16,854217,862000,1399-6-19
698,ثاباد,توريستي ورفاهي آبادگران ايران,12,8441,273826040,34140,32440,32440,-1700,-4.98,34130,-10,-0.03,32440,32440,1399-6-19
699,زنگان,صنعت روي زنگان,11,1061,165753664,164446,156224,156224,-8222,-5.0,164417,-29,-0.02,156224,156224,1399-6-19
700,ضفار8029,اختيارخ فارس-7326-1399/08/06,11,104,1449000000,11500,12000,14000,2500,21.74,13933,2433,21.16,12000,14000,1399-6-19
701,ضصاد8018,اختيارخ وبصادر-4000-1399/08/11,11,100,53000000,647,530,530,-117,-18.08,530,-117,-18.08,530,530,1399-6-19
702,غمهرا,توليدي‌مهرام‌,10,5920,629177600,111870,106280,106280,-5590,-5.0,111800,-70,-0.06,106280,106280,1399-6-19
703,زير0003پ04,زيره سبز0003شركت مينوبذر(پ),10,175,76154404,444673,429185,429190,-15483,-3.48,435168,-9505,-2.14,429185,469000,1399-6-19
704,ضجار7025,اختيارخ وتجارت-3400-1399/07/22,10,54,27000000,207,500,500,293,141.55,500,293,141.55,500,500,1399-6-19
705,ضصاد8002,اختيارخ وبصادر-1400-1399/08/11,10,271,571300000,1700,1800,2300,600,35.29,2108,408,24.0,1800,2300,1399-6-19
706,ضغدر8040,اختيارخ وغدير-13000-1399/08/26,10,187,1063300000,6000,5000,5850,-150,-2.5,5686,-314,-5.23,5000,5900,1399-6-19
707,زعف9908پ12,زعفران9908پوشالمعمول سحرخيز(پ),10,817,55613064,64654,65002,67000,2346,3.63,68070,3416,5.28,65002,69180,1399-6-19
708,لسرما,سرما آفرين‌,10,54021,1409948100,27470,26100,26100,-1370,-4.99,27430,-40,-0.15,26100,26100,1399-6-19
709,سخواف,سيمان مجد خواف,10,7691,133285030,17865,17330,17330,-535,-2.99,17861,-4,-0.02,17330,17330,1399-6-19
710,پلاست,كارخانجات توليدي پلاستيران,9,6799,289854968,43950,42632,42632,-1318,-3.0,43930,-20,-0.05,42632,42632,1399-6-19
711,صايپا012,صكوك مرابحه سايپا012-3ماهه 16%,9,155,153133610,1004236,984545,990000,-14236,-1.42,987959,-16277,-1.62,984545,990000,1399-6-19
712,سكارون,سيمان كارون,9,1332,158361480,122566,118890,118890,-3676,-3.0,122534,-32,-0.03,118890,118890,1399-6-19
713,زعف9908پ17,زعفران9908پوشالمعمول بيرجند(پ),9,1766,117494896,65966,62901,68000,2034,3.08,66532,566,0.86,62901,68000,1399-6-19
714,اخزا819,اسنادخزانه-م19بودجه98-020322,9,858,540491882,622222,630000,630000,7778,1.25,629944,7722,1.24,623126,630000,1399-6-19
715,شستا003,اجاره تامين اجتماعي-سپهر000523,8,135,141750000,1029686,1050000,1050000,20314,1.97,1050000,20314,1.97,1050000,1050000,1399-6-19
716,ضجار7031,اختيارخ وتجارت-4600-1399/07/22,8,48,9851000,119,199,243,124,104.2,205,86,72.27,181,270,1399-6-19
717,ضصاد8001,اختيارخ وبصادر-1300-1399/08/11,8,110,239990000,1975,1900,2300,325,16.46,2182,207,10.48,1900,2300,1399-6-19
718,اخزا723,اسنادخزانه-م23بودجه97-000824,8,32926,26932564778,819489,815011,819500,11,0.0,817973,-1516,-0.18,815011,819500,1399-6-19
719,سكه0112پ03,سكه تمام بهارتحويلي1روزه سامان,8,5500,6411586500,1154201,1165743,1165743,11542,1.0,1165743,11542,1.0,1165743,1165743,1399-6-19
720,غشوكو,شوكو پارس,8,1823,81201889,45920,44543,44543,-1377,-3.0,45914,-6,-0.01,44543,44543,1399-6-19
721,ضگل8061,اختيارخ كگل-17100-1399/08/21,8,85,557500000,6500,7000,6500,0,0.0,6559,59,0.91,6500,7000,1399-6-19
722,ضمخا7049,اختيارخ اخابر-13750-1399/07/30,8,237,1913070000,8807,11500,7900,-907,-10.3,8072,-735,-8.35,7000,11500,1399-6-19
723,دشيري,شيرين دارو,7,512,99766272,200882,194856,194856,-6026,-3.0,200850,-32,-0.02,194856,194856,1399-6-19
724,ضملي8072,اختيارخ فملي -19750-1399/08/06,7,38,535722000,10000,12222,15000,5000,50.0,14098,4098,40.98,12222,15000,1399-6-19
725,صمسكن912,ص دين مسكن جنوب-ماهانه16درصد,7,211,40570796,192852,183252,197498,4646,2.41,192279,-573,-0.3,183252,197498,1399-6-19
726,ضصاد8015,اختيارخ وبصادر-3400-1399/08/11,7,103,82830000,567,900,800,233,41.09,804,237,41.8,800,900,1399-6-19
727,پست9908-02,پسته فندقي32-30طلاسبززرند9908,7,154,194620022,1241683,1200000,1303767,62084,5.0,1263766,22083,1.78,1200000,1303767,1399-6-19
728,اعتماد2,صندوق س.اعتماد آفرين پارسيان-د,7,70000000,70000000,32261,1,1,-32260,-100.0,1,-32260,-100.0,1,1,1399-6-19
729,حرهشا,رهشاد سپاهان (سهامي عام,6,1057,62588141,62329,59213,59213,-3116,-5.0,62319,-10,-0.02,59213,59213,1399-6-19
730,اخزا805,اسنادخزانه-م5بودجه98-000422,6,3513,3040953569,865253,865510,865667,414,0.05,865629,376,0.04,865501,905000,1399-6-19
731,غنيلي,مجتمع توليدي نيلي صنعت كرمان,6,255000,4338695000,17777,17243,17000,-777,-4.37,17014,-763,-4.29,17000,17243,1399-6-19
732,ضچاد7013,اختيارخ كچاد-10300-1399/07/07,6,12,81050000,4515,5850,8000,3485,77.19,6754,2239,49.59,5850,8000,1399-6-19
733,ضخوز7028,اختيارخ فخوز-43470-1399/07/20,6,23,208999000,5651,9000,9500,3849,68.11,9087,3436,60.8,9000,9999,1399-6-19
734,ضجار7026,اختيارخ وتجارت-3600-1399/07/22,6,89,36010000,203,500,380,177,87.19,405,202,99.51,350,500,1399-6-19
735,فافزا,فولاد افزا سپاهان,6,1735,82832370,49218,47742,47742,-1476,-3.0,49212,-6,-0.01,47742,47742,1399-6-19
736,صايپا998,صكوك مرابحه سايپا998-3ماهه 18%,5,25,25062800,1000001,1004900,994950,-5051,-0.51,1002512,2511,0.25,994950,1004900,1399-6-19
737,تملي701,تسهيلات مسكن ب. ملي-فروردين97,5,174,61759908,338040,354942,354942,16902,5.0,354942,16902,5.0,354942,354942,1399-6-19
738,رنيكح,ح.جنرال مكانيك,5,20971,510601908,25629,24348,24348,-1281,-5.0,24348,-1281,-5.0,24348,24348,1399-6-19
739,زعف9908پ15,زعفران9908پوشالمعمول طلاسرخ(پ),5,545,35984900,66112,63515,68500,2388,3.61,66027,-85,-0.13,63515,68500,1399-6-19
740,سكه0011پ02,سكه تمام بهارتحويلي 1روزه ملت,5,600,699445800,1154201,1165743,1165743,11542,1.0,1165743,11542,1.0,1165743,1165743,1399-6-19
741,ضمخا7050,اختيارخ اخابر-14750-1399/07/30,5,113,786000000,9000,7000,6000,-3000,-33.33,6956,-2044,-22.71,6000,7500,1399-6-19
742,فن آوا,گروه فن آوا,5,1965,28242945,14666,14373,14373,-293,-2.0,14665,-1,-0.01,14373,14373,1399-6-19
743,خعمرا,توسعه و عمران شهرستان نائين,5,5700,77839200,13259,13656,13656,397,2.99,13260,1,0.01,13656,13656,1399-6-19
744,ضگل8058,اختيارخ كگل-14100-1399/08/21,5,67,600000000,9000,8400,9000,0,0.0,8955,-45,-0.5,8400,9000,1399-6-19
745,ساروج,بين المللي ساروج بوشهر,5,5668,141529960,25742,24970,24970,-772,-3.0,25736,-6,-0.02,24970,24970,1399-6-19
746,ضصاد8010,اختيارخ وبصادر-2400-1399/08/11,5,32,43940000,1600,1210,1450,-150,-9.38,1373,-227,-14.19,1200,1450,1399-6-19
747,اخزا804,اسنادخزانه-م4بودجه98-000421,4,1006,871075885,865028,865610,878456,13428,1.55,865881,853,0.1,865610,878456,1399-6-19
748,ضغدر8037,اختيارخ وغدير-10000-1399/08/26,4,15,120900000,6250,8100,8080,1830,29.28,8060,1810,28.96,8000,8100,1399-6-19
749,اخزا720,اسنادخزانه-م20بودجه97-000324,4,1243,1089690441,881004,875000,877718,-3286,-0.37,876662,-4342,-0.49,875000,886900,1399-6-19
750,ضپنا7046,اختيارخ رمپنا-44457-1399/07/13,4,9,1304000,50,100,200,150,300.0,145,95,190.0,100,200,1399-6-19
751,تپكو4,توليدتجهيزات‌سنگين‌هپكو,4,4000,22360000,5590,5590,5590,0,0.0,5590,0,0.0,5590,5590,1399-6-19
752,اخزا722,اسنادخزانه-م22بودجه97-000428,4,1683,1455183628,865515,862708,869999,4484,0.52,864637,-878,-0.1,862708,875000,1399-6-19
753,ضفار8041,اختيارخ فارس-16826-1399/08/06,4,10,29998000,4600,2999,3000,-1600,-34.78,3000,-1600,-34.78,2999,3000,1399-6-19
754,ضغدر8048,اختيارخ وغدير-22000-1399/08/26,4,17,42500000,3100,2500,2500,-600,-19.35,2500,-600,-19.35,2500,2500,1399-6-19
755,ضچاد7012,اختيارخ كچاد-9300-1399/07/07,4,5,45500000,9000,9000,9000,0,0.0,9100,100,1.11,9000,9500,1399-6-19
756,پست9908-04,پسته فندقي32-30سبزدانه9908,4,29,37215043,1223809,1279999,1303767,79958,6.53,1283277,59468,4.86,1279999,1303767,1399-6-19
757,صگل1411,ص اجاره گل گهر 1411-3 ماهه 17%,4,11860,12031033060,1014421,1521631,1014421,0,0.0,1014421,0,0.0,1014421,1014421,1399-6-19
758,ضپار8019,اختيارخ خپارس-3800-1399/08/18,4,4,26676000,6017,5176,7000,983,16.34,6669,652,10.84,5176,7500,1399-6-19
759,ضملي8079,اختيارخ فملي-33750-1399/08/06,4,21,129610000,7067,6190,6000,-1067,-15.1,6172,-895,-12.66,6000,6190,1399-6-19
760,ضگل8062,اختيارخ كگل-18100-1399/08/21,4,17,82901000,5500,6000,5500,0,0.0,4877,-623,-11.33,1600,6000,1399-6-19
761,عسناسنگ,سلف كنستانتره سنگ آهن سناباد,3,3,19971452,6783106,6660000,6655726,-127380,-1.88,6657150,-125956,-1.86,6655726,6660000,1399-6-19
762,تابا,تابان نيرو سپاهان,3,2564,81671092,32838,31853,31853,-985,-3.0,32834,-4,-0.01,31853,31853,1399-6-19
763,تملي703,تسهيلات مسكن ب. ملي-خرداد97,3,38,6682528,167482,175856,175856,8374,5.0,175856,8374,5.0,175856,175856,1399-6-19
764,كگل2,معدني و صنعتي گل گهر,3,2430104,48674983120,19080,19090,20030,950,4.98,20030,950,4.98,20030,20030,1399-6-19
765,ضفلا8088,اختيارخ فولاد-19775-1399/08/28,3,60,210000000,1800,3500,3500,1700,94.44,3500,1700,94.44,3500,3500,1399-6-19
766,ضجار7017,اختيارخ وتجارت-1900-1399/07/22,3,43,68513000,1660,1559,1600,-60,-3.61,1593,-67,-4.04,1559,1600,1399-6-19
767,صايپا203,صكوك مرابحه سايپا203-3ماهه 16%,3,1012,971460186,956757,955010,960000,3243,0.34,959941,3184,0.33,955010,960000,1399-6-19
768,اخزا718,اسنادخزانه-م18بودجه97-000525,3,1077,917100565,852738,851501,856999,4261,0.5,851533,-1205,-0.14,851501,856999,1399-6-19
769,ضمخا7036,اختيارخ اخابر-2750-1399/07/30,3,3,49500000,18500,15500,17500,-1000,-5.41,16500,-2000,-10.81,15500,17500,1399-6-19
770,ضمخا7038,اختيارخ اخابر-3150-1399/07/30,3,3,46500000,1,15000,16000,15999,1599900.0,15500,15499,1549900.0,15000,16000,1399-6-19
771,ضفار8037,اختيارخ فارس-12826-1399/08/06,3,6,34800000,4911,6000,5000,89,1.81,5800,889,18.1,5000,6000,1399-6-19
772,ضملي8081,اختيارخ فملي-37750-1399/08/06,3,5,20000000,8774,4000,4000,-4774,-54.41,4000,-4774,-54.41,4000,4000,1399-6-19
773,تملي712,تسهيلات مسكن ب. ملي-اسفند97,3,63,21269493,321535,337611,337611,16076,5.0,337611,16076,5.0,337611,337611,1399-6-19
774,ضغدر8039,اختيارخ وغدير-12000-1399/08/26,3,26,148980000,7282,5500,6480,-802,-11.01,5730,-1552,-21.31,5500,6500,1399-6-19
775,لوتوس99,اجاره لوتوس پارسيان990717,3,25,25025000,1002537,1000000,1005000,2463,0.25,1001000,-1537,-0.15,1000000,1005000,1399-6-19
776,صگل411,ص اجاره گل گهر 411- 3 ماهه 17%,3,20,20000000,950010,1000000,1000000,49990,5.26,1000000,49990,5.26,1000000,1000000,1399-6-19
777,شتهران,داروسازي تهران شيمي,3,22308,186717960,8206,8370,8370,164,2.0,8209,3,0.04,8370,8370,1399-6-19
778,ضملي8069,اختيارخ فملي -16750-1399/08/06,3,41,695000000,10833,18000,17500,6667,61.54,16951,6118,56.48,15000,18000,1399-6-19
779,ضگل8059,اختيارخ كگل-15100-1399/08/21,3,67,518500000,7900,7500,8400,500,6.33,7739,-161,-2.04,7500,8400,1399-6-19
780,سپرمي,پرميت‌,3,20604,172682124,8465,8381,8381,-84,-0.99,8462,-3,-0.04,8381,8381,1399-6-19
781,ضملي8058,اختيارخ فملي -7750-1399/08/06,3,10,294700000,25689,29400,29600,3911,15.22,29470,3781,14.72,29400,29600,1399-6-19
782,ضجار7027,اختيارخ وتجارت-3800-1399/07/22,3,22,5560000,570,300,280,-290,-50.88,253,-317,-55.61,200,300,1399-6-19
783,ضفلا8078,اختيارخ فولاد-9775-1399/08/28,2,37,314500000,6210,8500,8500,2290,36.88,8500,2290,36.88,8500,8500,1399-6-19
784,ضصاد8021,اختيارخ وبصادر-4600-1399/08/11,2,27,8440000,646,320,300,-346,-53.56,313,-333,-51.55,300,320,1399-6-19
785,صخود0004,صكوك رهني خودرو0004- 3ماهه 16%,2,35,33950000,994250,970000,970000,-24250,-2.44,970000,-24250,-2.44,970000,970000,1399-6-19
786,ضپنا7047,اختيارخ رمپنا-48507-1399/07/13,2,40,28000000,699,700,700,1,0.14,700,1,0.14,700,700,1399-6-19
787,مبين0112,اجاره اعتماد مبين لوتوس010710,2,2000000,1950000000000,977000,1000000,950000,-27000,-2.76,975000,-2000,-0.2,950000,1000000,1399-6-19
788,ضچاد7020,اختيارخ كچاد-17300-1399/07/07,2,17,45866000,1200,2698,2698,1498,124.83,2698,1498,124.83,2698,2698,1399-6-19
789,صايپا0122,صكوك مرابحه سايپا012-3ماهه 16%,2,6537150,6390064125000,1004236,1000000,955000,-49236,-4.9,977500,-26736,-2.66,955000,1000000,1399-6-19
790,شرق1400,مشاركت ليزينگ ايران وشرق140010,2,60,60600000,1020816,1010000,1010000,-10816,-1.06,1010000,-10816,-1.06,1010000,1010000,1399-6-19
791,ضپنا7045,اختيارخ رمپنا-40407-1399/07/13,2,7,6300000,937,900,900,-37,-3.95,900,-37,-3.95,900,900,1399-6-19
792,ضفلا8079,اختيارخ فولاد-10775-1399/08/28,2,15,123500000,7191,8700,8000,809,11.25,8233,1042,14.49,8000,8700,1399-6-19
793,ضجار7021,اختيارخ وتجارت-2600-1399/07/22,2,2,1690000,525,840,850,325,61.9,845,320,60.95,840,850,1399-6-19
794,وسالت,بانك قرض الحسنه رسالت,2,562,2426154,4151,4317,4317,166,4.0,4151,0,0.0,4317,4317,1399-6-19
795,ضفلا8076,اختيارخ فولاد-8775-1399/08/28,2,5,52450000,10045,10490,10490,445,4.43,10490,445,4.43,10490,10490,1399-6-19
796,وبصادر2,بانك صادرات ايران,2,200000000,683000000000,3340,3410,3420,80,2.4,3415,75,2.25,3410,3420,1399-6-19
797,اخزا716,اسنادخزانه-م16بودجه97-000407,2,12,10505886,872381,872000,878981,6600,0.76,875490,3109,0.36,872000,878981,1399-6-19
798,گواهي ظرفيت,گواهي ظرفيت نقدي,2,13750,146278577500,10638442,10638442,10638442,0,0.0,10638442,0,0.0,10638442,10638442,1399-6-19
799,ضگل8056,اختيارخ كگل-12100-1399/08/21,2,101,1059500000,10700,9500,10500,-200,-1.87,10490,-210,-1.96,9500,10500,1399-6-19
800,تملي807,تسهيلات مسكن ب. ملي-مهر98,2,8,1381304,164441,172663,172663,8222,5.0,172663,8222,5.0,172663,172663,1399-6-19
801,تملي702,تسهيلات مسكن ب. ملي-ارديبهشت97,2,2,642114,305769,321057,321057,15288,5.0,321057,15288,5.0,321057,321057,1399-6-19
802,ضملي8076,اختيارخ فملي -27750-1399/08/06,2,7,56500000,7199,6500,8700,1501,20.85,8071,872,12.11,6500,8700,1399-6-19
803,ضملي8067,اختيارخ فملي -14750-1399/08/06,2,14,268000000,12500,19000,19500,7000,56.0,19143,6643,53.14,19000,19500,1399-6-19
804,ضخوز7027,اختيارخ فخوز-39470-1399/07/20,2,4,49500000,12150,12500,12000,-150,-1.23,12375,225,1.85,12000,12500,1399-6-19
805,غگز,گز سكه,2,60000,2040000000,34500,34000,34000,-500,-1.45,34000,-500,-1.45,34000,34000,1399-6-19
806,صخود412,ص مرابحه خودرو412- 3ماهه 18%,2,12,11825080,986000,985010,986002,2,0.0,985423,-577,-0.06,985010,986002,1399-6-19
807,تملي705,تسهيلات مسكن ب. ملي-مرداد97,2,2,422280,201086,211140,211140,10054,5.0,211140,10054,5.0,211140,211140,1399-6-19
808,ضچاد7025,اختيارخ كچاد-26000-1399/07/07,2,133,19950000,110,150,150,40,36.36,150,40,36.36,150,150,1399-6-19
809,تملي707,تسهيلات مسكن ب. ملي-مهر97,2,3,793404,251875,264468,264468,12593,5.0,264468,12593,5.0,264468,264468,1399-6-19
810,ضفلا8082,اختيارخ فولاد-13775-1399/08/28,2,4,26100000,3561,6000,6700,3139,88.15,6525,2964,83.24,6000,6700,1399-6-19
811,گندم2,مرابحه گندم2-واجدشرايط خاص1400,2,1100,1043800000,949000,988000,945000,-4000,-0.42,948909,-91,-0.01,945000,988000,1399-6-19
812,كيش1402,اجاره س. و توسعه كيش14020820,2,390,409470000,1045880,1040000,1050000,4120,0.39,1049923,4043,0.39,1040000,1050000,1399-6-19
813,وخارزم2,سرمايه گذاري خوارزمي,2,35942900,419094214000,12270,11660,11660,-610,-4.97,11660,-610,-4.97,11660,11660,1399-6-19
814,ضملي8054,اختيارخ فملي -5750-1399/08/06,1,1,27000000,27000,27000,27000,0,0.0,27000,0,0.0,27000,27000,1399-6-19
815,تملي801,تسهيلات مسكن ب. ملي-فروردين98,1,1,232575,221500,232575,232575,11075,5.0,232575,11075,5.0,232575,232575,1399-6-19
816,پست9908-08,پسته فندقي32-30زرينمه ولات9908,1,5,6250000,1176420,1250000,1250000,73580,6.25,1250000,73580,6.25,1250000,1250000,1399-6-19
817,اميد99,مشارکت ليزينگ اميد9907,1,5,5050000,1005000,1010000,1010000,5000,0.5,1010000,5000,0.5,1010000,1010000,1399-6-19
818,فايرا2,آلومينيوم‌ايران‌,1,5000000,101750000000,20350,20350,20350,0,0.0,20350,0,0.0,20350,20350,1399-6-19
819,ضفار8031,اختيارخ فارس-8326-1399/08/06,1,5,57500000,10000,11500,11500,1500,15.0,11500,1500,15.0,11500,11500,1399-6-19
820,ضملي8062,اختيارخ فملي -9750-1399/08/06,1,3,7200000,31000,2400,2400,-28600,-92.26,2400,-28600,-92.26,2400,2400,1399-6-19
821,تملي805,تسهيلات مسكن ب. ملي-مرداد98,1,2,325184,154850,162592,162592,7742,5.0,162592,7742,5.0,162592,162592,1399-6-19
822,ضجار7028,اختيارخ وتجارت-4000-1399/07/22,1,100,18000000,200,180,180,-20,-10.0,180,-20,-10.0,180,180,1399-6-19
823,وغدير2,سرمايه‌گذاري‌غدير(هلدينگ‌,1,6500000,103025000000,15800,15850,15850,50,0.32,15850,50,0.32,15850,15850,1399-6-19
824,اجاد22,اجاره دولتي آپرورش-لوتوس991118,1,8992,8992017984,1000000,1000002,1000002,2,0.0,1000002,2,0.0,1000002,1000002,1399-6-19
825,صخود1412,ص مرابحه خودرو1412- 3ماهه 18%,1,10,10050000,1015050,1005000,1005000,-10050,-0.99,1005000,-10050,-0.99,1005000,1005000,1399-6-19
826,آساس2,صندوق س.آسمان آرماني سهام-س,1,100000,100000,145151,1,1,-145150,-100.0,1,-145150,-100.0,1,1,1399-6-19
827,افاد814,منفعت دولت8-ش.خاص مهر0205,1,510000,471750000000,950000,925000,925000,-25000,-2.63,925000,-25000,-2.63,925000,925000,1399-6-19
828,زعف9908پ06,زعفران 9908پوشالمعمول زرين(پ),1,100,6500000,65708,65000,65000,-708,-1.08,65000,-708,-1.08,65000,65000,1399-6-19
829,كمند2,صندوق س. با درآمد ثابت كمند,1,10000000,10000000,10130,1,1,-10129,-99.99,1,-10129,-99.99,1,1,1399-6-19
830,اعتماد4,صندوق س.اعتماد آفرين پارسيان-د,1,6200000,200043000000,32261,32265,32265,4,0.01,32265,4,0.01,32265,32265,1399-6-19
831,تملي711,تسهيلات مسكن ب. ملي-بهمن97,1,1,347089,330561,347089,347089,16528,5.0,347089,16528,5.0,347089,347089,1399-6-19
832,ضصاد8013,اختيارخ وبصادر-3000-1399/08/11,1,100,111100000,1031,1111,1111,80,7.76,1111,80,7.76,1111,1111,1399-6-19
833,اجاد42,اجاره دولت-واجدشرايط خاص991224,1,5000,4900000000,980000,980000,980000,0,0.0,980000,0,0.0,980000,980000,1399-6-19
834,ضفار8040,اختيارخ فارس-15826-1399/08/06,1,100,250000000,5000,2500,2500,-2500,-50.0,2500,-2500,-50.0,2500,2500,1399-6-19
835,وتوكا2,سرمايه‌گذاري‌توكافولاد(هلدينگ,1,7500000,84607500000,11460,11281,11281,-179,-1.56,11281,-179,-1.56,11281,11281,1399-6-19
836,تملي706,تسهيلات مسكن ب. ملي-شهريور97,1,1,151159,143961,151159,151159,7198,5.0,151159,7198,5.0,151159,151159,1399-6-19
837,طسان7050,اختيارف پارسان-11000-99/07/15,1,10,460000,96,46,46,-50,-52.08,46,-50,-52.08,46,46,1399-6-19
838,ضفلا8084,اختيارخ فولاد-15775-1399/08/28,1,10,48000000,3759,4800,4800,1041,27.69,4800,1041,27.69,4800,4800,1399-6-19
839,شستا994,اجاره تامين اجتماعي-نوين991226,1,5,5000035,1001153,1000007,1000007,-1146,-0.11,1000007,-1146,-0.11,1000007,1000007,1399-6-19
840,فملي2,ملي‌ صنايع‌ مس‌ ايران‌,1,3000000,98190000000,31700,32730,32730,1030,3.25,32730,1030,3.25,32730,32730,1399-6-19
841,اجاد23,اجاره دولتي آپرورش-ملت991118,1,7683,7683030732,1000000,1000004,1000004,4,0.0,1000004,4,0.0,1000004,1000004,1399-6-19
842,لوتوس2,تامين سرمايه لوتوس پارسيان,1,10000000,150200000000,15810,15020,15020,-790,-5.0,15020,-790,-5.0,15020,15020,1399-6-19
843,ضصاد8009,اختيارخ وبصادر-2200-1399/08/11,1,1,1600000,1600,1600,1600,0,0.0,1600,0,0.0,1600,1600,1399-6-19
844,ضچاد7017,اختيارخ كچاد-14300-1399/07/07,1,1,4500000,4037,4500,4500,463,11.47,4500,463,11.47,4500,4500,1399-6-19
845,واميد2,گروه مديريت سرمايه گذاري اميد,1,60000000,2448000000000,40530,40800,40800,270,0.67,40800,270,0.67,40800,40800,1399-6-19
846,ضخوز7022,اختيارخ فخوز-29470-1399/07/20,1,4,80000000,20000,20000,20000,0,0.0,20000,0,0.0,20000,20000,1399-6-19
847,صايند2,صندوق س. گنجينه آينده روشن-د,1,1000000,1000000,9687,1,1,-9686,-99.99,1,-9686,-99.99,1,1,1399-6-19
848,سنفت993,سلف نفت خام سبك داخلي 993,1,1000,906100000,795484,906100,906100,110616,13.91,906100,110616,13.91,906100,906100,1399-6-19
849,تملي802,تسهيلات مسكن ب. ملي-ارديبهشت98,1,1,338782,322650,338782,338782,16132,5.0,338782,16132,5.0,338782,338782,1399-6-19
850,عفولاد2,اوراق سلف ورق گرم فولاد مباركه,1,10,5570690,553051,557069,557069,4018,0.73,557069,4018,0.73,557069,557069,1399-6-19
851,ضسان7057,اختيارخ پارسان-18000-99/07/15,1,27,243000000,22000,9000,9000,-13000,-59.09,9000,-13000,-59.09,9000,9000,1399-6-19
852,تبريز112,مشاركت شهرداري تبريز-3ماهه18%,1,5,4900000,980000,980000,980000,0,0.0,980000,0,0.0,980000,980000,1399-6-19
853,ضفار8023,اختيارخ فارس-4576-1399/08/06,1,1,15000000,13500,15000,15000,1500,11.11,15000,1500,11.11,15000,15000,1399-6-19
854,ضگل8065,اختيارخ كگل-23100-1399/08/21,1,1,2500000,1000,2500,2500,1500,150.0,2500,1500,150.0,2500,2500,1399-6-19
855,ومشان,س. فني و مهندسي مشانير,1,344,19845360,59474,57690,57690,-1784,-3.0,59472,-2,0.0,57690,57690,1399-6-19
856,اراد42,مرابحه عام دولت4-ش.خ 0106,1,2000,1960828000,1000000,980414,980414,-19586,-1.96,980414,-19586,-1.96,980414,980414,1399-6-19
857,اشاد10,مشاركت دولتي10-شرايط خاص001226,1,500,489445000,978890,978890,978890,0,0.0,978890,0,0.0,978890,978890,1399-6-19
858,ضملي8068,اختيارخ فملي -15750-1399/08/06,1,1,17799000,20000,17799,17799,-2201,-11.01,17799,-2201,-11.01,17799,17799,1399-6-19
859,تملي806,تسهيلات مسكن ب. ملي-شهريور98,1,5,734640,139932,146928,146928,6996,5.0,146928,6996,5.0,146928,146928,1399-6-19
860,ضمخا7037,اختيارخ اخابر-2950-1399/07/30,1,1,15500000,18000,15500,15500,-2500,-13.89,15500,-2500,-13.89,15500,15500,1399-6-19
861,ياقوت2,صندوق س ياقوت آگاه-ثابت,1,1300000,1300000,10940,1,1,-10939,-99.99,1,-10939,-99.99,1,1,1399-6-19
862,ضغدر8038,اختيارخ وغدير-11000-1399/08/26,1,20,126000000,8733,6300,6300,-2433,-27.86,6300,-2433,-27.86,6300,6300,1399-6-19
863,وسينا2,بانك سينا,1,37000000,463240000000,13160,12520,12520,-640,-4.86,12520,-640,-4.86,12520,12520,1399-6-19
864,زير0003پ01,زيره سبز0003كيميابذر(پ),1,11,5104000,451773,464000,464000,12227,2.71,464000,12227,2.71,464000,464000,1399-6-19
865,سلامت3,مرابحه دولتي تعاون-اميد991118,1,9,9045000,1022000,1005000,1005000,-17000,-1.66,1005000,-17000,-1.66,1005000,1005000,1399-6-19
866,صينا205,صكوك منفعت سينا دارو-3ماهه 19%,1,12,12815988,1029789,1067999,1067999,38210,3.71,1067999,38210,3.71,1067999,1067999,1399-6-19
867,ضملي8075,اختيارخ فملي -25750-1399/08/06,1,6,60000000,9366,10000,10000,634,6.77,10000,634,6.77,10000,10000,1399-6-19
868,سنفت2991,سلف نفت خام سبك داخلي2991,1,1900,1617802500,753644,851475,851475,97831,12.98,851475,97831,12.98,851475,851475,1399-6-19
869,وتجارت2,بانك تجارت,1,100000000,310000000000,3050,3100,3100,50,1.64,3100,50,1.64,3100,3100,1399-6-19
870,پرند,صندوق س. پروژه آرمان پرند مپنا,1,200,1200000,5850,6000,6000,150,2.56,6000,150,2.56,6000,6000,1399-6-19
871,اشاد102,مشاركت دولتي10-شرايط خاص001226,1,98,91140000,978890,930000,930000,-48890,-4.99,930000,-48890,-4.99,930000,930000,1399-6-19
872,شلرد02,كود شيميايي اوره لردگان,1,6,5952000,998454,992000,992000,-6454,-0.65,992000,-6454,-0.65,992000,992000,1399-6-19
873,عفولاد3,اوراق سلف موازي ورق گرم فولاد,1,7,5460896,779766,780128,780128,362,0.05,780128,362,0.05,780128,780128,1399-6-19
874,ضصاد8019,اختيارخ وبصادر-4200-1399/08/11,1,50,29500000,150,590,590,440,293.33,590,440,293.33,590,590,1399-6-19
