,نماد,نام,تعداد,حجم,ارزش,دیروز,اولین,آخرین معامله - مقدار,آخرین معامله - تغییر,آخرین معامله - درصد,قیمت پایانی - مقدار,قیمت پایانی - تغییر,قیمت پایانی - درصد,کمترین,بیشترین,تاریخ
0,پالايش,صندوق پالايشي يکم-سهام,143232,41744281,4222260072040,104470,103100,100390,-4080,-3.91,101150,-3320,-3.18,100060,103500,1399-9-18
1,فملي,ملي‌ صنايع‌ مس‌ ايران‌,105801,438942332,7064842841160,14050,15800,16200,2150,15.3,16100,2050,14.59,15780,16580,1399-9-18
2,بپيوند,برق و انرژي پيوندگستر پارس,90853,58738864,1992468608221,32380,32190,34500,2120,6.55,33921,1541,4.76,32190,34880,1399-9-18
3,وسپهر,سرمايه گذاري مالي سپهرصادرات,89824,119275113,1390757002353,11822,11735,11587,-235,-1.99,11660,-162,-1.37,11450,11980,1399-9-18
4,شستا,سرمايه گذاري تامين اجتماعي,77554,142262237,4176983610630,30320,29500,29120,-1200,-3.96,29360,-960,-3.17,28900,30150,1399-9-18
5,خودرو,ايران‌ خودرو,76753,1662519082,6925569077990,4180,4160,4200,20,0.48,4170,-10,-0.24,3990,4340,1399-9-18
6,وتجارت,بانك تجارت,72635,1611260168,6506283909310,4050,4050,4000,-50,-1.23,4040,-10,-0.25,3910,4150,1399-9-18
7,آبادا,توليد نيروي برق آبادان,67524,17209522,344924439620,20840,19900,19920,-920,-4.41,20040,-800,-3.84,19800,20910,1399-9-18
8,غزر,صنعتي زر ماكارون,64685,5759360,357386804870,59720,62290,62000,2280,3.82,62050,2330,3.9,59900,62700,1399-9-18
9,ثاميد,توسعه و عمران اميد,60110,363457691,868769084460,2300,2300,2410,110,4.78,2390,90,3.91,2300,2410,1399-9-18
10,زملارد,كشاورزي و دامپروري ملارد شير,57946,2052757,86819394562,42386,42560,41509,-877,-2.07,42294,-92,-0.22,41000,43220,1399-9-18
11,امين,تامين سرمايه امين,55882,27013154,318636215570,12220,11760,11690,-530,-4.34,11800,-420,-3.44,11610,12250,1399-9-18
12,خساپا,سايپا,55024,1537714682,5048409735160,3320,3290,3260,-60,-1.81,3280,-40,-1.2,3160,3390,1399-9-18
13,وبصادر,بانك صادرات ايران,53983,1613238229,6280721808370,3730,3870,3910,180,4.83,3890,160,4.29,3790,3910,1399-9-18
14,بگيلان,توسعه مسير برق گيلان,53678,7917864,216356709551,26106,26600,27411,1305,5.0,27325,1219,4.67,26300,27411,1399-9-18
15,شپنا,پالايش نفت اصفهان,53411,224355878,4033958024580,18710,18200,17780,-930,-4.97,17980,-730,-3.9,17780,18800,1399-9-18
16,شاروم,پتروشيمي اروميه,49177,14255135,382768010087,25660,26500,26943,1283,5.0,26851,1191,4.64,25660,26943,1399-9-18
17,پيزد,مجتمع صنايع لاستيك يزد,48901,2005572,174358313153,89046,87300,86619,-2427,-2.73,86937,-2109,-2.37,84900,89000,1399-9-18
18,گدنا,تهيه توزيع غذاي دنا آفرين فدك,47514,6863394,217363687980,30162,31670,31670,1508,5.0,31670,1508,5.0,31670,31670,1399-9-18
19,سيتا,سرمايه گذاري سيمان تامين,46555,36903169,641842120180,17690,17270,17340,-350,-1.98,17390,-300,-1.7,17190,18000,1399-9-18
20,دارا يكم,صندوق واسطه گري مالي يكم-سهام,44927,18345543,3568542316450,197520,197800,193300,-4220,-2.14,194520,-3000,-1.52,192000,198870,1399-9-18
21,ثبهساز,بهساز كاشانه تهران,44843,249036060,736436800590,2830,2890,2970,140,4.95,2960,130,4.59,2870,2970,1399-9-18
22,خگستر,گسترش‌سرمايه‌گذاري‌ايران‌خودرو,41504,574044238,2888417849950,4990,5000,5080,90,1.8,5030,40,0.8,4820,5190,1399-9-18
23,دي,بانك دي,39652,70598245,3515652066733,51890,51001,49296,-2594,-5.0,49798,-2092,-4.03,49296,52618,1399-9-18
24,وپويا,سرمايه گذاري پويا,38168,44954030,414978693908,8880,8840,9324,444,5.0,9231,351,3.95,8810,9324,1399-9-18
25,فولاد,فولاد مباركه اصفهان,38111,204837728,2932253253530,14320,14250,14310,-10,-0.07,14320,0,0.0,13910,14650,1399-9-18
26,چخزر,صنايع چوب خزر كاسپين,36924,247528,6739197328,25930,27226,27226,1296,5.0,26090,160,0.62,27226,27226,1399-9-18
27,شتران,پالايش نفت تهران,32547,119044366,1673812199570,14660,14250,13930,-730,-4.98,14060,-600,-4.09,13930,14660,1399-9-18
28,شبندر,پالايش نفت بندرعباس,32378,74094815,2350685252260,31450,31480,31630,180,0.57,31730,280,0.89,30770,32800,1399-9-18
29,رافزا,رايان هم افزا,31294,184817,6941541703,35771,37559,37559,1788,5.0,36004,233,0.65,37559,37559,1399-9-18
30,ولپارس,ليزينگ پارسيان,29362,3232345,25115320650,7400,7770,7770,370,5.0,7560,160,2.16,7770,7770,1399-9-18
31,آريا,پليمر آريا ساسول,28632,3745540,697727880697,189939,187000,185900,-4039,-2.13,186282,-3657,-1.93,183000,191000,1399-9-18
32,پترول,گروه پتروشيمي س. ايرانيان,22852,118539270,1545116486950,13550,13450,13030,-520,-3.84,13030,-520,-3.84,12880,13540,1399-9-18
33,وبملت,بانك ملت,21023,313823537,1694839730940,5490,5360,5350,-140,-2.55,5400,-90,-1.64,5230,5560,1399-9-18
34,بركت,گروه دارويي بركت,20717,114913214,2474113691080,20520,21530,21540,1020,4.97,21530,1010,4.92,20850,21540,1399-9-18
35,شگويا,پتروشيمي تندگويان,19902,72394911,903418430720,12973,12460,12360,-613,-4.73,12479,-494,-3.81,12325,12990,1399-9-18
36,حكشتي,كشتيراني جمهوري اسلامي ايران,19091,36704161,1128070770470,31640,31200,30820,-820,-2.59,30730,-910,-2.88,30060,32100,1399-9-18
37,ذوب,سهامي ذوب آهن  اصفهان,17576,159428321,879717577387,5595,5525,5501,-94,-1.68,5518,-77,-1.38,5371,5650,1399-9-18
38,وپارس,بانك‌پارسيان‌,15980,367748961,1599314274290,4420,4360,4280,-140,-3.17,4350,-70,-1.58,4210,4520,1399-9-18
39,گكوثر,هتل پارسيان كوثر اصفهان,15662,7565003,1175842431546,155052,152610,155020,-32,-0.02,155432,380,0.25,145000,165000,1399-9-18
40,وغدير,سرمايه‌گذاري‌غدير(هلدينگ‌,15517,76556011,1058373990410,14310,13990,13710,-600,-4.19,13820,-490,-3.42,13600,14290,1399-9-18
41,زدشت,كشت و صنعت دشت خرم دره,14460,21014858,1234151355385,57485,55000,59860,2375,4.13,58728,1243,2.16,53333,61000,1399-9-18
42,شبريز,پالايش نفت تبريز,14296,47391914,1751719909170,35530,36300,37300,1770,4.98,36960,1430,4.02,35530,37300,1399-9-18
43,وخارزم,سرمايه گذاري خوارزمي,14046,78088623,848075840250,11260,10800,10810,-450,-4.0,10860,-400,-3.55,10700,11450,1399-9-18
44,خزاميا,زامياد,13760,81530147,1240815026580,15810,15320,15020,-790,-5.0,15220,-590,-3.73,15020,16000,1399-9-18
45,سمايه,بانك سرمايه,12798,87212766,700993816452,8405,7985,8070,-335,-3.99,8038,-367,-4.37,7985,8314,1399-9-18
46,وسينا,بانك سينا,11710,92782482,1281611998810,13320,13510,13980,660,4.95,13810,490,3.68,12900,13980,1399-9-18
47,ثشاهد,سرمايه‌ گذاري‌ شاهد,11394,32467196,947241630320,27990,28480,29380,1390,4.97,29180,1190,4.25,28350,29380,1399-9-18
48,لكما,كارخانجات‌مخابراتي‌ايران‌,11379,65793387,598325977780,9302,9347,9120,-182,-1.96,9094,-208,-2.24,9023,9400,1399-9-18
49,غگيلا,شيرپاستوريزه پگاه گيلان,11075,162908,2942770112,17204,18064,18064,860,5.0,17252,48,0.28,18064,18064,1399-9-18
50,قصفها,قنداصفهان‌,11062,5098187,1225626001430,226720,215000,249390,22670,10.0,240400,13680,6.03,215000,249390,1399-9-18
51,فارس,صنايع پتروشيمي خليج فارس,10822,39177760,549526316750,14550,14400,13840,-710,-4.88,14030,-520,-3.57,13830,14460,1399-9-18
52,غگل,گلوكوزان‌,10546,86002789,456948674200,5210,5120,5350,140,2.69,5310,100,1.92,5110,5420,1399-9-18
53,خبهمن,گروه‌بهمن‌,10489,44355469,1214826206700,28440,27320,27110,-1330,-4.68,27390,-1050,-3.69,27020,28690,1399-9-18
54,شلرد,كود شيميايي اوره لردگان,10446,73920856,835580156329,11193,11000,11528,335,2.99,11304,111,0.99,10899,11528,1399-9-18
55,خپارس,پارس‌ خودرو,10387,83870523,720369091380,8530,8500,8690,160,1.88,8590,60,0.7,8220,8820,1399-9-18
56,بجهرم,توسعه مولد نيروگاهي جهرم,9894,92733188,381960016751,4261,4111,4130,-131,-3.07,4119,-142,-3.33,4048,4250,1399-9-18
57,ساوه,سيمان ساوه,9863,3065762,199275663214,64955,64850,64499,-456,-0.7,65000,45,0.07,62690,67000,1399-9-18
58,صبا,سرمايه گذاري صبا تامين,9861,23365225,216418600979,9586,9280,9172,-414,-4.32,9262,-324,-3.38,9110,9600,1399-9-18
59,وملي,گروه‌ صنعتي‌ ملي‌ (هلدينگ‌,9688,2593324,905808757620,338490,354920,355410,16920,5.0,349280,10790,3.19,328000,355410,1399-9-18
60,كرمان,س. توسعه و عمران استان كرمان,9593,10573505,942481265669,88656,87730,88979,323,0.36,89136,480,0.54,84700,92000,1399-9-18
61,هاي وب,داده گسترعصرنوين-هاي وب,9522,28817817,855693926840,31010,30100,29460,-1550,-5.0,29690,-1320,-4.26,29460,30770,1399-9-18
62,خصدرا,صنعتي‌ دريايي‌ ايران‌,9500,98580023,530765540821,5532,5430,5367,-165,-2.98,5384,-148,-2.68,5367,5570,1399-9-18
63,وساپا,سرمايه‌گذاري‌ سايپا,9383,58043751,610058532890,10710,10600,10340,-370,-3.45,10510,-200,-1.87,10250,10890,1399-9-18
64,شيران,س. صنايع‌شيميايي‌ايران,9158,17420904,723095037560,40040,41000,41760,1720,4.3,41510,1470,3.67,39710,42000,1399-9-18
65,فرابورس,فرابورس ايران,9100,12752220,753593634400,58580,56800,59780,1200,2.05,59095,515,0.88,56800,60990,1399-9-18
66,ونيرو,سرمايه‌گذاري‌نيرو,9092,100850773,495204037740,4970,5050,4810,-160,-3.22,4910,-60,-1.21,4730,5110,1399-9-18
67,تاپيكو,س. نفت و گاز و پتروشيمي تأمين,8943,41846961,684254303280,16950,16450,16180,-770,-4.54,16350,-600,-3.54,16110,16940,1399-9-18
68,ثاخت,بين‌المللي‌توسعه‌ساختمان,8704,133056403,602013273950,4400,4330,4620,220,5.0,4520,120,2.73,4200,4620,1399-9-18
69,بكهنوج,توليد برق ماهتاب كهنوج,8686,120044648,384483158320,3205,3207,3240,35,1.09,3203,-2,-0.06,3080,3299,1399-9-18
70,خمحركه,نيرو محركه‌,8403,54887122,423420848680,7950,7720,7610,-340,-4.28,7710,-240,-3.02,7560,8110,1399-9-18
71,دماوند,توليد نيروي برق دماوند,8293,8938240,676471839444,72853,72393,76495,3642,5.0,75683,2830,3.88,72350,76495,1399-9-18
72,فروي,ذوب روي اصفهان,8213,8095518,523222642810,62793,61000,65860,3067,4.88,64631,1838,2.93,61000,65932,1399-9-18
73,آسيا,بيمه آسيا,8188,21974957,757857164610,35780,35600,34910,-870,-2.43,34490,-1290,-3.61,34000,35700,1399-9-18
74,تملت,تامين سرمايه بانك ملت,8123,24979082,224854103100,9250,8820,9190,-60,-0.65,9000,-250,-2.7,8790,9300,1399-9-18
75,ونوين,بانك‌اقتصادنوين‌,8091,152671164,884984584010,5920,5780,5770,-150,-2.53,5800,-120,-2.03,5630,5970,1399-9-18
76,تبرك,گروه كارخانجات صنعتي تبرك,8077,16537465,444343569574,27672,27000,26770,-902,-3.26,26869,-803,-2.9,26289,28330,1399-9-18
77,انرژي3,سايراشخاص بورس انرژي,8022,1845963,654246111030,342330,349000,359440,17110,5.0,354420,12090,3.53,339890,359440,1399-9-18
78,زشگزا,شير و گوشت زاگرس شهركرد,7987,3374563,562397213073,162196,170000,168000,5804,3.58,166658,4462,2.75,156080,170000,1399-9-18
79,پتاير,ايران‌ تاير,7920,3074354,511980713370,167940,167950,167700,-240,-0.14,166530,-1410,-0.84,163040,172000,1399-9-18
80,فخوز,فولاد  خوزستان,7637,14177560,578119766660,41310,40400,40200,-1110,-2.69,40780,-530,-1.28,39910,42500,1399-9-18
81,سفاسي,شركت فارسيت اهواز,7633,53578333,770563631463,14062,14483,13943,-119,-0.85,14382,320,2.28,13655,14483,1399-9-18
82,چكاپا,گروه صنايع كاغذ پارس,7515,57338228,394363567800,6980,6830,6800,-180,-2.58,6880,-100,-1.43,6680,7190,1399-9-18
83,قنيشا,قند  نيشابور,7114,8631358,650692629540,72440,75000,76060,3620,5.0,75390,2950,4.07,72400,76060,1399-9-18
84,خكرمان,گروه اقتصادي كرمان خودرو,7081,89129933,550746611203,6049,6230,6119,70,1.16,6179,130,2.15,5950,6230,1399-9-18
85,حفاري,حفاري شمال,7076,41415541,566803771760,14280,14000,13570,-710,-4.97,13690,-590,-4.13,13570,14240,1399-9-18
86,ولساپا,ليزينگ رايان‌ سايپا,7058,98978570,449350307150,4680,4530,4520,-160,-3.42,4540,-140,-2.99,4450,4720,1399-9-18
87,ثغرب,شركت سرمايه گذاري مسكن شمالغرب,7009,35561499,423768303089,11693,11251,12277,584,4.99,11916,223,1.91,11120,12277,1399-9-18
88,البرز,بيمه البرز,6958,185901661,1035494738810,5320,5500,5580,260,4.89,5570,250,4.7,5420,5580,1399-9-18
89,ختوقا,قطعات‌ اتومبيل‌ ايران‌,6924,87969595,367871975380,4260,4130,4140,-120,-2.82,4180,-80,-1.88,4050,4340,1399-9-18
90,فاراك,ماشين‌ سازي‌ اراك‌,6906,58709641,449274761350,7960,7950,7680,-280,-3.52,7650,-310,-3.89,7570,7950,1399-9-18
91,وشمال,س. چشم انداز توسعه شمال,6815,7676225,752080183210,97422,94500,100344,2922,3.0,97975,553,0.57,94500,100344,1399-9-18
92,بكام,كارخانجات توليدي شهيد قندي,6799,60565962,291168568710,4920,4920,4850,-70,-1.42,4810,-110,-2.24,4680,5000,1399-9-18
93,تليسه,دامداري تليسه نمونه,6731,46251678,370934068741,8420,8100,7999,-421,-5.0,8020,-400,-4.75,7999,8349,1399-9-18
94,زكوثر,سرمايه گذاري كشاورزي كوثر,6687,15007604,397662118630,25640,25900,26910,1270,4.95,26500,860,3.35,25000,26920,1399-9-18
95,وپست,پست بانك ايران,6677,31390668,655675668220,20440,20000,20580,140,0.68,20890,450,2.2,19520,21460,1399-9-18
96,سمگا,گروه سرمايه گذاري ميراث فرهنگي,6578,40265443,1089126301886,25915,26700,27210,1295,5.0,27049,1134,4.38,26100,27210,1399-9-18
97,خكمك,كمك‌فنرايندامين‌,6569,10349826,510782549490,51480,50010,48910,-2570,-4.99,49350,-2130,-4.14,48910,52000,1399-9-18
98,فزرين,زرين معدن آسيا,6401,17233801,527089703861,30170,30200,30190,20,0.07,30585,415,1.38,29000,31670,1399-9-18
99,وساخت,سرمايه‌ گذاري‌ ساختمان‌ايران‌,6393,10420207,699683261210,70220,66710,66710,-3510,-5.0,67150,-3070,-4.37,66710,68700,1399-9-18
100,كگل,معدني و صنعتي گل گهر,6364,29579125,590321952730,20880,19850,19840,-1040,-4.98,19960,-920,-4.41,19840,20590,1399-9-18
101,غبهنوش,بهنوش‌ ايران‌,6358,5624346,656595730080,107850,111890,118630,10780,10.0,116740,8890,8.24,108850,118630,1399-9-18
102,سبزوا,سيمان لار سبزوار,6354,38837369,227883930576,6069,5920,5833,-236,-3.89,5868,-201,-3.31,5766,6180,1399-9-18
103,ومعادن,توسعه‌معادن‌وفلزات‌,6214,36113480,548211026210,15380,15380,15290,-90,-0.59,15180,-200,-1.3,14650,15680,1399-9-18
104,ورنا,سرمايه‌گذاري‌ رنا(هلدينگ‌,6091,40302078,420926201310,10560,10490,10300,-260,-2.46,10440,-120,-1.14,10040,11000,1399-9-18
105,سامان,بانك سامان,6004,156491333,1968580847478,12237,12604,12604,367,3.0,12579,342,2.79,12237,12604,1399-9-18
106,شغدير,پتروشيمي غدير,5884,15697302,1133900682648,70759,70110,74296,3537,5.0,72235,1476,2.09,68636,74296,1399-9-18
107,فسرب,ملي‌ سرب‌وروي‌ ايران‌,5882,4735476,733648204780,147990,141000,155380,7390,4.99,154930,6940,4.69,141000,155380,1399-9-18
108,غمينوح,ح . شركت صنايع غذايي مينو شرق,5848,20052785,247414855084,12682,12048,12300,-382,-3.01,12338,-344,-2.71,12048,13179,1399-9-18
109,ثنام,س ساختماني ب نام آوران مهندسي,5813,16318795,356455905622,21588,22235,21610,22,0.1,21843,255,1.18,21000,22235,1399-9-18
110,كحافظ,كاشي‌ وسراميك‌ حافظ‌,5728,17308412,346270736610,20880,20150,19840,-1040,-4.98,20010,-870,-4.17,19840,20770,1399-9-18
111,فاذر,صنايع‌ آذرآب‌,5691,11278270,402239644070,34640,33500,36370,1730,4.99,35670,1030,2.97,33500,36370,1399-9-18
112,حسينا,توسعه خدمات دريايي وبندري سينا,5517,13164659,1202375355220,84085,88000,92493,8408,10.0,91334,7249,8.62,83940,92493,1399-9-18
113,كسعدي,كاشي‌ سعدي‌,5428,8867186,327811632550,36680,36680,37820,1140,3.11,36970,290,0.79,35500,38200,1399-9-18
114,وتوصا,گروه س توسعه صنعتي ايران,5384,35906300,556990483410,16220,16280,15410,-810,-4.99,15510,-710,-4.38,15410,16280,1399-9-18
115,زبينا,كشاورزي و دامپروري بينالود,5331,8634973,468098659459,56856,54900,54014,-2842,-5.0,54210,-2646,-4.65,54014,56856,1399-9-18
116,غديس,پاكديس,5205,24691347,326653715893,13742,13250,13200,-542,-3.94,13229,-513,-3.73,13055,13740,1399-9-18
117,قثابت,قند ثابت‌ خراسان‌,5008,4921431,413029667240,87280,87000,83500,-3780,-4.33,83920,-3360,-3.85,82920,87000,1399-9-18
118,خريخت,صنايع‌ريخته‌گري‌ايران‌,4978,47355249,213659813000,4660,4680,4460,-200,-4.29,4510,-150,-3.22,4430,4680,1399-9-18
119,اخابر,مخابرات ايران,4971,25634362,396617203490,15770,15470,15230,-540,-3.42,15470,-300,-1.9,15100,16100,1399-9-18
120,ثمسكن,سرمايه‌گذاري‌ مسكن‌,4938,51477150,344088603350,6850,6600,6670,-180,-2.63,6680,-170,-2.48,6510,6950,1399-9-18
121,فنوال,نورد آلومينيوم‌,4928,12309213,351993498810,29960,29000,28470,-1490,-4.97,28600,-1360,-4.54,28470,30000,1399-9-18
122,ودي,بيمه  دي,4867,19098257,559521570059,28861,28800,29700,839,2.91,29297,436,1.51,28020,30000,1399-9-18
123,وپاسار,بانك  پاسارگاد,4775,46205589,541712405750,11720,11760,11820,100,0.85,11720,0,0.0,11500,11830,1399-9-18
124,تپمپي,پمپ‌ سازي‌ ايران‌,4654,9058848,333460989730,35390,36900,37150,1760,4.97,36810,1420,4.01,35570,37150,1399-9-18
125,نوين,بيمه نوين,4618,37825847,347298161728,8949,8980,9396,447,4.99,9182,233,2.6,8650,9396,1399-9-18
126,كاوه,فولاد كاوه جنوب كيش,4606,20268590,440041346830,22130,22100,21430,-700,-3.16,21710,-420,-1.9,21100,22600,1399-9-18
127,خاذين,سايپاآذين‌,4540,39144141,250267457830,6660,6370,6330,-330,-4.95,6390,-270,-4.05,6330,6660,1399-9-18
128,ماديرا,صنايع ماشين هاي اداري ايران,4535,8700545,254067675762,29558,29000,29000,-558,-1.89,29201,-357,-1.21,28500,30000,1399-9-18
129,وتوس,توسعه‌شهري‌توس‌گستر,4519,9748940,260718762540,27020,26900,26260,-760,-2.81,26740,-280,-1.04,25770,27660,1399-9-18
130,لپارس,پارس‌ الكتريك‌,4479,1604352,259017646010,154810,161000,162550,7740,5.0,161450,6640,4.29,157440,162550,1399-9-18
131,شكلر,نيروكلر,4390,7265855,479068475410,62970,63990,66110,3140,4.99,65930,2960,4.7,63050,66110,1399-9-18
132,دتوليد,داروسازي توليد دارو,4293,9673129,364758685611,36323,37432,38139,1816,5.0,37708,1385,3.81,36323,38139,1399-9-18
133,شصدف,صنعتي دوده فام,4285,206243,5299001399,24470,25693,25693,1223,5.0,24591,121,0.49,25693,25693,1399-9-18
134,كرازي,كارخانجات‌توليدي‌شيشه‌رازي‌,4227,9207676,223782947590,23610,23000,24790,1180,5.0,24300,690,2.92,23000,24790,1399-9-18
135,كالا,بورس كالاي ايران,4217,10024031,500730191920,47650,49680,50030,2380,4.99,49950,2300,4.83,47900,50030,1399-9-18
136,بزاگرس,نيروگاه زاگرس كوثر,4217,16419675,234467455595,14466,14850,13961,-505,-3.49,14280,-186,-1.29,13800,14850,1399-9-18
137,پاكشو,گروه صنعتي پاكشو,4167,4153331,348050155980,87430,87000,83060,-4370,-5.0,83800,-3630,-4.15,83060,87020,1399-9-18
138,وايران,ليزينگ ايرانيان,4166,27675985,389856171450,13440,14000,14110,670,4.99,14090,650,4.84,13710,14110,1399-9-18
139,شفارس,صنايع‌ شيميايي‌ فارس‌,4164,9177076,539201129020,56970,55500,59810,2840,4.99,58760,1790,3.14,54600,59810,1399-9-18
140,كچاد,معدني‌وصنعتي‌چادرملو,4148,13181812,281843072940,21590,21160,21440,-150,-0.69,21380,-210,-0.97,20940,21980,1399-9-18
141,ملت,بيمه ملت,4136,26899164,522755507240,18570,19490,19490,920,4.95,19430,860,4.63,18700,19490,1399-9-18
142,سفارس,سيمان فارس و خوزستان,4036,19535074,379811277320,19130,18300,19930,800,4.18,19440,310,1.62,18300,20000,1399-9-18
143,كپارس,كاشي‌ پارس‌,4025,2011335,332555819290,170550,173000,165350,-5200,-3.05,165340,-5210,-3.05,162030,173000,1399-9-18
144,تنوينح,ح . تامين سرمايه نوين,3984,17077747,87224761125,5141,5010,5190,49,0.95,5108,-33,-0.64,4970,5240,1399-9-18
145,كبافق,معادن‌ بافق‌,3921,4195236,195801870850,47760,48000,45600,-2160,-4.52,46670,-1090,-2.28,45510,48000,1399-9-18
146,وبانك,سرمايه گذاري گروه توسعه ملي,3913,18711310,216662138530,11910,11500,11420,-490,-4.11,11580,-330,-2.77,11350,11980,1399-9-18
147,غشهداب,كشت و صنعت شهداب ناب خراسان,3873,74719861,386454903178,4929,5175,5175,246,4.99,5172,243,4.93,5029,5175,1399-9-18
148,ونفت,سرمايه‌گذاري‌ صنعت‌ نفت‌,3832,14340436,260292298710,17370,18190,18230,860,4.95,18150,780,4.49,17600,18230,1399-9-18
149,قرن,پديده شيمي قرن,3829,3291302,200108086480,60430,60000,61570,1140,1.89,60800,370,0.61,57700,62900,1399-9-18
150,دزهراوي,داروسازي‌زهراوي‌,3821,13979008,196737871600,13630,14140,14310,680,4.99,14070,440,3.23,13200,14310,1399-9-18
151,بورس,بورس اوراق بهادار تهران,3797,5748607,366521021910,62420,60020,64190,1770,2.84,63760,1340,2.15,60020,65500,1399-9-18
152,زقيام,كشت و دام قيام اصفهان,3789,5850929,230838048969,40134,39500,39448,-686,-1.71,39453,-681,-1.7,38128,40780,1399-9-18
153,ثتران,سرمايه گذاري مسكن تهران,3752,47288645,268305602179,5783,5700,5630,-153,-2.65,5674,-109,-1.88,5494,5850,1399-9-18
154,كسرا,سراميك‌هاي‌صنعتي‌اردكان‌,3671,13029116,443006415730,32500,32700,34120,1620,4.98,34000,1500,4.62,32500,34120,1399-9-18
155,آگاس,صندوق س.هستي بخش آگاه-س,3588,3229099,244062867188,76475,75000,75640,-835,-1.09,75582,-893,-1.17,73700,76990,1399-9-18
156,رانفور,خدمات‌انفورماتيك‌,3587,8453470,284363210190,35080,33610,33970,-1110,-3.16,33640,-1440,-4.1,33330,34860,1399-9-18
157,قشير,قند شيروان قوچان و بجنورد,3586,5830366,203536734018,34555,35890,34550,-5,-0.01,34910,355,1.03,33560,35950,1399-9-18
158,بپاس,بيمه پاسارگاد,3537,6035648,534314053905,87935,87936,91001,3066,3.49,88526,591,0.67,84015,92000,1399-9-18
159,خاهن,آهنگري‌ تراكتورسازي‌ ايران‌,3493,7631523,317243403500,40150,38650,41160,1010,2.52,41570,1420,3.54,38650,42150,1399-9-18
160,حريل,ريل پردازسير,3492,48700500,202998938615,4298,4084,4289,-9,-0.21,4168,-130,-3.02,4084,4296,1399-9-18
161,وسپه,سرمايه‌گذاري‌ سپه‌,3435,21249033,316774931480,15410,15000,14640,-770,-5.0,14910,-500,-3.24,14640,15530,1399-9-18
162,كمند,صندوق س. با درآمد ثابت كمند,3413,144607030,1448561581778,10012,10020,10017,5,0.05,10017,5,0.05,10016,10022,1399-9-18
163,رنيك,جنرال مكانيك,3405,7691133,211033248684,26954,26110,27950,996,3.7,27439,485,1.8,26010,28278,1399-9-18
164,وهور,مديريت انرژي اميد  تابان هور,3405,8206811,352417975891,44912,42667,42667,-2245,-5.0,42942,-1970,-4.39,42667,44220,1399-9-18
165,رمپنا,گروه مپنا (سهامي عام),3375,15040382,327607711900,21670,21660,21500,-170,-0.78,21780,110,0.51,21050,22700,1399-9-18
166,وآوا,سرمايه گذاري آوا نوين,3334,11561376,195592846184,16584,15910,17370,786,4.74,16918,334,2.01,15910,17400,1399-9-18
167,لسرما,سرما آفرين‌,3248,7824838,255128249190,31810,30800,33400,1590,5.0,32600,790,2.48,30230,33400,1399-9-18
168,ومهان,گروه توسعه مالي مهر آيندگان,3245,9330455,165576877293,18088,17430,17611,-477,-2.64,17746,-342,-1.89,17350,18300,1399-9-18
169,ومعلم,بيمه معلم,3193,21773050,177669369291,7989,7950,8387,398,4.98,8160,171,2.14,7670,8388,1399-9-18
170,مدير,ص.س.مديريت ثروت ص.بازنشستگي-س,3154,14160063,161072450217,11438,11229,11350,-88,-0.77,11375,-63,-0.55,11052,11640,1399-9-18
171,وسديد,گروه ‌صنعتي‌سديد,3099,20466798,459869001383,21512,22100,22587,1075,5.0,22469,957,4.45,21600,22587,1399-9-18
172,ونيكي,سرمايه‌گذاري‌ ملي‌ايران‌,3077,28673419,515161685790,17140,17990,17990,850,4.96,17970,830,4.84,17400,17990,1399-9-18
173,كترام,توليدي‌ كاشي‌ تكسرام‌,3017,5622793,215192276490,39620,39990,37680,-1940,-4.9,38270,-1350,-3.41,37640,39990,1399-9-18
174,تاصيكو,سرمايه گذاري صدرتامين,3001,16219348,190051039670,11990,11430,11560,-430,-3.59,11720,-270,-2.25,11400,12290,1399-9-18
175,وپترو,سرمايه‌گذاري صنايع پتروشيمي‌,2965,10145230,195783569170,19960,19100,19200,-760,-3.81,19300,-660,-3.31,18970,20130,1399-9-18
176,حفارس,حمل و نقل بين المللي خليج فارس,2881,34988356,164617798850,4730,4730,4650,-80,-1.69,4700,-30,-0.63,4550,4840,1399-9-18
177,فولاي,صنايع فولاد آلياژي يزد,2878,4839129,179298854136,38744,37050,37000,-1744,-4.5,37052,-1692,-4.37,36807,38510,1399-9-18
178,بساما,بيمه سامان,2876,8926238,299533699201,32229,31584,33820,1591,4.94,33557,1328,4.12,31584,33840,1399-9-18
179,سرو,صندوق س سروسودمند مدبران-سهام,2875,3635588,265541582920,73520,73500,72650,-870,-1.18,73040,-480,-0.65,71590,74300,1399-9-18
180,پاسا,ايران‌ياساتايرورابر,2851,7320314,215450464600,30180,29110,28680,-1500,-4.97,29430,-750,-2.49,28680,31000,1399-9-18
181,ثپرديس,سرمايه گذاري مسكن پرديس,2834,18663397,214447104882,11116,11000,11671,555,4.99,11490,374,3.36,10610,11671,1399-9-18
182,شسپا,نفت سپاهان,2833,7271877,202578939240,28280,28800,27620,-660,-2.33,27860,-420,-1.49,27260,28800,1399-9-18
183,چكارن,كارتن‌ ايران‌,2823,22740885,93958103910,4230,4130,4140,-90,-2.13,4130,-100,-2.36,4040,4250,1399-9-18
184,شبصير,توليدات پتروشيمي قائد بصير,2785,2966773,366345404844,124408,126100,125000,592,0.48,123483,-925,-0.74,118188,129000,1399-9-18
185,حسير,ريل سير كوثر,2777,7550187,143416733019,19323,19323,18680,-643,-3.33,18995,-328,-1.7,18500,20000,1399-9-18
186,اميد,تامين سرمايه اميد,2760,20014234,281254008880,13450,13590,14120,670,4.98,14050,600,4.46,13260,14120,1399-9-18
187,وبوعلي,سرمايه‌گذاري‌بوعلي‌,2732,17236278,131223487290,7820,7520,7630,-190,-2.43,7610,-210,-2.69,7430,7850,1399-9-18
188,چكاوه,صنايع‌كاغذسازي‌كاوه‌,2719,4803468,141656838490,29340,28030,29790,450,1.53,29490,150,0.51,27950,30690,1399-9-18
189,ثفارس,عمران‌وتوسعه‌فارس‌,2686,28947877,259501533030,8680,8500,9110,430,4.95,8960,280,3.23,8370,9110,1399-9-18
190,كهمدا,شيشه‌ همدان‌,2675,17731412,250826789170,13480,14150,14150,670,4.97,14150,670,4.97,13900,14150,1399-9-18
191,ثعمرا,عمران و توسعه شاهد,2662,11685130,196249154034,16277,16520,17090,813,4.99,16795,518,3.18,16055,17090,1399-9-18
192,توريل,توکاريل,2661,7775786,173411258462,23171,22250,22600,-571,-2.46,22301,-870,-3.75,22013,23170,1399-9-18
193,پارسان,گسترش نفت و گاز پارسيان,2654,11492237,277901228080,24780,24890,24200,-580,-2.34,24180,-600,-2.42,23600,24890,1399-9-18
194,شپديس,پتروشيمي پرديس,2636,2514708,281881973350,114520,111200,110000,-4520,-3.95,112090,-2430,-2.12,108920,116000,1399-9-18
195,پلاسك,پلاسكوكار,2632,18812500,160609340330,8920,8920,8480,-440,-4.93,8540,-380,-4.26,8480,9100,1399-9-18
196,غمارگ,مارگارين‌,2630,6480609,245532471250,39400,39030,38500,-900,-2.28,37890,-1510,-3.83,37430,40000,1399-9-18
197,ما,بيمه  ما,2561,17460520,162059566620,9360,8920,9500,140,1.5,9280,-80,-0.85,8900,9700,1399-9-18
198,كلر,كلر پارس,2549,1860345,138095625844,71194,70000,74753,3559,5.0,74231,3037,4.27,68000,74753,1399-9-18
199,ريشمك,توليد و صادرات ريشمك,2533,3873861,211229973166,52107,53550,54712,2605,5.0,54527,2420,4.64,52000,54712,1399-9-18
200,فلوله,لوله‌وماشين‌سازي‌ايران‌,2502,8534791,213473234150,26060,25200,25000,-1060,-4.07,25010,-1050,-4.03,24760,26200,1399-9-18
201,ستران,سيمان‌ تهران‌,2489,3642229,135991686240,37870,36870,37000,-870,-2.3,37340,-530,-1.4,35990,38390,1399-9-18
202,ثالوند,سرمايه گذاري مسكن الوند,2486,8345647,144920599659,17023,16290,17678,655,3.85,17365,342,2.01,16290,17700,1399-9-18
203,كيميا,معدني كيمياي زنجان گستران,2471,4471607,156572578621,33995,34990,34570,575,1.69,35015,1020,3.0,34000,35630,1399-9-18
204,شفن,پتروشيمي فناوران,2454,816686,272910328510,324260,323910,334900,10640,3.28,334170,9910,3.06,315000,340000,1399-9-18
205,شكربن,كربن‌ ايران‌,2452,3271551,325433252490,95020,97000,99000,3980,4.19,99470,4450,4.68,95800,99770,1399-9-18
206,ارزش,صندوق س ارزش آفرين بيدار-سهام,2447,13694722,153459026440,11240,11190,11190,-50,-0.44,11210,-30,-0.27,11010,11340,1399-9-18
207,وليز,ليزينگ‌ايران‌,2432,13159183,133538361820,10390,9920,10040,-350,-3.37,10150,-240,-2.31,9880,10700,1399-9-18
208,ساربيل,سيمان آرتا اردبيل,2421,3015485,150033209990,52150,49550,49550,-2600,-4.99,49750,-2400,-4.6,49550,51900,1399-9-18
209,كپشيرح,ح . پشم‌شيشه‌ايران‌,2408,11050401,134601604251,12672,11870,12367,-305,-2.41,12181,-491,-3.87,11512,12600,1399-9-18
210,سپح,ح . پرداخت الكترونيك سامان كيش,2405,5415543,96860470900,16710,17800,18380,1670,9.99,17890,1180,7.06,16410,18380,1399-9-18
211,كفپارس,فرآورده‌هاي‌ نسوز پارس‌,2403,17273483,152778416550,8440,8840,8860,420,4.98,8840,400,4.74,8690,8860,1399-9-18
212,مرقام,ايران‌ارقام‌,2392,5708511,146398996530,25620,24700,25350,-270,-1.05,25650,30,0.12,24700,26300,1399-9-18
213,اپرداز,آتيه داده پرداز,2341,4833653,158231273940,32539,31900,32560,21,0.06,32735,196,0.6,31730,34000,1399-9-18
214,غشهد,شهد ايران ‌,2303,15014873,114460731770,7380,7690,7740,360,4.88,7620,240,3.25,7200,7740,1399-9-18
215,غشان,شيرپاستوريزه‌پگاه‌خراسان‌,2271,15636611,137113200780,8580,8420,9000,420,4.9,8770,190,2.21,8350,9000,1399-9-18
216,سيدكو,سرمايه گذاري توسعه صنايع سيمان,2258,20132726,180683623780,8600,8740,9030,430,5.0,8970,370,4.3,8330,9030,1399-9-18
217,ختراكح,ح . ريخته‌گري‌ تراكتورسازي‌,2217,5775675,86693513760,16250,15100,14630,-1620,-9.97,15010,-1240,-7.63,14630,16100,1399-9-18
218,ارفع,شركت آهن و فولاد ارفع,2212,7425938,110039712188,14968,14742,14760,-208,-1.39,14818,-150,-1.0,14450,15290,1399-9-18
219,ختور,رادياتور ايران‌,2205,4193004,191701829920,43620,45600,45800,2180,5.0,45720,2100,4.81,45100,45800,1399-9-18
220,آپ,آسان پرداخت پرشين,2201,6297749,118719251890,19170,19190,18860,-310,-1.62,18850,-320,-1.67,18220,19560,1399-9-18
221,وآذر,سرمايه‌گذاري‌توسعه‌آذربايجان‌,2189,1555912,198970181960,122750,122000,128880,6130,4.99,127880,5130,4.18,122000,128880,1399-9-18
222,همراه,شركت ارتباطات سيار ايران,2178,6520253,230252674310,36700,36150,34880,-1820,-4.96,35310,-1390,-3.79,34870,36150,1399-9-18
223,تايرا,تراكتورسازي‌ايران‌,2160,9278074,268232288110,30290,28790,28780,-1510,-4.99,28910,-1380,-4.56,28780,29800,1399-9-18
224,سخوز,سيمان خوزستان,2157,3973339,106785358680,26690,25360,27000,310,1.16,26880,190,0.71,25360,27790,1399-9-18
225,تنوين,تامين سرمايه نوين,2157,28574158,207207044960,7180,7100,7150,-30,-0.42,7250,70,0.97,6860,7470,1399-9-18
226,حآسا,آسيا سير ارس,2142,4100977,105479560280,25392,25800,25770,378,1.49,25721,329,1.3,24620,26250,1399-9-18
227,قشرين,قند شيرين خراسان,2141,9525142,219121046315,23484,23500,22806,-678,-2.89,23004,-480,-2.04,22780,23999,1399-9-18
228,سشرق,سيمان‌ شرق‌,2134,14599266,97919614760,6820,6700,6640,-180,-2.64,6710,-110,-1.61,6500,6990,1399-9-18
229,هرمز,فولاد هرمزگان جنوب,2104,9370895,126560396109,13573,13550,13465,-108,-0.8,13506,-67,-0.49,13110,13798,1399-9-18
230,غويتا,ويتانا,2092,2798588,128166721822,46751,46350,45990,-761,-1.63,45797,-954,-2.04,44700,46751,1399-9-18
231,خمهر,مهركام‌پارس‌,2089,12379286,96874093990,7960,7980,7750,-210,-2.64,7830,-130,-1.63,7570,8190,1399-9-18
232,تكشا,گسترش‌صنايع‌وخدمات‌كشاورزي‌,2082,1527867,88010673300,58630,56610,58300,-330,-0.56,57600,-1030,-1.76,55700,60000,1399-9-18
233,خكاوه,سايپا ديزل,2070,26464581,140575714684,5207,5340,5363,156,3.0,5312,105,2.02,5070,5363,1399-9-18
234,سدور,سيمان‌ دورود,2068,16301511,158602268890,10200,10000,9690,-510,-5.0,9730,-470,-4.61,9690,10150,1399-9-18
235,پرديس,سرمايه گذاري پرديس,2018,20267662,161687485740,7860,7780,8250,390,4.96,7980,120,1.53,7610,8250,1399-9-18
236,غسالم,سالمين‌,2012,20031467,115082684030,5500,5500,5770,270,4.91,5750,250,4.55,5500,5770,1399-9-18
237,خشرق,الكتريك‌ خودرو شرق‌,1998,8459794,196609130940,22190,21800,23290,1100,4.96,23240,1050,4.73,21800,23290,1399-9-18
238,كرماشا,صنايع پتروشيمي كرمانشاه,1994,9637213,411492283650,44740,44020,43230,-1510,-3.38,42700,-2040,-4.56,42510,44020,1399-9-18
239,فاما,صنعتي‌ آما,1991,4936333,153111334950,29890,31380,30890,1000,3.35,31020,1130,3.78,30030,31380,1399-9-18
240,افق,فروشگاههاي زنجيره اي افق كوروش,1988,956242,78923787540,84030,84760,82060,-1970,-2.34,82840,-1190,-1.42,81080,84760,1399-9-18
241,دسبحان,سبحان دارو,1971,4781767,125365120020,25340,26480,26600,1260,4.97,26220,880,3.47,25110,26600,1399-9-18
242,بالاس,مهندسي ساختمان تاسيسات راه آهن,1965,1893968,111773146948,60139,60139,58500,-1639,-2.73,59015,-1124,-1.87,57153,61200,1399-9-18
243,وسين,بيمه سينا,1963,10174372,255082592219,26183,24874,24874,-1309,-5.0,25071,-1112,-4.25,24874,26100,1399-9-18
244,ثرود,سرمايه‌گذاري مسكن زاينده رود,1954,12840466,148661751218,11173,11030,11731,558,4.99,11578,405,3.62,10727,11731,1399-9-18
245,ولبهمن,شركت بهمن ليزينگ,1944,21814877,244164874400,10912,10600,11457,545,4.99,11193,281,2.58,10390,11457,1399-9-18
246,ثامان,سامان‌ گستراصفهان‌,1921,5866467,139599300200,22840,23500,23980,1140,4.99,23800,960,4.2,22400,23980,1399-9-18
247,ولصنم,ليزينگ‌صنعت‌ومعدن‌,1906,11705393,135156142100,11190,11300,11740,550,4.92,11550,360,3.22,10850,11740,1399-9-18
248,كهمداح,ح . شيشه‌ همدان‌,1906,10385794,125769657660,11740,11790,12250,510,4.34,12110,370,3.15,11610,12500,1399-9-18
249,فخاس,فولاد خراسان,1897,2413426,88873602970,35310,37060,37070,1760,4.98,36490,1180,3.34,35800,37070,1399-9-18
250,جم,پتروشيمي جم,1886,5214497,262047579830,51600,50000,50000,-1600,-3.1,50250,-1350,-2.62,49490,51000,1399-9-18
251,وثنو,سرمايه گذاري ساختماني نوين,1885,10708938,193313618278,17792,17796,18681,889,5.0,18052,260,1.46,16903,18681,1399-9-18
252,رتاپح,ح.تجارت الكترونيك پارسيان,1877,11015770,60502814720,5770,5380,5490,-280,-4.85,5490,-280,-4.85,5270,5800,1399-9-18
253,اعتماد,صندوق س.اعتماد آفرين پارسيان-د,1868,50776440,1711925746710,33699,33600,33724,25,0.07,33715,16,0.05,33600,33724,1399-9-18
254,ثنور,سرمايه گذاري كوه نور,1863,16522022,122384438246,7281,7440,7499,218,2.99,7407,126,1.73,7200,7499,1399-9-18
255,سپاها,سيمان‌سپاهان‌,1854,8256404,74409928840,9330,8910,8890,-440,-4.72,9010,-320,-3.43,8870,9330,1399-9-18
256,شاراك,پتروشيمي شازند,1843,7475610,191090876790,26060,25550,25140,-920,-3.53,25560,-500,-1.92,24930,26510,1399-9-18
257,زاگرس,پتروشيمي زاگرس,1840,758976,144342070499,192121,188000,188700,-3421,-1.78,190180,-1941,-1.01,187002,194400,1399-9-18
258,مارون,پتروشيمي مارون,1832,884061,144022625470,156447,163000,160040,3593,2.3,162910,6463,4.13,159000,164269,1399-9-18
259,دكوثر,داروسازي‌ كوثر,1828,4439624,115501041580,24890,25900,26130,1240,4.98,26020,1130,4.54,24960,26130,1399-9-18
260,سپ,پرداخت الكترونيك سامان كيش,1822,5673875,107871373700,18250,19160,19160,910,4.99,19010,760,4.16,18300,19160,1399-9-18
261,دسانكو,داروسازي سبحان انكولوژي,1814,5097069,98066968403,19771,19100,19230,-541,-2.74,19240,-531,-2.69,18783,20498,1399-9-18
262,بخاور,بيمه زندگي خاورميانه,1805,11001365,101004963205,9154,8750,9358,204,2.23,9181,27,0.29,8707,9500,1399-9-18
263,ثباغ,شهر سازي و خانه سازي باغميشه,1784,4840551,116401660612,23351,22650,24518,1167,5.0,24047,696,2.98,22650,24518,1399-9-18
264,كساوه,صنايع‌ كاشي‌ و سراميك‌ سينا,1767,2796496,268608558690,91650,95870,96230,4580,5.0,96050,4400,4.8,92100,96230,1399-9-18
265,فسازان,غلتك سازان سپاهان,1762,8249737,282217446370,32740,32160,34370,1630,4.98,34210,1470,4.49,31850,34370,1399-9-18
266,سكرد,سيمان كردستان,1762,7987028,75844201160,9510,9500,9500,-10,-0.11,9500,-10,-0.11,9100,9750,1399-9-18
267,طلا,صندوق س.پشتوانه طلاي لوتوس,1731,1170777,105055964782,87375,89980,89322,1947,2.23,89732,2357,2.7,89001,90200,1399-9-18
268,وصندوق,سرمايه‌گذاري‌صندوق‌بازنشستگي‌,1731,7746600,134034145590,16990,16560,17300,310,1.82,17300,310,1.82,16420,17600,1399-9-18
269,شاوان,پالايش نفت لاوان,1729,1351347,164369471036,124649,124000,118417,-6232,-5.0,121634,-3015,-2.42,118417,126640,1399-9-18
270,وتوسم,سرمايه‌گذاري‌توسعه‌ملي‌,1712,6291522,91921346270,14280,14980,14700,420,2.94,14610,330,2.31,14000,14980,1399-9-18
271,وسكاب,س.ص.بازنشستگي كاركنان بانكها,1702,13248623,93094088870,7180,7050,6960,-220,-3.06,7030,-150,-2.09,6940,7200,1399-9-18
272,دلقما,دارويي‌ لقمان‌,1699,3609752,113979983990,32340,31220,31890,-450,-1.39,31580,-760,-2.35,30730,32840,1399-9-18
273,شپاكسا,پاكسان‌,1683,3339420,107854498290,33490,33500,31840,-1650,-4.93,32300,-1190,-3.55,31820,33780,1399-9-18
274,وبهمن,سرمايه‌گذاري‌بهمن‌,1680,5846005,118689752050,20380,20380,20700,320,1.57,20300,-80,-0.39,19470,20830,1399-9-18
275,خوساز,محورسازان‌ايران‌خودرو,1656,9020433,70520048060,8090,7820,7690,-400,-4.94,7820,-270,-3.34,7690,8200,1399-9-18
276,زنگان,صنعت روي زنگان,1646,1038724,108811518785,109292,103850,103828,-5464,-5.0,104755,-4537,-4.15,103828,110550,1399-9-18
277,زنجان,صنايع كشاورزي وكود زنجان,1633,19682094,202000366839,9991,9860,10290,299,2.99,10263,272,2.72,9860,10290,1399-9-18
278,پكرمان,گروه‌ صنعتي‌ بارز,1608,5266812,171388876470,33550,32020,32100,-1450,-4.32,32540,-1010,-3.01,31900,33560,1399-9-18
279,سصفها,سيمان‌اصفهان‌,1605,1738427,420469511930,236000,229410,247800,11800,5.0,241870,5870,2.49,224200,247800,1399-9-18
280,آ س پ,آ.س.پ,1597,8611763,100479523740,11301,11250,11866,565,5.0,11668,367,3.25,11050,11866,1399-9-18
281,آريان,سرمايه گذاري پارس آريان,1579,14669240,232025753311,16246,16244,15914,-332,-2.04,15817,-429,-2.64,15759,16246,1399-9-18
282,تسه9908,امتياز تسهيلات مسكن آبان99,1576,40687,24546630224,605613,605613,600000,-5613,-0.93,603304,-2309,-0.38,596000,605613,1399-9-18
283,زشريف,كشت وصنعت شريف آباد,1576,3894061,100264765467,25058,24006,26310,1252,5.0,25748,690,2.75,24002,26310,1399-9-18
284,وشهر,بانك شهر,1567,20750085,163287928905,8128,8280,7803,-325,-4.0,7869,-259,-3.19,7803,8280,1399-9-18
285,ولشرق,ليزينگ ايران و شرق,1536,17652123,133539977577,7208,7567,7568,360,4.99,7565,357,4.95,7297,7568,1399-9-18
286,ميدكو,هلدينگ صنايع  معدني خاورميانه,1529,4348569,115521638384,26687,26690,26719,32,0.12,26569,-118,-0.44,26275,26730,1399-9-18
287,چفيبر,فيبر ايران‌,1529,17965820,140079905090,7470,7550,7840,370,4.95,7800,330,4.42,7200,7840,1399-9-18
288,واميد,گروه مديريت سرمايه گذاري اميد,1526,3193186,125033671280,38500,37680,39200,700,1.82,39160,660,1.71,37680,39900,1399-9-18
289,غشاذر,پگاه‌آذربايجان‌غربي‌,1521,2900216,61701193800,21330,20280,21540,210,0.98,21270,-60,-0.28,20280,21960,1399-9-18
290,فن آوا,گروه فن آوا,1520,10156559,139948782808,14462,13739,13739,-723,-5.0,13779,-683,-4.72,13739,14030,1399-9-18
291,فرآور,فرآوري‌موادمعدني‌ايران‌,1520,6508729,166689396960,24650,24900,25880,1230,4.99,25610,960,3.89,24100,25880,1399-9-18
292,چافست,افست‌,1513,5666635,142531094330,23980,24990,25170,1190,4.96,25150,1170,4.88,24360,25170,1399-9-18
293,ميهن,بيمه ميهن,1507,22222527,153041268930,6571,6710,6899,328,4.99,6887,316,4.81,6600,6899,1399-9-18
294,وبيمه,سرمايه‌ گذاري‌ صنعت‌ بيمه‌,1495,23250531,86028877200,3540,3700,3710,170,4.8,3700,160,4.52,3540,3710,1399-9-18
295,سخزر,سيمان‌ خزر,1495,4625298,138989935000,29880,30000,29150,-730,-2.44,30050,170,0.57,28680,31340,1399-9-18
296,زفكا,كشت و دامداري فكا,1484,1547083,80819634110,53427,51130,51350,-2077,-3.89,52240,-1187,-2.22,51130,54240,1399-9-18
297,امين يكم,صندوق درآمد ثابت امين يكم فردا,1482,41685768,425485396894,10196,10222,10220,24,0.24,10207,11,0.11,10197,10222,1399-9-18
298,تماوند,تامين سرمايه دماوند,1480,13787657,200242735819,14087,14000,14791,704,5.0,14523,436,3.1,13700,14791,1399-9-18
299,غپاك,لبنيات‌ پاك‌,1478,6526891,94923704670,14760,14300,14560,-200,-1.36,14540,-220,-1.49,14030,14990,1399-9-18
300,پكوير,كوير تاير,1471,2743358,51644415960,19270,18450,19150,-120,-0.62,18830,-440,-2.28,18310,19390,1399-9-18
301,فمراد,آلومراد,1467,1074747,134168363690,120230,115000,126240,6010,5.0,124840,4610,3.83,115000,126240,1399-9-18
302,شدوص,دوده‌ صنعتي‌ پارس‌,1442,3355089,85630922250,26210,25740,25300,-910,-3.47,25520,-690,-2.63,24900,27000,1399-9-18
303,قزوين,كارخانجات‌ قند قزوين‌,1439,1654416,73275281310,44690,42700,43500,-1190,-2.66,44290,-400,-0.9,42700,45680,1399-9-18
304,شبهرن,نفت‌ بهران‌,1434,1896998,121437415660,65210,63530,64500,-710,-1.09,64020,-1190,-1.82,63020,64900,1399-9-18
305,سنير,سيمان‌ سفيد ني‌ريز,1432,616131,54275972480,92140,90110,87540,-4600,-4.99,88090,-4050,-4.4,87540,92360,1399-9-18
306,كلوند,كاشي‌ الوند,1423,2633504,73000945230,26800,27600,28140,1340,5.0,27720,920,3.43,26050,28140,1399-9-18
307,فنورد,نوردوقطعات‌ فولادي‌,1420,1318292,235237445600,173930,165500,182620,8690,5.0,178440,4510,2.59,165500,182620,1399-9-18
308,دانا,بيمه دانا,1414,17018174,143923326220,8060,8400,8460,400,4.96,8460,400,4.96,8250,8460,1399-9-18
309,حبندر,دريايي و کشتيراني خط دريابندر,1408,3846711,122819771168,31326,30388,32265,939,3.0,31929,603,1.92,30387,32265,1399-9-18
310,شتوكا,توكا رنگ فولاد سپاهان,1407,1784025,76533601972,42624,43000,43000,376,0.88,42899,275,0.65,41500,44250,1399-9-18
311,بهپاك,صنعتي بهپاك,1403,2748241,126940457249,45731,46500,45000,-731,-1.6,46190,459,1.0,43445,48017,1399-9-18
312,زگلدشت,كشت و دام گلدشت نمونه اصفهان,1403,1620405,79393987424,47101,48000,49456,2355,5.0,48996,1895,4.02,46010,49456,1399-9-18
313,دابور,داروسازي‌ ابوريحان‌,1398,1275440,64316678820,52160,49950,50000,-2160,-4.14,50430,-1730,-3.32,49560,51700,1399-9-18
314,ومعادنح,ح . توسعه‌معادن‌وفلزات‌,1391,66321277,928514241600,14000,15400,14000,0,0.0,14000,0,0.0,14000,15400,1399-9-18
315,دامين,داروسازي‌ امين‌,1383,3425587,54676845650,15680,15760,16380,700,4.46,15950,270,1.72,15220,16430,1399-9-18
316,غپينو,پارس‌ مينو,1383,20457935,190667954200,8880,9320,9320,440,4.95,9320,440,4.95,9320,9320,1399-9-18
317,فايرا,آلومينيوم‌ايران‌,1366,2832693,75771521160,26930,26000,26300,-630,-2.34,26750,-180,-0.67,25600,27700,1399-9-18
318,فباهنر,مس‌ شهيدباهنر,1353,1742570,94185197640,55810,54110,53320,-2490,-4.46,54050,-1760,-3.15,53020,56680,1399-9-18
319,فجر,فولاد اميركبيركاشان,1318,3676817,233084242870,64130,64200,63350,-780,-1.22,63390,-740,-1.15,62310,64930,1399-9-18
320,غبشهر,صنعتي‌ بهشهر,1317,4144378,117570669650,29440,28050,28560,-880,-2.99,28370,-1070,-3.63,27970,29440,1399-9-18
321,ثشرق,سرمايه گذاري مسكن شمال شرق,1310,17958936,110772870930,5970,5710,6260,290,4.86,6170,200,3.35,5710,6260,1399-9-18
322,غنوش,نوش‌ مازندران‌,1289,1624610,106076724870,68230,65260,64820,-3410,-5.0,65290,-2940,-4.31,64820,68000,1399-9-18
323,وسبحان,سرمايه گذاري سبحان,1286,7027979,63593004082,9188,9000,9180,-8,-0.09,9049,-139,-1.51,8810,9250,1399-9-18
324,پلاست,كارخانجات توليدي پلاستيران,1281,3255491,132375183227,42719,40584,40584,-2135,-5.0,40662,-2057,-4.82,40584,41383,1399-9-18
325,هجرت,پخش هجرت,1280,1251298,83143507627,64597,62700,67300,2703,4.18,66446,1849,2.86,62700,67826,1399-9-18
326,ددام,داروسازي زاگرس فارمد پارس,1278,6577304,110241876030,16180,15710,16980,800,4.94,16760,580,3.58,15710,16980,1399-9-18
327,سمازن,سيمان‌مازندران‌,1274,5156207,57584158450,11170,11390,11340,170,1.52,11170,0,0.0,10620,11500,1399-9-18
328,شگل,گلتاش‌,1273,3072126,88963780240,27790,26700,29170,1380,4.97,28960,1170,4.21,26700,29170,1399-9-18
329,پخش,پخش البرز,1270,1972161,92152328965,46739,46100,47020,281,0.6,46727,-12,-0.03,44800,47950,1399-9-18
330,غالبر,لبنيات‌ كالبر,1268,3629046,44602465850,12850,12480,12210,-640,-4.98,12340,-510,-3.97,12210,12980,1399-9-18
331,سرچشمه,سرمايه گذاري مس سرچشمه,1258,7329848,67577701236,9193,9390,9170,-23,-0.25,9220,27,0.29,9100,9400,1399-9-18
332,وثوق,سرمايه گذاري وثوق امين,1253,4626675,57287883851,12238,11871,12605,367,3.0,12382,144,1.18,11871,12605,1399-9-18
333,وپسا,س. پتروشيمي ساختمان  خليج فارس,1241,18323826,71532810060,4008,3938,3888,-120,-2.99,3904,-104,-2.59,3888,4050,1399-9-18
334,دسبحا,گروه دارويي سبحان,1232,5181881,123537428460,22730,23850,23860,1130,4.97,23840,1110,4.88,23470,23860,1399-9-18
335,شفارا,پتروشيمي فارابي,1225,8621894,43383184898,5012,5012,4930,-82,-1.64,5032,20,0.4,4900,5160,1399-9-18
336,شخارك,پتروشيمي‌ خارك‌,1224,2323690,107730309370,48000,47090,46530,-1470,-3.06,46360,-1640,-3.42,45800,47100,1399-9-18
337,شوينده,مديريت صنعت شوينده ت.ص.بهشهر,1213,2835523,116579814670,42880,41200,41060,-1820,-4.24,41110,-1770,-4.13,40740,43000,1399-9-18
338,رتاپ,تجارت الكترونيك  پارسيان,1213,4407723,32436082240,7460,7370,7500,40,0.54,7400,-60,-0.8,7110,7530,1399-9-18
339,حتايد,تايدواترخاورميانه,1212,2961044,61068870930,20630,19750,20940,310,1.5,20620,-10,-0.05,19750,21400,1399-9-18
340,وآرين,شركت توسعه اقتصادي آرين,1210,8299975,48130690066,5950,6030,5772,-178,-2.99,5799,-151,-2.54,5772,6030,1399-9-18
341,بميلا,توسعه بازرگاني آهن وفولادميلاد,1207,3710434,83803744633,22966,23000,22212,-754,-3.28,22586,-380,-1.65,21818,24000,1399-9-18
342,غگرجي,بيسكويت‌  گرجي‌,1206,2171564,84099876470,37280,38000,39140,1860,4.99,38730,1450,3.89,37730,39140,1399-9-18
343,وايرا,سرمايه گذاري صنايع ايران,1204,16295692,145636106415,8516,8941,8941,425,4.99,8937,421,4.94,8100,8941,1399-9-18
344,وخاور,بانك خاورميانه,1202,4919440,52912121100,10730,10950,10800,70,0.65,10750,20,0.19,10500,10950,1399-9-18
345,وگستر,گسترش سرمايه گذاري ايرانيان,1196,1966695,50319724477,26131,26700,25263,-868,-3.32,25613,-518,-1.98,25020,26700,1399-9-18
346,جم پيلن,پلي پروپيلن جم - جم پيلن,1175,1552602,135573173970,91310,87500,86750,-4560,-4.99,87320,-3990,-4.37,86750,90390,1399-9-18
347,تكنو,تكنوتار,1171,4849856,68345103750,13560,13540,14230,670,4.94,14090,530,3.91,13100,14230,1399-9-18
348,وصنا,گروه‌صنايع‌بهشهرايران‌,1171,4620354,60378744120,13660,13000,13000,-660,-4.83,13070,-590,-4.32,12980,13500,1399-9-18
349,گوهران,سرمايه گذاري توسعه گوهران اميد,1169,5035622,49254956870,9469,9130,9942,473,5.0,9744,275,2.9,9130,9942,1399-9-18
350,كاذرح,ح . فرآورده‌هاي‌نسوزآذر,1157,2903230,55111396510,18310,18300,19330,1020,5.57,18980,670,3.66,17430,19480,1399-9-18
351,ضملت1129,اختيارخ وبملت-7000-1399/11/28,1148,76094,18057262000,400,151,298,-102,-25.5,237,-163,-40.75,120,320,1399-9-18
352,ثقزوي,شركت عمران و سازندگي قزوين,1145,3216697,85755690585,25890,26666,26666,776,3.0,26660,770,2.97,26455,26666,1399-9-18
353,پارسيان,بيمه پارسيان,1141,3365089,50087967210,14970,14690,14900,-70,-0.47,14880,-90,-0.6,14400,15400,1399-9-18
354,تابا,تابان نيرو سپاهان,1140,1683389,50283431122,30582,29670,29665,-917,-3.0,29870,-712,-2.33,29665,30980,1399-9-18
355,پارند,صندوق س. پارند پايدار سپهر,1128,45177687,508294682589,11262,11251,11250,-12,-0.11,11251,-11,-0.1,11249,11265,1399-9-18
356,تيپيكو,سرمايه گذاري دارويي تامين,1114,1111112,65851121970,60820,58240,58970,-1850,-3.04,59820,-1000,-1.64,58000,61990,1399-9-18
357,غمينو,شركت صنايع غذايي مينو شرق,1106,4446730,65955835092,14250,14800,14962,712,5.0,14832,582,4.08,14100,14962,1399-9-18
358,شيراز,پتروشيمي‌شيراز,1102,1791974,107679433640,59270,60000,59000,-270,-0.46,60090,820,1.38,56800,60990,1399-9-18
359,آوا,صندوق س.سهام آواي معيار-س,1096,4670692,44849484382,9719,9600,9530,-189,-1.94,9602,-117,-1.2,9420,9767,1399-9-18
360,خموتور,موتورسازان‌تراكتورسازي‌ايران‌,1096,10758037,129612233500,11500,11510,12070,570,4.96,12050,550,4.78,11510,12070,1399-9-18
361,لوتوس,تامين سرمايه لوتوس پارسيان,1042,3952378,59287958000,14810,14520,15120,310,2.09,15000,190,1.28,14520,15400,1399-9-18
362,كپشير,پشم‌شيشه‌ايران‌,1036,1855954,36032724560,18770,17980,19700,930,4.95,19220,450,2.4,17980,19700,1399-9-18
363,درازك,دارويي‌ رازك‌,1031,1920933,86341848140,45580,44360,45150,-430,-0.94,44950,-630,-1.38,43310,46440,1399-9-18
364,قلرست,قند لرستان‌,1029,2006573,53141123670,27540,27500,26230,-1310,-4.76,26480,-1060,-3.85,26170,27500,1399-9-18
365,كوير,توليدي فولاد سپيد فراب كوير,1028,3721452,79527429240,20360,21370,21370,1010,4.96,21230,870,4.27,21370,21370,1399-9-18
366,واتي,سرمايه‌ گذاري‌ آتيه‌ دماوند,1028,8227258,129126432090,15120,15000,15870,750,4.96,15690,570,3.77,14690,15870,1399-9-18
367,ساراب,سيمان‌ داراب‌,1026,3136510,44474529260,13670,14050,14350,680,4.97,14070,400,2.93,13650,14350,1399-9-18
368,شرانل,نفت ايرانول,1024,1123123,42607962483,39071,38160,37800,-1271,-3.25,38176,-895,-2.29,37118,39790,1399-9-18
369,غشصفا,شيرپاستوريزه‌پگاه‌اصفهان‌,1023,2198434,64040618030,30270,28760,30170,-100,-0.33,29130,-1140,-3.77,28760,30200,1399-9-18
370,غگلستا,شير پاستوريزه پگاه گلستان,1022,3256543,65135959161,19107,19600,20062,955,5.0,20002,895,4.68,19107,20062,1399-9-18
371,دجابر,داروسازي‌ جابرابن‌حيان‌,1022,2584008,121411436030,45120,45000,47370,2250,4.99,46990,1870,4.14,44800,47370,1399-9-18
372,وكادو,تكادو,1016,4888141,107208671653,21312,21951,21951,639,3.0,21932,620,2.91,21338,21951,1399-9-18
373,دعبيد,لابراتوارداروسازي‌  دكترعبيدي‌,1016,1089372,36206752890,33930,32350,33600,-330,-0.97,33510,-420,-1.24,32350,33900,1399-9-18
374,بشهاب,لامپ‌  پارس‌ شهاب‌,1000,1290801,91086285820,67590,65220,70960,3370,4.99,70570,2980,4.41,64270,70960,1399-9-18
375,لابسا,آبسال‌,998,1639894,68031936730,39710,41390,41690,1980,4.99,41490,1780,4.48,39710,41690,1399-9-18
376,دفارا,داروسازي‌ فارابي‌,993,586886,40909261810,70880,71000,68500,-2380,-3.36,69940,-940,-1.33,68300,71990,1399-9-18
377,دشيمي,شيمي‌ داروئي‌ داروپخش‌,982,1033773,59855741490,58600,57590,57390,-1210,-2.06,57900,-700,-1.19,56510,59990,1399-9-18
378,تاپكيش,تجارت الكترونيك پارسيان كيش,968,3443821,82486347824,22812,23952,23952,1140,5.0,23952,1140,5.0,23950,23952,1399-9-18
379,وبشهر,توسعه‌ صنايع‌ بهشهر(هلدينگ,966,3883769,69607897780,18410,17530,18240,-170,-0.92,17920,-490,-2.66,17490,18670,1399-9-18
380,عيار,صندوق س. پشتوانه طلاي مفيد,964,1138174,35198394317,30099,31390,30624,525,1.74,30925,826,2.74,30600,31390,1399-9-18
381,قشكر,شكرشاهرود,963,1316240,59240940930,46970,45000,44630,-2340,-4.98,45010,-1960,-4.17,44630,47500,1399-9-18
382,وحكمت,بيمه حكمت صبا,955,5203808,30603594848,5710,5881,5881,171,2.99,5881,171,2.99,5881,5881,1399-9-18
383,دالبر,البرزدارو,945,2032256,50211465160,24450,24250,25370,920,3.76,24690,240,0.98,23800,25500,1399-9-18
384,سغرب,سيمان‌غرب‌,935,1948727,39838159580,20090,19160,21090,1000,4.98,20360,270,1.34,19090,21090,1399-9-18
385,فولاژ,فولاد آلياژي ايران,935,1416229,38836969240,28020,26810,27010,-1010,-3.6,27670,-350,-1.25,26630,28190,1399-9-18
386,كنور,توسعه معدني و صنعتي صبانور,934,845681,39467644630,48250,45920,46150,-2100,-4.35,47110,-1140,-2.36,45840,48250,1399-9-18
387,خپويش,سازه‌ پويش‌,908,1098971,43123231810,39100,41010,38980,-120,-0.31,39210,110,0.28,37150,41010,1399-9-18
388,حپارسا,توسعه حمل و نقل ريلي پارسيان,906,1975470,70106895962,36731,35350,34895,-1836,-5.0,35489,-1242,-3.38,34895,36700,1399-9-18
389,كفرآور,فرآورده هاي سيمان شرق,903,4073634,75535029025,18988,18419,19100,112,0.59,18542,-446,-2.35,18419,19160,1399-9-18
390,پسهند,صنايع‌ لاستيكي‌  سهند,900,1302581,57588421700,45670,43430,43390,-2280,-4.99,44210,-1460,-3.2,43390,46500,1399-9-18
391,فافزا,فولاد افزا سپاهان,895,1658858,71219387417,41701,42952,42952,1251,3.0,42933,1232,2.95,42080,42952,1399-9-18
392,خفناور,مهندسي صنعتي روان فن آور,883,2617639,73668204868,27572,27572,28399,827,3.0,28143,571,2.07,27320,28399,1399-9-18
393,ساروم,سيمان‌اروميه‌,880,1708607,46681624530,27960,26760,27200,-760,-2.72,27390,-570,-2.04,26570,28400,1399-9-18
394,خنصير,مهندسي‌نصيرماشين‌,878,2051570,103763048980,48270,50370,50680,2410,4.99,50580,2310,4.79,48750,50680,1399-9-18
395,دتماد,توليدمواداوليه‌داروپخش‌,866,971927,54521397320,56350,54500,57000,650,1.15,56100,-250,-0.44,53860,58160,1399-9-18
396,كمنگنز,معادن‌منگنزايران‌,861,460838,47631268660,104360,103000,104360,0,0.0,103430,-930,-0.89,99800,106000,1399-9-18
397,شراز,پالايش نفت شيراز,858,1040233,127013156687,116703,111120,122538,5835,5.0,122101,5398,4.63,111120,122538,1399-9-18
398,وسنا,سرمايه گذاري نيروگاهي ايران,858,3021558,52219386812,16620,17400,17451,831,5.0,17282,662,3.98,16800,17451,1399-9-18
399,وملت,سرمايه گذاري ملت,846,6582910,27197799712,4212,4194,4128,-84,-1.99,4132,-80,-1.9,4128,4280,1399-9-18
400,فيروزه,صندوق شاخص30 شركت فيروزه- سهام,845,292447,54657004420,188300,184210,187500,-800,-0.42,186900,-1400,-0.74,183880,189400,1399-9-18
401,دپارس,پارس‌ دارو,835,614310,64231803050,102290,98220,105820,3530,3.45,104560,2270,2.22,98220,107300,1399-9-18
402,بايكا,كارخانجات كابلسازي ‌ايران‌,834,1408527,83971723035,56844,59686,59686,2842,5.0,59617,2773,4.88,57420,59686,1399-9-18
403,غچين,كشت‌ و صنعت‌ چين‌ چين,833,1315815,68742656330,51870,49500,51700,-170,-0.33,52240,370,0.71,49500,53490,1399-9-18
404,زكشت,كشاورزي مكانيزه اصفهان كشت,833,1144229,35584014094,30946,30010,31350,404,1.31,31052,106,0.34,29800,32070,1399-9-18
405,خودكفا,اقتصادي و خودكفايي آزادگان,832,6095179,213550691444,33368,35036,35036,1668,5.0,35036,1668,5.0,35036,35036,1399-9-18
406,فلامي,لاميران‌,832,696812,27323969600,40000,39990,38700,-1300,-3.25,39540,-460,-1.15,38100,40500,1399-9-18
407,مبين,مبين انرژي خليج فارس,832,4009756,92579384480,23530,23500,22800,-730,-3.1,23100,-430,-1.83,22600,23700,1399-9-18
408,غپآذر,شير پگاه آذربايجان شرقي,831,1157850,65164749753,58527,56780,56140,-2387,-4.08,56281,-2246,-3.84,55601,60020,1399-9-18
409,كساپا,سايپاشيشه‌,824,1138397,29866119190,26750,25910,25910,-840,-3.14,26430,-320,-1.2,25560,27020,1399-9-18
410,اتكاي,بيمه اتكايي ايرانيان,823,1756486,25886577945,15399,15650,14630,-769,-4.99,15047,-352,-2.29,14630,15650,1399-9-18
411,زر,صندوق س.پشتوانه سكه طلاي زر,818,1104736,57969855110,51322,53000,52100,778,1.52,52474,1152,2.24,51500,53000,1399-9-18
412,كپرور,فرآوري زغال سنگ پروده طبس,806,1188418,51894479110,43983,43983,45000,1017,2.31,43667,-316,-0.72,42010,45469,1399-9-18
413,سفانو,سيمان فارس نو,793,1686758,58106068140,35800,35180,34080,-1720,-4.8,34450,-1350,-3.77,34010,36000,1399-9-18
414,بفجر,فجر انرژي خليج فارس,782,1780812,52565903390,30170,29020,29280,-890,-2.95,29720,-450,-1.49,29000,30160,1399-9-18
415,بنو,بيمه تجارت نو,780,4013428,120598233684,28678,29900,30111,1433,5.0,30049,1371,4.78,29000,30111,1399-9-18
416,پارس,پتروشيمي پارس,779,581497,93615374110,163210,163800,160280,-2930,-1.8,161060,-2150,-1.32,158910,163800,1399-9-18
417,ثزاگرس,سرمايه گذاري توسعه عمران زاگرس,773,1086760,43482774367,41355,39288,40000,-1355,-3.28,40011,-1344,-3.25,39288,42000,1399-9-18
418,وتوشه,سرمايه‌ گذاري‌ پارس‌ توشه‌,770,1952038,47087814060,24930,24980,24420,-510,-2.05,24200,-730,-2.93,23690,24980,1399-9-18
419,كمينا,شيشه سازي مينا,768,1495403,57540722627,38567,37025,38001,-566,-1.47,38478,-89,-0.23,36700,39780,1399-9-18
420,خفنر,فنرسازي‌خاور,765,2201878,47466186540,20570,21590,21590,1020,4.96,21440,870,4.23,20720,21590,1399-9-18
421,بنيرو,نيروترانس‌,763,401950,22184239490,55300,53660,55000,-300,-0.54,55250,-50,-0.09,53190,56800,1399-9-18
422,غدشت,دشت‌ مرغاب‌,759,127872,34453879260,270990,266120,265140,-5850,-2.16,269940,-1050,-0.39,264030,275000,1399-9-18
423,وسكرد,شركت س استان كردستان,756,33703494,28043893360,870,830,850,-20,-2.3,850,-20,-2.3,830,850,1399-9-18
424,رتكو,كنترل‌خوردگي‌تكين‌كو,755,5147510,99203107560,18720,18000,19650,930,4.97,19270,550,2.94,18000,19650,1399-9-18
425,اطلس,صندوق س.توسعه اندوخته آينده-س,753,130238,27752556600,214040,212000,213990,-50,-0.02,213091,-949,-0.44,207116,216965,1399-9-18
426,تكمبا,كمباين‌ سازي‌ ايران‌,753,5711660,56316286440,9410,9350,9880,470,4.99,9860,450,4.78,9260,9880,1399-9-18
427,كشرق,صنعتي و معدني شمال شرق شاهرود,751,438149,34922641659,80424,76550,81850,1426,1.77,79917,-507,-0.63,76550,82500,1399-9-18
428,لخزر,پارس‌ خزر,746,173484,32600917420,189300,189090,187380,-1920,-1.01,188430,-870,-0.46,179900,193500,1399-9-18
429,غگلپا,شير پاستوريزه پگاه گلپايگان,734,838408,60513123727,70627,69510,74158,3531,5.0,72176,1549,2.19,67900,74158,1399-9-18
430,قمرو,قند مرودشت‌,731,1332538,38758769200,28390,27000,29680,1290,4.54,28890,500,1.76,27000,29790,1399-9-18
431,شساخت,مهندسي و ساختمان صنايع نفت,722,5189903,230933380430,42406,44526,44526,2120,5.0,44497,2091,4.93,43001,44526,1399-9-18
432,فپنتا,سپنتا,719,337697,118489110330,335200,321000,351960,16760,5.0,350870,15670,4.67,321000,351960,1399-9-18
433,ولملت,واسپاري ملت,718,4106964,46336157840,11480,11480,11670,190,1.66,11300,-180,-1.57,10910,11740,1399-9-18
434,وهنر,گروه توسعه هنر ايران,717,13401237,69046041388,5007,5157,5157,150,3.0,5152,145,2.9,5007,5157,1399-9-18
435,مداران,داده‌پردازي‌ايران‌,707,2683908,70683420520,25150,26260,26400,1250,4.97,26340,1190,4.73,24010,26400,1399-9-18
436,غمهرا,توليدي‌مهرام‌,706,664244,39868743090,58180,55410,61080,2900,4.98,59560,1380,2.37,55410,61080,1399-9-18
437,سفار,سيمان‌فارس‌,695,602111,57355062390,90730,95260,95260,4530,4.99,95260,4530,4.99,94700,95260,1399-9-18
438,خاور,ايران خودرو ديزل,684,8724927,58282512360,6362,6680,6680,318,5.0,6680,318,5.0,6680,6680,1399-9-18
439,كاردان,صندوق س تجارت شاخصي كاردان,681,305250,58613378240,192410,191500,192010,-400,-0.21,192020,-390,-0.2,188000,195000,1399-9-18
440,افرا,افرانت,677,830174,39545295695,50044,49000,47542,-2502,-5.0,48137,-1907,-3.81,47542,49000,1399-9-18
441,اميدح,ح . تامين سرمايه اميد,670,19254126,198567906080,10380,11000,10020,-360,-3.47,10310,-70,-0.67,10000,11000,1399-9-18
442,سشمال,سيمان‌ شمال‌,670,3403851,31325004880,9330,9000,9380,50,0.54,9250,-80,-0.86,8870,9550,1399-9-18
443,دسينا,داروسازي‌ سينا,670,1253400,40363187750,30990,32000,32530,1540,4.97,31840,850,2.74,31600,32530,1399-9-18
444,قچار,فراوردههاي غذايي وقند چهارمحال,666,1923379,129658825148,64202,67412,67412,3210,5.0,67412,3210,5.0,67412,67412,1399-9-18
445,خراسان,پتروشيمي خراسان,658,802939,59318317080,77020,73210,73630,-3390,-4.4,73880,-3140,-4.08,73180,77100,1399-9-18
446,وارس,سرمايه گذاري ارس صبا,658,452818,40552051629,91508,91471,90000,-1508,-1.65,89555,-1953,-2.13,88763,91471,1399-9-18
447,ورازي,بيمه رازي,656,4914212,63977845365,12404,13024,13024,620,5.0,13019,615,4.96,12900,13024,1399-9-18
448,ثاژن,سخت آژند,654,5237104,42404196921,8016,8176,8176,160,2.0,8097,81,1.01,7856,8176,1399-9-18
449,كاسپين,داروسازي كاسپين تامين,644,1292607,39908296942,29538,30500,31014,1476,5.0,30483,945,3.2,28940,31014,1399-9-18
450,كاذر,فرآورده‌هاي‌نسوزآذر,631,2141899,47486460140,21140,22160,22190,1050,4.97,21980,840,3.97,21500,22190,1399-9-18
451,ثاختح,ح . بين‌المللي‌توسعه‌ساختمان,628,16345744,52434698790,3470,3300,3210,-260,-7.49,3210,-260,-7.49,3200,3300,1399-9-18
452,كاريس,صندوق س.سپهر كاريزما-س,628,265030,56778861167,216047,214940,215100,-947,-0.44,214236,-1811,-0.84,209550,218000,1399-9-18
453,غفارس,شير پاستوريزه پگاه فارس,620,3562496,35229213583,9530,9155,10006,476,4.99,9768,238,2.5,9155,10006,1399-9-18
454,نتوس,پشم‌ بافي‌ توس,612,2012779,21567407321,10525,10835,10840,315,2.99,10715,190,1.81,10210,10840,1399-9-18
455,شمواد,توليد مواداوليه الياف مصنوعي,610,481689,29989998509,60451,62264,62264,1813,3.0,62260,1809,2.99,62033,62264,1399-9-18
456,سخواف,سيمان مجد خواف,599,1790817,24811769535,13452,13855,13855,403,3.0,13855,403,3.0,13855,13855,1399-9-18
457,سبهان,سيمان‌ بهبهان‌,594,390212,24489520570,61890,60100,63900,2010,3.25,62280,390,0.63,60100,64090,1399-9-18
458,دكيمي,كيميدارو,593,1459262,41879247940,28720,29390,28700,-20,-0.07,28700,-20,-0.07,27400,29990,1399-9-18
459,خزر,فنرسازي‌زر,591,2732855,72557300250,25290,26550,26550,1260,4.98,26550,1260,4.98,26550,26550,1399-9-18
460,ثعتما,س. ساختماني اعتماد گستر,590,825035,34469589676,41684,40440,41500,-184,-0.44,41780,96,0.23,40440,42934,1399-9-18
461,لپيام,گسترش صنايع پيام,589,1037832,31895435047,29964,30862,30862,898,3.0,30733,769,2.57,30150,30862,1399-9-18
462,شلعاب,لعابيران‌,585,2522060,23303834400,8800,9240,9240,440,5.0,8980,180,2.05,9240,9240,1399-9-18
463,گوهر,صندوق سكه طلاي كيان,584,574305,35038708745,60358,61400,60000,-358,-0.59,61011,653,1.08,60000,62000,1399-9-18
464,سباقر,سيمان باقران,579,2722832,41186504054,14837,15262,15282,445,3.0,15126,289,1.95,14392,15282,1399-9-18
465,كيان,صندوق س. با درآمد ثابت كيان,571,10570005,277211271235,26217,26230,26230,13,0.05,26226,9,0.03,26224,26231,1399-9-18
466,مفاخر,توسعه فناوري اطلاعات خوارزمي,568,587617,26337804235,45596,43320,46600,1004,2.2,45196,-400,-0.88,43320,46700,1399-9-18
467,ركيش,كارت اعتباري ايران كيش,561,2711938,45534546030,16830,16300,16820,-10,-0.06,16790,-40,-0.24,16260,17050,1399-9-18
468,خمحور,توليدمحورخودرو,556,438271,29705946190,68560,68150,67790,-770,-1.12,68110,-450,-0.66,65160,69800,1399-9-18
469,خديزل,بهمن  ديزل,544,874524,44122607587,51016,52950,50897,-119,-0.23,50527,-489,-0.96,48466,52950,1399-9-18
470,قاسم,قاسم ايران,544,4748728,70262179488,14092,14796,14796,704,5.0,14796,704,5.0,14796,14796,1399-9-18
471,آساس,صندوق س.آسمان آرماني سهام-س,544,217056,38109559309,175339,172600,175705,366,0.21,175575,236,0.13,172300,177999,1399-9-18
472,شفا,سرمايه گذاري شفادارو,543,432441,27280453510,63210,65990,62130,-1080,-1.71,63150,-60,-0.09,62000,65990,1399-9-18
473,غدام,خوراك‌  دام‌ پارس‌,543,203694,65000792340,303920,319110,319110,15190,5.0,319110,15190,5.0,319110,319110,1399-9-18
474,زپارس,ملي كشت و صنعت و دامپروري پارس,542,1264276,105013991810,80040,76510,84040,4000,5.0,83060,3020,3.77,76510,84040,1399-9-18
475,شاملا,معدني‌ املاح‌  ايران‌,527,1053810,69631260460,63700,63090,66880,3180,4.99,66080,2380,3.74,62900,66880,1399-9-18
476,داسوه,داروسازي‌ اسوه‌,523,781417,23342970140,30640,29280,30200,-440,-1.44,30290,-350,-1.14,29270,30500,1399-9-18
477,سجام,مجتمع سيمان غرب آسيا,523,4105148,62011986127,15059,15180,14620,-439,-2.92,15106,47,0.31,14608,15268,1399-9-18
478,ضصاد1103,اختيارخ وبصادر-4000-1399/11/12,522,23718,11453161000,467,550,504,37,7.92,483,16,3.43,450,554,1399-9-18
479,سرود,سيمان‌شاهرود,519,2767701,45972854540,15860,16100,16650,790,4.98,16480,620,3.91,15860,16650,1399-9-18
480,شنفت,نفت‌ پارس‌,518,437090,26576536770,62420,60640,61400,-1020,-1.63,61710,-710,-1.14,59300,62420,1399-9-18
481,ثجوان,تامين مسكن جوانان,518,3674646,31661088628,8893,8449,9070,177,1.99,8616,-277,-3.11,8449,9070,1399-9-18
482,ضخود1044,اختيارخ خودرو-4000-1399/10/07,515,20718,9540915000,473,475,451,-22,-4.65,461,-12,-2.54,410,495,1399-9-18
483,سكه0012پ01,سكه تمام بهارتحويلي 1روزه رفاه,514,128100,157825552700,1202871,1223001,1235100,32229,2.68,1232050,29179,2.43,1223001,1248400,1399-9-18
484,قجام,فرآوردههاي غذايي وقندتربت‌جام‌,509,4110857,49085209821,11600,11948,11948,348,3.0,11940,340,2.93,11684,11948,1399-9-18
485,اوان,مبين وان كيش,509,941545,60639993345,64880,66000,63650,-1230,-1.9,64405,-475,-0.73,63250,66940,1399-9-18
486,پارتا,مجتمع‌صنعتي‌آرتاويل‌تاير,507,604502,34070427455,57337,57428,56700,-637,-1.11,56361,-976,-1.7,55617,57910,1399-9-18
487,وسكرمان,س.سهام عدالت استان كرمان,505,13271304,13952949310,1010,1060,1060,50,4.95,1020,10,0.99,1030,1060,1399-9-18
488,نيرو,نيرو سرمايه,499,877288,42939586255,47915,46478,49352,1437,3.0,48946,1031,2.15,46478,49352,1399-9-18
489,قهكمت,قندهكمتان‌,490,429405,22541550220,52950,50500,51400,-1550,-2.93,52750,-200,-0.38,50500,54690,1399-9-18
490,سپاس,صندوق س. پاداش سهامداري توسعه1,481,15681451,156915162136,10004,10017,10000,-4,-0.04,10006,2,0.02,10000,10021,1399-9-18
491,شجم,صنايع پتروشيمي تخت جمشيد,476,23975753,234315034069,9489,9773,9773,284,2.99,9773,284,2.99,9773,9773,1399-9-18
492,اتكام,شركت بيمه اتكايي امين,474,8764480,66039892570,7177,7535,7535,358,4.99,7535,358,4.99,7321,7535,1399-9-18
493,ثاباد,توريستي ورفاهي آبادگران ايران,473,873726,29818750900,32560,34000,34180,1620,4.98,33400,840,2.58,33200,34180,1399-9-18
494,دارو,كارخانجات‌داروپخش‌,473,334345,19299324870,57660,55550,58050,390,0.68,57680,20,0.03,55550,59000,1399-9-18
495,ديران,ايران‌دارو,470,1955264,57132814080,27830,29220,29220,1390,4.99,29220,1390,4.99,29220,29220,1399-9-18
496,ضملت1128,اختيارخ وبملت-6000-1399/11/28,469,13796,9917225000,736,652,685,-51,-6.93,719,-17,-2.31,652,798,1399-9-18
497,سكرما,سيمان‌ كرمان‌,469,3197401,51616611040,15590,15200,16360,770,4.94,16120,530,3.4,15200,16360,1399-9-18
498,خرينگ,رينگ‌سازي‌مشهد,468,434845,27512643150,66600,63270,63270,-3330,-5.0,64820,-1780,-2.67,63270,63270,1399-9-18
499,وتعاون,بيمه  تعاون,463,4629495,34313506753,7211,7427,7427,216,3.0,7412,201,2.79,7200,7427,1399-9-18
500,آتيمس,صندوق س.آرمان آتيه درخشان مس-س,459,113778,25865829978,229583,227050,227998,-1585,-0.69,227336,-2247,-0.98,221007,229200,1399-9-18
501,كي بي سي,شركت كي بي سي,456,658116,21783964314,33695,32099,32280,-1415,-4.2,33451,-244,-0.72,32099,34102,1399-9-18
502,كوثر,بيمه كوثر,453,2938024,59424473424,19263,20226,20226,963,5.0,20226,963,5.0,20226,20226,1399-9-18
503,حخزر,كشتيراني درياي خزر,450,1041838,25868715753,25696,24450,24600,-1096,-4.27,25209,-487,-1.9,24430,25599,1399-9-18
504,سكه9912پ04,سكه تمام بهارتحويل1روزه صادرات,435,179000,220450978500,1200722,1225000,1234000,33278,2.77,1231570,30848,2.57,1225000,1245000,1399-9-18
505,زماهان,مجتمع توليد گوشت مرغ ماهان,433,1124641,31940730428,27049,28401,28401,1352,5.0,27827,778,2.88,28041,28401,1399-9-18
506,ولراز,ليزينگ رازي,433,651466,26015136791,38979,40148,40148,1169,3.0,39933,954,2.45,39400,40148,1399-9-18
507,سيستم,همكاران سيستم,419,642504,20682828610,33190,31650,31990,-1200,-3.62,32760,-430,-1.3,31650,33430,1399-9-18
508,دبالك,مواد اوليه دارويي البرز بالك,410,1061466,21859830804,19614,20594,20594,980,5.0,19985,371,1.89,20594,20594,1399-9-18
509,ياقوت,صندوق س ياقوت آگاه-ثابت,406,13591582,156995077480,11531,11535,11554,23,0.2,11551,20,0.17,11534,11554,1399-9-18
510,افق ملت,صندوق س در سهام افق ملت,402,106952,15803618600,149030,148600,147800,-1230,-0.83,147760,-1270,-0.85,143000,150000,1399-9-18
511,ثنظام,س. ساختماني نظام مهندسي ايران,400,453680,20014797490,42843,44128,44128,1285,3.0,44015,1172,2.74,43800,44128,1399-9-18
512,قشهد,شهد,397,696082,20630512500,31100,29590,29800,-1300,-4.18,30490,-610,-1.96,29550,31400,1399-9-18
513,دلر,داروسازي‌ اكسير,395,230211,27117713000,119900,121000,117000,-2900,-2.42,118820,-1080,-0.9,116000,121000,1399-9-18
514,حتوكا,حمل‌ونقل‌توكا,382,892543,19823380030,21160,22210,22210,1050,4.96,21510,350,1.65,22210,22210,1399-9-18
515,وزمين,بانك ايران زمين,377,5252872,67244288259,12561,12400,12812,251,2.0,12801,240,1.91,12400,12812,1399-9-18
516,غمهراح,ح . توليدي‌مهرام‌,373,256077,13223228620,51480,50250,53000,1520,2.95,51640,160,0.31,47510,53700,1399-9-18
517,بالبر,كابل‌ البرز,368,1232308,31667188440,24730,25890,25960,1230,4.97,25300,570,2.3,24730,25960,1399-9-18
518,فالوم,آلومتك‌,365,1253437,28022730475,21736,21601,22388,652,3.0,22357,621,2.86,21601,22388,1399-9-18
519,ساينا,صنايع بهداشتي ساينا,363,53105,10778048428,198494,206000,204850,6356,3.2,199386,892,0.45,199000,206000,1399-9-18
520,ضصاد1104,اختيارخ وبصادر-4500-1399/11/12,352,13923,3921545000,263,270,295,32,12.17,282,19,7.22,260,300,1399-9-18
521,خلنت,لنت‌ ترمزايران‌,350,152913,12716107710,81440,78160,80810,-630,-0.77,81850,410,0.5,78160,85510,1399-9-18
522,سهرمز,سيمان‌هرمزگان‌,339,1749142,36341678540,19880,19020,20870,990,4.98,20480,600,3.02,19020,20870,1399-9-18
523,بمپنا,توليد برق عسلويه  مپنا,337,97595,9803469993,100015,96015,96353,-3662,-3.66,100096,81,0.08,96015,103980,1399-9-18
524,غبهار,كشت وصنعت بهاران گلبهار خراسان,336,1316936,57593562088,42460,43733,43733,1273,3.0,43733,1273,3.0,43733,43733,1399-9-18
525,دقاضي,داروسازي شهيد قاضي,328,181432,17108609477,93373,95000,92310,-1063,-1.14,94112,739,0.79,90600,96174,1399-9-18
526,آكورد,صندوق س. آرمان آتي كوثر-د,321,9475705,280769050785,29616,29630,29620,4,0.01,29630,14,0.05,29620,29635,1399-9-18
527,كگاز,شيشه‌ و گاز,320,923491,23012788070,25040,25000,24620,-420,-1.68,24980,-60,-0.24,24600,25000,1399-9-18
528,سيمرغ,سيمرغ,316,1373810,26171080500,18150,19050,19050,900,4.96,18580,430,2.37,19050,19050,1399-9-18
529,فسپا,گروه‌صنعتي‌سپاهان‌,313,1373112,72582700320,50350,52860,52860,2510,4.99,52860,2510,4.99,52860,52860,1399-9-18
530,گكيش,توريستي ورفاهي آبادگران كيش,309,525697,35541005363,64392,67611,67611,3219,5.0,67607,3215,4.99,66323,67611,1399-9-18
531,وساغربي,شركت س استان آذربايجان غربي,307,12452287,10358438060,870,830,830,-40,-4.6,860,-10,-1.15,830,850,1399-9-18
532,بسويچ,پارس‌سويچ‌,306,335079,15473948220,43990,46180,46180,2190,4.98,44630,640,1.45,46180,46180,1399-9-18
533,تسه9907,امتياز تسهيلات مسكن مهر99,303,4457,2685181423,613062,590111,606000,-7062,-1.15,602464,-10598,-1.73,590111,610000,1399-9-18
534,سقاين,سيمان‌ قائن‌,301,293636,14601553970,47400,49770,49770,2370,5.0,48000,600,1.27,48050,49770,1399-9-18
535,زعف0008پ10,زعفران0008نگين طلاي سرخ(پ),300,188876,23863548900,126974,126010,127000,26,0.02,126345,-629,-0.5,124000,127500,1399-9-18
536,وپخش,داروپخش‌ (هلدينگ‌,300,71508,10355704070,145630,145480,144460,-1170,-0.8,145470,-160,-0.11,138410,147990,1399-9-18
537,ثشرقح,ح. سرمايه گذاري مسكن شمال شرق,298,3000000,16350000000,4950,5450,5450,500,10.1,5450,500,10.1,5450,5450,1399-9-18
538,دفرا,فرآورده‌هاي‌ تزريقي‌ ايران‌,291,349746,9301484020,26840,27970,27340,500,1.86,26790,-50,-0.19,25700,27970,1399-9-18
539,فنرژي,گسترش صنايع انرژي آذرآب,291,1583002,16099602049,9975,10174,10174,199,1.99,10170,195,1.95,10001,10174,1399-9-18
540,غپونه,نوش پونه مشهد,290,1133160,21814315100,18375,18650,19293,918,5.0,19211,836,4.55,18650,19293,1399-9-18
541,دارا,صندوق س. دارا الگوريتم-د,287,9536529,95887211582,10057,10061,10050,-7,-0.07,10055,-2,-0.02,10050,10065,1399-9-18
542,كفرا,فراورده‌ هاي‌ نسوزايران‌,285,319985,19090305100,56820,59660,59660,2840,5.0,57770,950,1.67,59660,59660,1399-9-18
543,گشان,توسعه بين المللي پديده شانديز,281,148536,10639930752,73093,71632,71632,-1461,-2.0,72728,-365,-0.5,71632,71632,1399-9-18
544,سصوفي,سيمان‌ صوفيان‌,276,693369,11773405620,16180,16980,16980,800,4.94,16350,170,1.05,16980,16980,1399-9-18
545,وحافظ,بيمه حافظ,273,440500,29244795000,64457,66390,66390,1933,3.0,66390,1933,3.0,66390,66390,1399-9-18
546,وملل,اعتباري ملل,268,8113139,130053618170,15323,16030,16030,707,4.61,16030,707,4.61,16030,16030,1399-9-18
547,دروز,داروسازي‌ روزدارو,261,438246,7704614610,17900,17010,17890,-10,-0.06,17850,-50,-0.28,17010,18000,1399-9-18
548,پدرخش,درخشان‌ تهران‌,257,58129,11279351160,215590,194040,194040,-21550,-10.0,210140,-5450,-2.53,194040,194040,1399-9-18
549,گپارس,امور رفاهي كارگزاران پارس,250,318422,42761139150,132236,134000,136203,3967,3.0,134291,2055,1.55,129610,136203,1399-9-18
550,سخاش,سيمان‌خاش‌,246,98472,9826520880,95040,99790,99790,4750,5.0,95880,840,0.88,99790,99790,1399-9-18
551,سدبير,س. تدبيرگران فارس وخوزستان,236,844455,37914987045,42761,44899,44899,2138,5.0,44207,1446,3.38,44890,44899,1399-9-18
552,شپترو,پتروشيمي آبادان,233,2324221,11972062371,5001,5151,5151,150,3.0,5083,82,1.64,5151,5151,1399-9-18
553,فنفت,صنايع تجهيزات نفت,226,829419,12040279449,14849,14405,14500,-349,-2.35,14653,-196,-1.32,14404,14800,1399-9-18
554,وكار,بانك‌ كارآفرين‌,226,9864811,48238925790,4660,4890,4890,230,4.94,4850,190,4.08,4890,4890,1399-9-18
555,وسهمدا,شركت س استان همدان,226,5739227,5115108760,900,860,880,-20,-2.22,900,0,0.0,860,940,1399-9-18
556,ولتجار,واسپاري تجارت وسرمايه ايرانيان,226,1504795,10845606544,6999,7208,7208,209,2.99,7099,100,1.43,7053,7208,1399-9-18
557,سبجنو,سيمان‌ بجنورد,216,395587,14933409250,35960,37750,37750,1790,4.98,36450,490,1.36,37750,37750,1399-9-18
558,سكه0112پ03,سكه تمام بهارتحويلي1روزه سامان,215,71100,87631622600,1198852,1225001,1234000,35148,2.93,1232512,33660,2.81,1225001,1246650,1399-9-18
559,ضصاد1102,اختيارخ وبصادر-3500-1399/11/12,215,7226,5575898000,690,780,800,110,15.94,772,82,11.88,680,850,1399-9-18
560,كيسون,شركت كيسون,214,2077390,33192537420,15513,15978,15978,465,3.0,15978,465,3.0,15978,15978,1399-9-18
561,حپترو,حمل و نقل پتروشيمي( سهامي عام,212,479457,14230283760,28270,29680,29680,1410,4.99,28630,360,1.27,29680,29680,1399-9-18
562,سلار,شركت سيمان لارستان,201,1686301,63516177375,36569,37666,37666,1097,3.0,37666,1097,3.0,37610,37666,1399-9-18
563,ولانا,شركت ليزينگ آريا دانا,200,989909,18829116705,18470,18250,19024,554,3.0,18995,525,2.84,18250,19024,1399-9-18
564,زعف0008پ11,زعفران0008نگين سحرخيز(پ),199,137741,17258683391,124771,125000,125501,730,0.59,125298,527,0.42,123202,126000,1399-9-18
565,تشتاد,صنايع توليدي اشتاد ايران‌,198,312142,5070394774,16358,16000,16110,-248,-1.52,16330,-28,-0.17,16000,16740,1399-9-18
566,لبوتان,گروه‌صنعتي‌بوتان‌,197,131640,11132794800,80550,84570,84570,4020,4.99,81310,760,0.94,84570,84570,1399-9-18
567,حاريا,كشتيراني آريا,196,734827,20679501434,27323,28142,28142,819,3.0,28142,819,3.0,28142,28142,1399-9-18
568,وسرمد,بيمه  سرمد,194,2604243,18828676890,7020,7230,7230,210,2.99,7201,181,2.58,7230,7230,1399-9-18
569,نمرينو,ايران‌ مرينوس‌,193,132949,7024420270,55550,53000,52780,-2770,-4.99,55140,-410,-0.74,52780,55000,1399-9-18
570,ضخود1042,اختيارخ خودرو-3000-1399/10/07,189,6392,7416937000,1174,1190,1200,26,2.21,1160,-14,-1.19,1063,1250,1399-9-18
571,ضجار1016,اختيارخ وتجارت-4000-1399/10/21,189,7063,3295162000,462,465,458,-4,-0.87,467,5,1.08,440,488,1399-9-18
572,واحصا,احياء صنايع خراسان,186,654750,18397820250,27281,28099,28099,818,3.0,27957,676,2.48,28099,28099,1399-9-18
573,تسه9902,امتياز تسهيلات مسكن ارديبهشت99,183,2220,1340868454,609981,585000,610000,19,0.0,603995,-5986,-0.98,580222,640480,1399-9-18
574,شپارس,بين‌ المللي‌ محصولات‌  پارس‌,181,706470,11720337300,15800,16590,16590,790,5.0,15960,160,1.01,16590,16590,1399-9-18
575,تسه9810,امتياز تسهيلات مسكن دي98,179,3120,1858736927,601506,580445,600000,-1506,-0.25,595749,-5757,-0.96,580445,609969,1399-9-18
576,وسگيلا,شركت س استان گيلان,177,5594417,4739496900,880,850,850,-30,-3.41,880,0,0.0,840,870,1399-9-18
577,تسه9711,امتياز تسهيلات مسكن بهمن 97,176,2546,1513071636,621864,590771,594210,-27654,-4.45,594294,-27570,-4.43,590771,610000,1399-9-18
578,فاهواز,نورد و لوله اهواز,174,744953,13906782604,19445,18668,18668,-777,-4.0,19189,-256,-1.32,18668,18668,1399-9-18
579,غشوكوح,ح . شوكو پارس,174,942746,27264787710,29363,31124,28000,-1363,-4.64,28921,-442,-1.51,28000,31124,1399-9-18
580,تسه9710,امتياز تسهيلات مسكن دي 97,174,3971,2311210448,605038,574787,577303,-27735,-4.58,582022,-23016,-3.8,574787,600000,1399-9-18
581,وتوكا,سرمايه‌گذاري‌توكافولاد(هلدينگ,172,1497058,18114401800,11530,12100,12100,570,4.94,11720,190,1.65,12100,12100,1399-9-18
582,تسه9904,امتياز تسهيلات مسكن تير99,169,2372,1438270229,602358,582328,572241,-30117,-5.0,606353,3995,0.66,572241,632475,1399-9-18
583,دكپسول,توليد ژلاتين كپسول ايران,168,195056,8469331520,41353,43420,43420,2067,5.0,41661,308,0.74,43420,43420,1399-9-18
584,وسفارس,شركت س استان فارس,167,4556611,4466603430,1030,980,980,-50,-4.85,1030,0,0.0,980,990,1399-9-18
585,ضملي1152,اختيارخ فملي-18252-1399/11/05,166,2564,4830526404,1128,940,989,-139,-12.32,955,-173,-15.34,813,1179,1399-9-18
586,وسيستا,شركت س استان سيستان وبلوچستان,166,7394432,6155766110,870,830,830,-40,-4.6,870,0,0.0,830,860,1399-9-18
587,تسه9906,امتياز تسهيلات مسكن شهريور99,163,2008,1250091107,628606,600000,597176,-31430,-5.0,622555,-6051,-0.96,597176,660036,1399-9-18
588,دشيري,شيرين دارو,162,38696,6167435032,158698,153939,161000,2302,1.45,158908,210,0.13,153938,161999,1399-9-18
589,معيار,سرمايه گذاري معيار صنعت پارس,161,306295,8692998385,27829,28330,28385,556,2.0,28311,482,1.73,28320,28385,1399-9-18
590,شپاس,نفت پاسارگاد,159,255274,6005320850,22405,23525,23525,1120,5.0,22522,117,0.52,23525,23525,1399-9-18
591,سفارود,كارخانه فارسيت درود,157,862482,9083660424,10127,10532,10532,405,4.0,10461,334,3.3,10532,10532,1399-9-18
592,درهآور,دارويي ره آورد تامين,156,132896,5747486208,41189,43248,43248,2059,5.0,41404,215,0.52,43248,43248,1399-9-18
593,داوه,داروسازي آوه سينا,152,471233,8364385750,16905,17750,17750,845,5.0,17037,132,0.78,17750,17750,1399-9-18
594,آبين,كشت و صنعت آبشيرين,152,1707985,7665436680,4358,4488,4488,130,2.98,4403,45,1.03,4488,4488,1399-9-18
595,تسه9712,امتياز تسهيلات مسكن اسفند97,150,1667,1005913869,634872,603129,603129,-31743,-5.0,603428,-31444,-4.95,603129,630129,1399-9-18
596,قپيرا,فرآورده‌هاي‌غدايي‌وقندپيرانشهر,148,52256,4703679000,89260,88000,89990,730,0.82,89330,70,0.08,87050,91000,1399-9-18
597,ثاصفا,شركت‌ ساختمان‌ اصفهان‌,148,771949,28037959629,37444,36321,36321,-1123,-3.0,36321,-1123,-3.0,36321,36321,1399-9-18
598,اخزا821,اسنادخزانه-م21بودجه98-020906,144,2566,1463985032,572619,570001,571100,-1519,-0.27,570532,-2087,-0.36,568179,572619,1399-9-18
599,ضخود1045,اختيارخ خودرو-4500-1399/10/07,144,7144,1828243000,277,231,250,-27,-9.75,256,-21,-7.58,225,277,1399-9-18
600,الماس,صندوق س.امين تدبيرگران فردا-س,143,49019,6493184733,131532,131899,133905,2373,1.8,132463,931,0.71,128859,133905,1399-9-18
601,جهرم,پتروشيمي جهرم,142,1268031,3804093000,3092,3000,3000,-92,-2.98,3074,-18,-0.58,3000,3000,1399-9-18
602,دمعيار,صندوق س. توازن معيار-د,141,7907943,79785400417,10088,10095,10091,3,0.03,10089,1,0.01,10085,10095,1399-9-18
603,كقزوي,شيشه‌ قزوين‌,141,1044537,9145965972,8501,8756,8756,255,3.0,8608,107,1.26,8756,8756,1399-9-18
604,وجامي,سرمايه گذاري جامي,140,539643,5543212896,9973,10272,10272,299,3.0,10048,75,0.75,10272,10272,1399-9-18
605,فسا,پتروشيمي فسا,139,1288949,3536876056,2828,2744,2744,-84,-2.97,2812,-16,-0.57,2744,2744,1399-9-18
606,ختراك,ريخته‌گري‌ تراكتورسازي‌ ايران‌,139,1252510,15393347900,11710,12290,12290,580,4.95,11870,160,1.37,12290,12290,1399-9-18
607,شسينا,صنايع‌شيميايي‌سينا,135,73593,10464188670,135420,142190,142190,6770,5.0,136740,1320,0.97,142190,142190,1399-9-18
608,اعتلا,شركت سرمايه گذاري اعتلاء البرز,133,2230501,22554826112,9631,10112,10112,481,4.99,9826,195,2.02,10112,10112,1399-9-18
609,آساميد,صندوق س.مشترك آسمان اميد -د,129,5009184,55923394575,11161,11161,11168,7,0.06,11164,3,0.03,11159,11170,1399-9-18
610,كگهر,سنگ آهن گهرزمين,128,521417,24454978717,44668,46901,46901,2233,5.0,45083,415,0.93,46901,46901,1399-9-18
611,ساذريح,ح . آذريت‌,124,910874,4747780106,5230,5200,5180,-50,-0.96,5212,-18,-0.34,5080,5350,1399-9-18
612,داراب,پتروشيمي داراب,122,963926,2810808216,3006,2916,2916,-90,-2.99,2992,-14,-0.47,2916,2916,1399-9-18
613,سمتاز,سيمان ممتازان كرمان,122,834113,19489049245,22685,23365,23365,680,3.0,23284,599,2.64,23364,23365,1399-9-18
614,كخاك,صنايع‌خاك‌چيني‌ايران‌,119,791664,42369857280,50980,53520,53520,2540,4.98,52810,1830,3.59,53520,53520,1399-9-18
615,سپر,صندوق س سپر سرمايه بيدار- ثابت,117,824134,9081165865,11016,11020,11050,34,0.31,11019,3,0.03,10931,11050,1399-9-18
616,شكف,كف,117,83888,5829532302,68196,69559,69559,1363,2.0,68896,700,1.03,68235,69559,1399-9-18
617,وثخوز,سرمايه گذاري و توسعه خوزستان,116,509705,24120260010,45069,47322,47322,2253,5.0,47322,2253,5.0,47322,47322,1399-9-18
618,سكه0011پ02,سكه تمام بهارتحويلي 1روزه ملت,112,37600,46189110600,1202770,1220000,1240000,37230,3.1,1228434,25664,2.13,1220000,1244870,1399-9-18
619,صنوين,صندوق سرمايه‌گذاري صنوين-مختلط,111,70020,7287341100,103900,104500,104000,100,0.1,104080,180,0.17,103500,105000,1399-9-18
620,فيروزا,صندوق بادرآمد ثابت فيروزه آسيا,110,916837,19740495587,21593,21620,21551,-42,-0.19,21531,-62,-0.29,21410,21620,1399-9-18
621,تسه9801,امتياز تسهيلات مسكن فروردين98,109,1016,611443043,610515,610020,605100,-5415,-0.89,601814,-8701,-1.43,582110,618998,1399-9-18
622,آرمان,بيمه آرمان,108,1748740,19454732500,10801,11125,11125,324,3.0,11079,278,2.57,11125,11125,1399-9-18
623,صايند,صندوق س. گنجينه آينده روشن-د,105,1827950,18277725570,9997,10010,9997,0,0.0,9999,2,0.02,9987,10010,1399-9-18
624,ضسپا1104,اختيارخ خساپا-3000-1399/11/26,104,3844,2717247000,712,750,679,-33,-4.63,707,-5,-0.7,643,770,1399-9-18
625,تسه9905,امتياز تسهيلات مسكن مرداد99,103,674,404731727,619761,590320,600000,-19761,-3.19,600492,-19269,-3.11,590305,610000,1399-9-18
626,تصميم,صندوق س با درآمد ثابت تصميم,103,912538,13808657458,15102,15119,15128,26,0.17,15132,30,0.2,15100,15150,1399-9-18
627,ضپاس1005,اختيارخ وپارس-4500-1399/10/30,102,5098,2483334000,515,539,480,-35,-6.8,487,-28,-5.44,450,539,1399-9-18
628,تسه9903,امتياز تسهيلات مسكن خرداد99,101,666,403031258,605809,590001,605000,-809,-0.13,605152,-657,-0.11,590001,630000,1399-9-18
629,وسرضوي,س.سهام عدالت استان خراسان رضوي,100,2130267,2087661660,1030,980,980,-50,-4.85,1030,0,0.0,980,980,1399-9-18
630,شرنگي,شيميايي رنگين,97,52903,6731324817,121180,127239,127239,6059,5.0,123023,1843,1.52,127239,127239,1399-9-18
631,زعف0008پ05,زعفران0008نگين زرين(پ),97,91343,11403232173,124886,125500,125997,1111,0.89,124840,-46,-0.04,123301,126000,1399-9-18
632,ارمغان,ص سرمايه گذاري ارمغان ايرانيان,96,766044,7681538736,10021,10048,10018,-3,-0.03,10028,7,0.07,10010,10048,1399-9-18
633,سنوين,سرمايه گذاري اقتصاد نوين,94,501121,5061536507,10090,10189,9893,-197,-1.95,10095,5,0.05,9892,10195,1399-9-18
634,اخزا815,اسنادخزانه-م15بودجه98-010406,93,110390,83720697653,758206,753110,758450,244,0.03,758408,202,0.03,753110,758800,1399-9-18
635,خفولا,خدمات فني فولاد يزد,92,137784,5093736696,35893,36969,36969,1076,3.0,36151,258,0.72,36969,36969,1399-9-18
636,بذر,صندوق س بذر اميد آفرين-سهام,91,24735,2854379250,115350,115350,115600,250,0.22,115400,50,0.04,113500,116500,1399-9-18
637,تسه9803,امتياز تسهيلات مسكن خرداد98,88,569,338644940,594830,567255,594000,-830,-0.14,595158,328,0.06,567255,605000,1399-9-18
638,ضخود1043,اختيارخ خودرو-3500-1399/10/07,87,3191,2518799000,798,769,782,-16,-2.01,789,-9,-1.13,700,859,1399-9-18
639,فلات,گروه صنايع معادن فلات ايرانيان,86,965255,15619756410,15711,16182,16182,471,3.0,16068,357,2.27,16182,16182,1399-9-18
640,ثتوسا,س.توسعه و عمران استان اردبيل,84,252586,14629781120,59711,57920,57920,-1791,-3.0,58266,-1445,-2.42,57920,57920,1399-9-18
641,ضشنا1036,اختيارخ شپنا-16000-1399/10/23,84,520,1883617000,4008,4500,3250,-758,-18.91,3622,-386,-9.63,3250,4500,1399-9-18
642,وسقم,شركت س استان قم,82,940539,1260322260,1410,1340,1340,-70,-4.96,1410,0,0.0,1340,1340,1399-9-18
643,وآتوس,س.آرين توسكا قيمت اسمي 350ريال,81,400200,13112152800,33777,32764,32764,-1013,-3.0,33065,-712,-2.11,32764,32764,1399-9-18
644,ضملي1153,اختيارخ فملي-20280-1399/11/05,80,1304,1220535876,540,450,413,-127,-23.52,475,-65,-12.04,413,529,1399-9-18
645,شتولي,تولي‌پرس‌,80,142313,3800753291,26184,26707,26707,523,2.0,26367,183,0.7,26707,26707,1399-9-18
646,بموتو,موتوژن‌,79,129296,6255340480,46080,48380,48380,2300,4.99,46350,270,0.59,48380,48380,1399-9-18
647,سدشت,صنايع سيمان دشتستان,79,65234,2421478870,38130,37020,37420,-710,-1.86,38080,-50,-0.13,36970,37800,1399-9-18
648,تسه9802,امتياز تسهيلات مسكن ارديبهشت98,78,483,290384972,595444,625216,620000,24556,4.12,601211,5767,0.97,584500,625216,1399-9-18
649,افران,صندوق س افرا نماد پايدار-ثابت,76,467523,5731031768,12258,12255,12270,12,0.1,12258,0,0.0,12255,12270,1399-9-18
650,شكبير,پتروشيمي اميركبير,76,1406623,84267970684,58164,59908,59908,1744,3.0,59868,1704,2.93,59908,59908,1399-9-18
651,زعف0008پ08,زعفران0008نگين روستا(پ),75,28975,3607572793,124118,124003,125003,885,0.71,124506,388,0.31,122000,125499,1399-9-18
652,تملتح,ح . تامين سرمايه بانك ملت,75,526910,4215280000,8000,8000,8000,0,0.0,8000,0,0.0,8000,8000,1399-9-18
653,ضجار1014,اختيارخ وتجارت-3000-1399/10/21,73,1466,1617544000,1102,1061,1065,-37,-3.36,1103,1,0.09,1042,1171,1399-9-18
654,ضجار1015,اختيارخ وتجارت-3500-1399/10/21,70,2164,1631960000,751,780,722,-29,-3.86,754,3,0.4,680,798,1399-9-18
655,تسه9812,امتياز تسهيلات مسكن اسفند98,70,692,412120025,599711,600000,590000,-9711,-1.62,595549,-4162,-0.69,569726,625000,1399-9-18
656,كتوكا,توليدي و خدمات صنايع نسوز توكا,70,100801,2356928982,22269,23382,23382,1113,5.0,22318,49,0.22,23382,23382,1399-9-18
657,اخزا814,اسنادخزانه-م14بودجه98-010318,70,141005,109013409456,780699,765700,765702,-14997,-1.92,773117,-7582,-0.97,765700,789001,1399-9-18
658,ضفلا1156,اختيارخ فولاد-16000-1399/11/28,69,1725,2741033000,1541,1232,1610,69,4.48,1589,48,3.11,1232,1750,1399-9-18
659,هترول911,اختيارف ت پترول-14730-99/11/15,69,500000,367000000,356,734,734,378,106.18,734,378,106.18,734,734,1399-9-18
660,ثروت,ص.خ.ثروت آفرين فيروزه 35%تاديه,68,161630,56570500000,1000000,350000,350000,-650000,-65.0,350000,-650000,-65.0,350000,350000,1399-9-18
661,فسديد,لوله‌وتجهيزات‌ سديد - ورشكسته,65,60695,6676753475,108916,110005,110005,1089,1.0,110005,1089,1.0,110005,110005,1399-9-18
662,فبيرا,بسته‌ بندي‌ ايران‌,64,478166,2327233922,5017,4867,4867,-150,-2.99,4999,-18,-0.36,4867,4867,1399-9-18
663,غشوكو,شوكو پارس,63,72007,2977561457,43527,41351,41351,-2176,-5.0,43185,-342,-0.79,41351,41351,1399-9-18
664,ضپنا1022,اختيارخ رمپنا-18806-1399/10/09,63,443,2156897299,3324,3300,3000,-324,-9.75,3288,-36,-1.08,3000,3500,1399-9-18
665,تسه9808,امتياز تسهيلات مسكن آبان98,63,738,439335774,600827,570786,591007,-9820,-1.63,595306,-5521,-0.92,570786,609000,1399-9-18
666,ضمخا7070,اختيارخ اخابر-20000-1400/07/28,62,579,2491482000,4292,4800,4000,-292,-6.8,4303,11,0.26,3860,4800,1399-9-18
667,ثروتم,صندوق س. ثروت آفرين پارسيان-س,61,20030,1975572090,99439,99710,98510,-929,-0.93,98631,-808,-0.81,98000,100000,1399-9-18
668,ضصاد1101,اختيارخ وبصادر-3000-1399/11/12,60,1241,1339390000,1004,1198,1100,96,9.56,1079,75,7.47,1000,1198,1399-9-18
669,تسه9811,امتياز تسهيلات مسكن بهمن98,60,513,308003285,600516,572661,588000,-12516,-2.08,600396,-120,-0.02,572661,610000,1399-9-18
670,ضملي1148,اختيارخ فملي-10140-1399/11/05,59,280,3618194048,9169,6600,6400,-2769,-30.2,6553,-2616,-28.53,6000,6999,1399-9-18
671,جوين,كشت و صنعت جوين,57,260951,6275088697,23347,24047,24047,700,3.0,23554,207,0.89,24047,24047,1399-9-18
672,آسام,صندوق س.آرمان سپهر آشنا-م,57,38270,4162994550,108640,105100,109800,1160,1.07,108780,140,0.13,105100,110000,1399-9-18
673,تسه9809,امتياز تسهيلات مسكن آذر98,56,530,315255629,596928,567085,600000,3072,0.51,594822,-2106,-0.35,567085,605000,1399-9-18
674,شزنگ,تجهيزنيروي‌زنگان‌,56,47391,8663406537,177483,182807,182807,5324,3.0,179607,2124,1.2,182807,182807,1399-9-18
675,اخزا903,اسنادخزانه-م3بودجه99-011110,56,175851,117352222397,667621,662376,669999,2378,0.36,667339,-282,-0.04,662376,670000,1399-9-18
676,تكنار,مجتمع معادن مس تكنار,55,203302,23550097076,112465,115838,115838,3373,3.0,115838,3373,3.0,115838,115838,1399-9-18
677,كيان2,صندوق س. با درآمد ثابت كيان,55,5500000,5500000,26217,1,1,-26216,-100.0,1,-26216,-100.0,1,1,1399-9-18
678,پست0008پ08,پسته فندقي32-30مه ولات0008(پ),55,1837,3326217856,1759014,1850578,1869998,110984,6.31,1810679,51665,2.94,1710001,1869999,1399-9-18
679,اخزا902,اسنادخزانه-م2بودجه99-011019,54,111280,75137667794,675682,674168,675000,-682,-0.1,675213,-469,-0.07,674168,676500,1399-9-18
680,ضصاد1105,اختيارخ وبصادر-5000-1399/11/12,53,2724,546798000,197,220,200,3,1.52,201,4,2.03,153,220,1399-9-18
681,تسه9807,امتياز تسهيلات مسكن مهر98,51,243,143900518,602640,572508,602640,0,0.0,592183,-10457,-1.74,572508,602640,1399-9-18
682,ضسپا1106,اختيارخ خساپا-4000-1399/11/26,48,1372,470282000,318,470,350,32,10.06,343,25,7.86,300,470,1399-9-18
683,اخزا808,اسنادخزانه-م8بودجه98-000817,47,17053,14713898156,863099,859000,859501,-3598,-0.42,862833,-266,-0.03,857541,865000,1399-9-18
684,فوكا,فولاد كاويان,46,840744,16356674520,20056,19455,19455,-601,-3.0,19845,-211,-1.05,19455,19455,1399-9-18
685,كصدف,كاشي صدف سرام استقلال آباده,45,534829,11560863664,20987,21616,21616,629,3.0,21329,342,1.63,21616,21616,1399-9-18
686,تسه9806,امتياز تسهيلات مسكن شهريور98,43,452,274239820,598284,600000,587200,-11084,-1.85,606725,8441,1.41,568370,615000,1399-9-18
687,سخند,صندوق س.سپهرخبرگان نفت-د,43,320790,3208267040,10003,10024,10001,-2,-0.02,10001,-2,-0.02,10000,10024,1399-9-18
688,سايرا,ايرانيت‌,42,103126,3577828160,35245,34542,34541,-704,-2.0,35043,-202,-0.57,34541,35949,1399-9-18
689,ضترا1118,اختيارخ شتران-12000-1399/11/14,42,422,1427175000,3655,3301,3390,-265,-7.25,3382,-273,-7.47,3300,3600,1399-9-18
690,هبركت912,اختيارف ت بركت-22100-99/12/17,42,360000,94320000,1129,262,262,-867,-76.79,262,-867,-76.79,262,262,1399-9-18
691,ضخود1048,اختيارخ خودرو-7000-1399/10/07,42,1976,16780000,13,10,7,-6,-46.15,8,-5,-38.46,7,10,1399-9-18
692,آكورد2,صندوق س. آرمان آتي كوثر-د,40,4000000,4000000,29616,1,1,-29615,-100.0,1,-29615,-100.0,1,1,1399-9-18
693,وآفري,بيمه كارآفرين,39,773607,13002786456,16008,16808,16808,800,5.0,16497,489,3.05,16808,16808,1399-9-18
694,شصفها,پتروشيمي‌ اصفهان‌,39,25344,2676681216,103544,105614,105614,2070,2.0,103981,437,0.42,105614,105614,1399-9-18
695,زعف0008پ16,زعفران0008نگين بيرجند(پ),38,46641,5802366880,126435,125000,125500,-935,-0.74,124405,-2030,-1.61,123001,125500,1399-9-18
696,اخزا809,اسنادخزانه-م9بودجه98-000923,38,34915,29561247645,845823,842001,845121,-702,-0.08,846663,840,0.1,842001,849000,1399-9-18
697,ضشنا1035,اختيارخ شپنا-14000-1399/10/23,38,174,911962000,5512,5000,4999,-513,-9.31,5241,-271,-4.92,4999,5750,1399-9-18
698,ضپيك1020,اختيارخ تاپيكو-14000-99/10/16,38,239,823694000,4052,3600,3300,-752,-18.56,3446,-606,-14.96,3300,3900,1399-9-18
699,زعف0008پ09,زعفران0008نگين نوين(پ),37,26150,3267896990,124837,123551,125500,663,0.53,124967,130,0.1,123551,126000,1399-9-18
700,اخزا810,اسنادخزانه-م10بودجه98-001006,37,9947,8341424616,839645,840000,837000,-2645,-0.32,838587,-1058,-0.13,837000,840433,1399-9-18
701,ضپاس1002,اختيارخ وپارس-3000-1399/10/30,36,584,829976000,1521,1430,1375,-146,-9.6,1421,-100,-6.57,1300,1689,1399-9-18
702,حرهشا,رهشاد سپاهان (سهامي عام,35,5763,335988663,61369,58301,58301,-3068,-5.0,61314,-55,-0.09,58301,58301,1399-9-18
703,ضپاس1006,اختيارخ وپارس-5000-1399/10/30,34,1100,330000000,390,300,300,-90,-23.08,300,-90,-23.08,300,300,1399-9-18
704,تسه9805,امتياز تسهيلات مسكن مرداد98,34,229,138749726,637783,605894,605894,-31889,-5.0,605894,-31889,-5.0,605894,605894,1399-9-18
705,ضفار1125,اختيارخ فارس-17826-1399/11/07,32,855,1123642000,784,620,590,-194,-24.74,657,-127,-16.2,590,760,1399-9-18
706,ضپاس1001,اختيارخ وپارس-2500-1399/10/30,31,139,247749000,2004,1666,1788,-216,-10.78,1782,-222,-11.08,1580,1999,1399-9-18
707,ضپاس1003,اختيارخ وپارس-3500-1399/10/30,31,488,497259000,1094,1100,982,-112,-10.24,1019,-75,-6.86,915,1120,1399-9-18
708,بكاب,صنايع‌جوشكاب‌يزد,31,5400,1679562000,296220,311030,311030,14810,5.0,296660,440,0.15,311030,311030,1399-9-18
709,تسه9901,امتياز تسهيلات مسكن فروردين99,30,101,61619488,642122,610016,610016,-32106,-5.0,610094,-32028,-4.99,610016,611000,1399-9-18
710,اخزا817,اسنادخزانه-م17بودجه98-010512,30,31841,23683226451,743819,742001,743825,6,0.0,743797,-22,0.0,742001,744003,1399-9-18
711,گوهر2,صندوق سكه طلاي كيان,30,300000,300000,60358,1,1,-60357,-100.0,1,-60357,-100.0,1,1,1399-9-18
712,اخزا818,اسنادخزانه-م18بودجه98-010614,29,34541,25304505482,729633,732700,732594,2961,0.41,732593,2960,0.41,732256,732999,1399-9-18
713,اخزا811,اسنادخزانه-م11بودجه98-001013,27,39429,33023819686,838202,826238,833700,-4502,-0.54,837552,-650,-0.08,826238,844985,1399-9-18
714,ضصاد1100,اختيارخ وبصادر-2500-1399/11/12,27,497,729529000,1413,1401,1500,87,6.16,1468,55,3.89,1400,1578,1399-9-18
715,وسخوز,شركت س استان خوزستان,26,374961,348713730,970,930,930,-40,-4.12,970,0,0.0,930,930,1399-9-18
716,اخزا820,اسنادخزانه-م20بودجه98-020806,25,106265,61740578878,580989,581000,582000,1011,0.17,581006,17,0.0,581000,582000,1399-9-18
717,ضملي1149,اختيارخ فملي-12168-1399/11/05,25,151,1350802252,5952,4000,4630,-1322,-22.21,4536,-1416,-23.79,4000,4750,1399-9-18
718,داريك,صندوق س.اعتماد داريك-د,25,820774,8404683544,10230,10240,10241,11,0.11,10240,10,0.1,10230,10249,1399-9-18
719,ضخود1047,اختيارخ خودرو-6000-1399/10/07,24,1200,36000000,30,30,30,0,0.0,30,0,0.0,30,30,1399-9-18
720,ساروج,بين المللي ساروج بوشهر,23,806476,16249684924,19563,20149,20149,586,3.0,19998,435,2.22,20149,20149,1399-9-18
721,ضفلا1155,اختيارخ فولاد-14000-1399/11/28,23,259,617319000,2358,2449,2400,42,1.78,2383,25,1.06,2300,2600,1399-9-18
722,اخزا904,اسنادخزانه-م4بودجه99-011215,22,15768,10332086071,654060,654949,656000,1940,0.3,655257,1197,0.18,654949,656000,1399-9-18
723,ضملت1130,اختيارخ وبملت-8000-1399/11/28,22,1785,267000000,163,150,150,-13,-7.98,150,-13,-7.98,120,150,1399-9-18
724,اخزا905,اسنادخزانه-م5بودجه99-020218,21,15187,9569845472,632000,632010,626000,-6000,-0.95,630134,-1866,-0.3,623002,633000,1399-9-18
725,ضغدر1119,اختيارخ وغدير-10000-1399/11/26,21,269,1205420000,4817,4300,4400,-417,-8.66,4481,-336,-6.98,4000,4800,1399-9-18
726,ضخود1046,اختيارخ خودرو-5000-1399/10/07,21,787,110255000,121,164,126,5,4.13,140,19,15.7,120,164,1399-9-18
727,پست0008پ04,پسته فندقي32-30سبزدانه0008(پ),20,2000,3711015600,1794205,1865000,1860000,65795,3.67,1855508,61303,3.42,1850000,1870578,1399-9-18
728,پست0008پ02,پسته فندقي32-30طلاسبززرند0008,20,303,557245000,1803342,1850000,1820000,16658,0.92,1839092,35750,1.98,1820000,1850000,1399-9-18
729,اوصتا,صندوق انديشه ورزان صباتامين -د,20,15221,263015149,17279,17285,17289,10,0.06,17280,1,0.01,17200,17290,1399-9-18
730,ضپاس1004,اختيارخ وپارس-4000-1399/10/30,19,352,231319000,734,622,640,-94,-12.81,657,-77,-10.49,622,810,1399-9-18
731,اخزا806,اسنادخزانه-م6بودجه98-000519,18,34663,31080880147,893255,896890,895015,1760,0.2,896659,3404,0.38,893715,897000,1399-9-18
732,ضفار1126,اختيارخ فارس-19826-1399/11/07,18,132,131828000,510,490,498,-12,-2.35,499,-11,-2.16,490,500,1399-9-18
733,ضملي1151,اختيارخ فملي-16224-1399/11/05,17,208,977703796,1697,2350,2450,753,44.37,2384,687,40.48,2000,2450,1399-9-18
734,ضخود1041,اختيارخ خودرو-2500-1399/10/07,17,1143,1923379000,1677,1601,1693,16,0.95,1683,6,0.36,1601,2000,1399-9-18
735,ضچاد1017,اختيارخ كچاد-20000-1399/10/02,16,54,103281000,2415,2000,2200,-215,-8.9,1913,-502,-20.79,1166,2555,1399-9-18
736,كرونا2,تامين مالي جمعي صرفا اهداي سود,16,1316,13160000,10000,10000,10000,0,0.0,10000,0,0.0,10000,10000,1399-9-18
737,اخزا713,اسنادخزانه-م13بودجه97-000518,16,67885,60755146965,888809,890032,895000,6191,0.7,894972,6163,0.69,890032,897000,1399-9-18
738,ضچاد1014,اختيارخ كچاد-14000-1399/10/02,16,120,773843000,7262,7000,6450,-812,-11.18,6449,-813,-11.2,6000,7000,1399-9-18
739,لخانه,لوازم‌ خانگي‌ پارس‌,15,8287,463657650,57680,55950,55950,-1730,-3.0,57638,-42,-0.07,55950,55950,1399-9-18
740,هفارس912,اختيارف ت فارس-14576-99/12/13,15,432650,432650,1,1,1,0,0.0,1,0,0.0,1,1,1399-9-18
741,اخزا816,اسنادخزانه-م16بودجه98-010503,15,19080,14260290910,747136,747170,747510,374,0.05,747395,259,0.03,747150,748400,1399-9-18
742,وسخراش,شركت س استان خراسان شمالي,15,333304,436628240,1370,1310,1310,-60,-4.38,1370,0,0.0,1310,1310,1399-9-18
743,ضچاد1015,اختيارخ كچاد-16000-1399/10/02,14,65,357561000,5624,4200,5000,-624,-11.1,5501,-123,-2.19,4001,5671,1399-9-18
744,هصيكو402,اختيارف ت تاصيكو13500-00/02/20,13,59747,54668505,581,915,915,334,57.49,915,334,57.49,915,915,1399-9-18
745,وسكرشا,س.سهام عدالت استان كرمانشاه,13,242191,290629200,1260,1200,1200,-60,-4.76,1260,0,0.0,1200,1200,1399-9-18
746,ضفار1122,اختيارخ فارس-11826-1399/11/07,13,52,381960000,3698,3800,3800,102,2.76,3673,-25,-0.68,3016,3800,1399-9-18
747,اخزا721,اسنادخزانه-م21بودجه97-000728,13,9170,7942822950,865869,860000,869000,3131,0.36,866175,306,0.04,860000,869000,1399-9-18
748,اخزا812,اسنادخزانه-م12بودجه98-001111,13,20797,17154983963,828191,815003,822901,-5290,-0.64,824878,-3313,-0.4,815003,833000,1399-9-18
749,ضجار1017,اختيارخ وتجارت-4500-1399/10/21,12,204,54550000,283,250,290,7,2.47,267,-16,-5.65,250,298,1399-9-18
750,وسبوشهر,شركت س استان بوشهر,12,157095,188514000,1260,1200,1200,-60,-4.76,1260,0,0.0,1200,1200,1399-9-18
751,ضملت1127,اختيارخ وبملت-5000-1399/11/28,12,130,171140000,1325,1300,1330,5,0.38,1316,-9,-0.68,1200,1330,1399-9-18
752,پلوله,گازلوله‌,12,33098,593976708,18127,17946,17946,-181,-1.0,18105,-22,-0.12,17946,17946,1399-9-18
753,ضسپا1103,اختيارخ خساپا-2500-1399/11/26,12,319,326450000,1045,1000,970,-75,-7.18,1023,-22,-2.11,930,1243,1399-9-18
754,شستا991,اجاره تامين اجتماعي-امين991226,12,247,247327000,1003046,1008000,1005000,1954,0.19,1001324,-1722,-0.17,1000000,1008000,1399-9-18
755,ضسپا1105,اختيارخ خساپا-3500-1399/11/26,11,452,225787000,494,500,500,6,1.21,500,6,1.21,405,537,1399-9-18
756,اخزا704,اسنادخزانه-م4بودجه97-991022,11,83054,81982354400,987635,983000,987980,345,0.03,987097,-538,-0.05,983000,990000,1399-9-18
757,خعمرا,توسعه و عمران شهرستان نائين,11,77520,1353499200,16952,17460,17460,508,3.0,16985,33,0.19,17460,17460,1399-9-18
758,وساربيل,شركت س استان اردبيل,11,186644,227705680,1280,1220,1220,-60,-4.69,1280,0,0.0,1220,1220,1399-9-18
759,نگين,ص.س. زمين و ساختمان نگين شهرري,11,49911,2421083500,48530,48500,48500,-30,-0.06,48510,-20,-0.04,48500,48530,1399-9-18
760,ضملت1126,اختيارخ وبملت-4500-1399/11/28,10,95,154805000,1699,1700,1600,-99,-5.83,1630,-69,-4.06,1550,1700,1399-9-18
761,وسگلستا,شركت س استان گلستان,10,168447,198767460,1240,1180,1180,-60,-4.84,1240,0,0.0,1180,1180,1399-9-18
762,ضپيك1019,اختيارخ تاپيكو-12000-99/10/16,10,105,558910000,5398,6000,5000,-398,-7.37,5323,-75,-1.39,5000,6000,1399-9-18
763,اراد55,مرابحه عام دولت5-ش.خ 0209,10,2000000,1850040000000,928350,925020,925020,-3330,-0.36,925020,-3330,-0.36,925020,925020,1399-9-18
764,زير0003پ01,زيره سبز0003كيميابذر(پ),10,400,250719500,619084,650000,588130,-30954,-5.0,626799,7715,1.25,588130,650000,1399-9-18
765,ضخود1040,اختيارخ خودرو-2000-1399/10/07,10,79,173090000,2155,2249,2170,15,0.7,2191,36,1.67,2170,2249,1399-9-18
766,اخزا901,اسنادخزانه-م1بودجه99-010621,10,14027,10242873973,729798,720001,732000,2202,0.3,730226,428,0.06,720001,732000,1399-9-18
767,هاباد912,اختيارف ت آبادا-30100-99/12/12,10,7569,57229209,7763,7561,7561,-202,-2.6,7561,-202,-2.6,7561,7561,1399-9-18
768,سرو2,صندوق س سروسودمند مدبران-سهام,9,900000,900000,73520,1,1,-73519,-100.0,1,-73519,-100.0,1,1,1399-9-18
769,آينده,بازرگاني آينده سازان بهشت پارس,9,8366,176020640,21690,21040,21040,-650,-3.0,21684,-6,-0.03,21040,21040,1399-9-18
770,زير0003پ02,زيره سبز0003 دانش(پ),8,231,144210480,576451,588130,588130,11679,2.03,624288,47837,8.3,588130,650000,1399-9-18
771,كابگن,توليدي و صنعتي آبگينه‌,8,123380,612828460,4918,4967,4967,49,1.0,4924,6,0.12,4967,4967,1399-9-18
772,ضملي1150,اختيارخ فملي-14196-1399/11/05,8,26,170696320,3619,3400,3300,-319,-8.81,3329,-290,-8.01,3030,3400,1399-9-18
773,ضمخا1025,اختيارخ اخابر-16000-1399/10/30,8,107,204000000,2013,2000,2000,-13,-0.65,1907,-106,-5.27,1900,2000,1399-9-18
774,عيار2,صندوق س. پشتوانه طلاي مفيد,7,70000,70000,30099,1,1,-30098,-100.0,1,-30098,-100.0,1,1,1399-9-18
775,زعف0008پ15,زعفران0008پوشالمعمول طلاسرخ(پ),7,1010,96042865,100090,95102,95082,-5008,-5.0,95092,-4998,-4.99,95082,95102,1399-9-18
776,تملي612,تسهيلات مسكن بانك ملي-اسفند96,7,30,25166100,882842,926984,838700,-44142,-5.0,838870,-43972,-4.98,838700,839000,1399-9-18
777,ضصاد1107,اختيارخ وبصادر-7000-1399/11/12,7,493,38132000,81,74,80,-1,-1.23,77,-4,-4.94,74,80,1399-9-18
778,ضملي1154,اختيارخ فملي-24336-1399/11/05,7,80,9426160,150,56,60,-90,-60.0,60,-90,-60.0,56,60,1399-9-18
779,تملي702,تسهيلات مسكن ب. ملي-ارديبهشت97,7,37,29319133,754676,792409,792409,37733,5.0,792409,37733,5.0,792409,792409,1399-9-18
780,گنجين,صندوق س. گنجينه يكم آويد-د,7,21429,252332295,11763,11765,11770,7,0.06,11775,12,0.1,11765,11780,1399-9-18
781,ضپاس1000,اختيارخ وپارس-2000-1399/10/30,7,55,129820000,2473,2400,2300,-173,-7.0,2360,-113,-4.57,2300,2700,1399-9-18
782,اخزا718,اسنادخزانه-م18بودجه97-000525,6,2445,2164543900,892000,884700,885294,-6706,-0.75,885294,-6706,-0.75,884700,890000,1399-9-18
783,هغدير912,اختيارف ت غدير-17380-99/12/16,6,50000,113550000,1762,2271,2271,509,28.89,2271,509,28.89,2271,2271,1399-9-18
784,ضخوز1014,اختيارخ فخوز-12191-1399/10/16,6,21,66927000,9677,9510,8350,-1327,-13.71,3187,-6490,-67.07,1000,9510,1399-9-18
785,ضجار1018,اختيارخ وتجارت-5000-1399/10/21,6,183,28497000,175,158,152,-23,-13.14,156,-19,-10.86,151,158,1399-9-18
786,اخزا813,اسنادخزانه-م13بودجه98-010219,6,17375,13509573280,783027,787000,777504,-5523,-0.71,777529,-5498,-0.7,777502,787000,1399-9-18
787,ضبدر1149,اختيارخ شبندر-28000-1399/11/19,6,41,267239000,6281,6250,6500,219,3.49,6518,237,3.77,6250,7500,1399-9-18
788,ضفلا1154,اختيارخ فولاد-12000-1399/11/28,6,49,180100000,4000,3605,3800,-200,-5.0,3676,-324,-8.1,3605,3800,1399-9-18
789,وسمازن,س.سهام عدالت استان مازندران,6,121500,114210000,980,940,940,-40,-4.08,980,0,0.0,940,940,1399-9-18
790,شستا992,اجاره تامين اجتماعي-سپهر991226,6,670,670079972,991011,1000000,1004997,13986,1.41,1000119,9108,0.92,1000000,1004999,1399-9-18
791,اخزا723,اسنادخزانه-م23بودجه97-000824,6,35554,30643052000,857000,860000,863000,6000,0.7,861874,4874,0.57,860000,863000,1399-9-18
792,ضترا1117,اختيارخ شتران-10000-1399/11/14,6,15,73303000,5300,4001,4700,-600,-11.32,4887,-413,-7.79,4001,6000,1399-9-18
793,تملي804,تسهيلات مسكن ب. ملي-تير98,5,27,26716095,1041563,1093641,989485,-52078,-5.0,989485,-52078,-5.0,989485,989485,1399-9-18
794,اخزا804,اسنادخزانه-م4بودجه98-000421,5,4322,3910436306,906326,904453,904501,-1825,-0.2,904775,-1551,-0.17,904453,907000,1399-9-18
795,شلرد02,كود شيميايي اوره لردگان,5,24,24150000,1000000,1040000,1000000,0,0.0,1006250,6250,0.63,990000,1040000,1399-9-18
796,ضگل1149,اختيارخ كگل-10000-1399/11/21,5,6,71500000,10500,11700,10000,-500,-4.76,11917,1417,13.5,10000,14000,1399-9-18
797,ياقوت2,صندوق س ياقوت آگاه-ثابت,5,9088000,9088000,11531,1,1,-11530,-99.99,1,-11530,-99.99,1,1,1399-9-18
798,ضفلا1157,اختيارخ فولاد-18000-1399/11/28,5,21,23052000,1000,1100,1095,95,9.5,1098,98,9.8,1094,1100,1399-9-18
799,ضسپا1102,اختيارخ خساپا-2000-1399/11/26,5,201,266700000,1526,1301,1600,74,4.85,1327,-199,-13.04,1301,1600,1399-9-18
800,اخزا807,اسنادخزانه-م7بودجه98-000719,5,1450,1261503800,865937,870000,870000,4063,0.47,870003,4066,0.47,870000,870100,1399-9-18
801,اخزا716,اسنادخزانه-م16بودجه97-000407,5,13487,12256687331,905259,906121,910000,4741,0.52,908778,3519,0.39,906121,912000,1399-9-18
802,ضچاد1012,اختيارخ كچاد-10000-1399/10/02,5,14,156900000,11300,11200,11250,-50,-0.44,11207,-93,-0.82,11200,11250,1399-9-18
803,وسيزد,شركت س استان يزد,5,154993,189091460,1280,1220,1220,-60,-4.69,1280,0,0.0,1220,1220,1399-9-18
804,آسيا4,بيمه آسيا,5,5000000,172450000000,35780,34490,34490,-1290,-3.61,34490,-1290,-3.61,34490,34490,1399-9-18
805,تملي708,تسهيلات مسكن ب. ملي-آبان97,4,67,45525897,715253,679491,679491,-35762,-5.0,679491,-35762,-5.0,679491,679491,1399-9-18
806,اطلس2,صندوق س.توسعه اندوخته آينده-س,4,40000,40000,214040,1,1,-214039,-100.0,1,-214039,-100.0,1,1,1399-9-18
807,اخزا720,اسنادخزانه-م20بودجه97-000324,4,27310,25043510000,915001,919000,917000,1999,0.22,917009,2008,0.22,917000,919000,1399-9-18
808,فماك,ماداكتو استيل كرد,4,200000,5397900000,26990,26990,26988,-2,-0.01,26989,-1,0.0,26988,26990,1399-9-18
809,سپرمي,پرميت‌,4,21200,178207200,8323,8406,8406,83,1.0,8326,3,0.04,8406,8406,1399-9-18
810,ضمخا7075,اختيارخ اخابر-9000-1400/07/28,3,4,42300000,11500,10000,10900,-600,-5.22,10575,-925,-8.04,10000,10900,1399-9-18
811,ضپار1117,اختيارخ خپارس-7000-1399/11/19,3,15,35330000,2497,2200,2400,-97,-3.88,2355,-142,-5.69,2200,2400,1399-9-18
812,اخزا805,اسنادخزانه-م5بودجه98-000422,3,12447,11275984500,903636,905601,906000,2364,0.26,905920,2284,0.25,905601,906000,1399-9-18
813,وسزنجان,شركت س استان زنجان,3,78708,106255800,1420,1350,1350,-70,-4.93,1420,0,0.0,1350,1350,1399-9-18
814,شستا993,اجاره ت.اجتماعي-كاردان991226,3,320,320000000,999523,1000000,1000000,477,0.05,1000000,477,0.05,1000000,1000000,1399-9-18
815,وسمركز,شركت س استان مركزي,3,105000,139650000,1400,1330,1330,-70,-5.0,1400,0,0.0,1330,1330,1399-9-18
816,ضملت1125,اختيارخ وبملت-4000-1399/11/28,3,20,47035000,2343,2300,2507,164,7.0,2352,9,0.38,2300,2507,1399-9-18
817,ضپار1116,اختيارخ خپارس-6000-1399/11/19,3,18,58000000,3800,2950,3300,-500,-13.16,3222,-578,-15.21,2950,3300,1399-9-18
818,اخزا906,اسنادخزانه-م6بودجه99-020321,3,1050,657358746,628367,615001,626609,-1758,-0.28,626056,-2311,-0.37,615001,626609,1399-9-18
819,ضمخا7066,اختيارخ اخابر-12000-1400/07/28,3,3,26730000,10150,9229,8750,-1400,-13.79,8910,-1240,-12.22,8750,9229,1399-9-18
820,گندم2,مرابحه گندم2-واجدشرايط خاص1400,3,1500,1451003000,965533,951003,1000000,34467,3.57,967335,1802,0.19,951003,1000000,1399-9-18
821,ساذري,آذريت‌,3,17223,105025854,5808,6098,6098,290,4.99,5809,1,0.02,6098,6098,1399-9-18
822,افران2,صندوق س افرا نماد پايدار-ثابت,3,300000,300000,12258,1,1,-12257,-99.99,1,-12257,-99.99,1,1,1399-9-18
823,صخود412,ص مرابحه خودرو412- 3ماهه 18%,3,137,135884411,983576,990003,992003,8427,0.86,991857,8281,0.84,990003,992003,1399-9-18
824,صگل1411,ص اجاره گل گهر 1411-3 ماهه 17%,2,11,10516000,956000,956000,956000,0,0.0,956000,0,0.0,956000,956000,1399-9-18
825,ما2,بيمه  ما,2,39950000,369138000000,9360,9240,9240,-120,-1.28,9240,-120,-1.28,9240,9240,1399-9-18
826,دومينو4,اجاره دومينو14040208,2,3000,2754155000,880000,933300,915002,35002,3.98,918052,38052,4.32,915002,933300,1399-9-18
827,صمسكن912,ص دين مسكن جنوب-ماهانه16درصد,2,133,8176244,61108,61719,61108,0,0.0,61476,368,0.6,61108,61719,1399-9-18
828,ضجار1013,اختيارخ وتجارت-2500-1399/10/21,2,3,3870000,1371,1200,1470,99,7.22,1290,-81,-5.91,1200,1470,1399-9-18
829,ضپار1118,اختيارخ خپارس-8000-1399/11/19,2,5,7500000,1618,1500,1500,-118,-7.29,1500,-118,-7.29,1500,1500,1399-9-18
830,ضگل1142,اختيارخ كگل-16000-1399/11/21,2,3,17250000,6136,5500,6250,114,1.86,5750,-386,-6.29,5500,6250,1399-9-18
831,وسكهبو,س.عدالت ا. كهگيلويه وبويراحمد,2,18514,19995120,1130,1080,1080,-50,-4.42,1130,0,0.0,1080,1080,1399-9-18
832,صايپا203,صكوك مرابحه سايپا203-3ماهه 16%,2,1020,980042620,967000,952131,961000,-6000,-0.62,960826,-6174,-0.64,952131,961000,1399-9-18
833,ضگل1141,اختيارخ كگل-14000-1399/11/21,2,3,22996000,7261,7998,7000,-261,-3.59,7665,404,5.56,7000,7998,1399-9-18
834,كمند2,صندوق س. با درآمد ثابت كمند,2,62000000,62000000,10012,1,1,-10011,-99.99,1,-10011,-99.99,1,1,1399-9-18
835,كشم0001پ01,كشمش سبز0001خليل آباد(پ),2,18,6993500,384409,388500,389000,4591,1.19,388528,4119,1.07,388500,389000,1399-9-18
836,ضشنا1045,اختيارخ شپنا-12000-1399/10/23,2,10,20930000,7701,3893,1893,-5808,-75.42,2093,-5608,-72.82,1893,3893,1399-9-18
837,تملي803,تسهيلات مسكن ب. ملي-خرداد98,2,40,23505880,559664,587647,587647,27983,5.0,587647,27983,5.0,587647,587647,1399-9-18
838,ضغدر1118,اختيارخ وغدير-9000-1399/11/26,2,28,159600000,6375,5700,5700,-675,-10.59,5700,-675,-10.59,5700,5700,1399-9-18
839,صگل411,ص اجاره گل گهر 411- 3 ماهه 17%,2,11,10780000,980000,980000,980000,0,0.0,980000,0,0.0,980000,980000,1399-9-18
840,اخزا9022,اسنادخزانه-م2بودجه99-011019,2,320000,216300000000,675682,675000,676500,818,0.12,675937,255,0.04,675000,676500,1399-9-18
841,اراد584,مرابحه عام دولت5-ش.خ 0110,2,6200000,5846600000000,1000000,943000,943000,-57000,-5.7,943000,-57000,-5.7,943000,943000,1399-9-18
842,صخابر102,صكوك اجاره مخابرات-3 ماهه 16%,2,1006,942604000,937000,934000,937000,0,0.0,936982,-18,0.0,934000,937000,1399-9-18
843,اخابر2,مخابرات ايران,2,39000000,609230000000,15770,15770,15480,-290,-1.84,15621,-149,-0.94,15480,15770,1399-9-18
844,ضفلا1153,اختيارخ فولاد-10000-1399/11/28,1,4,22000000,5100,5500,5500,400,7.84,5500,400,7.84,5500,5500,1399-9-18
845,شتهران,داروسازي تهران شيمي,1,5676,44494164,7686,7839,7839,153,1.99,7687,1,0.01,7839,7839,1399-9-18
846,ضگل1143,اختيارخ كگل-18000-1399/11/21,1,1,5000000,5500,5000,5000,-500,-9.09,5000,-500,-9.09,5000,5000,1399-9-18
847,ضخوز1013,اختيارخ فخوز-10667-1399/10/16,1,15,216000000,14062,14400,14400,338,2.4,14400,338,2.4,14400,14400,1399-9-18
848,عفولاد3,اوراق سلف موازي ورق گرم فولاد,1,10,7967220,794596,796722,796722,2126,0.27,796722,2126,0.27,796722,796722,1399-9-18
849,خاور4,ايران خودرو ديزل,1,15000000,100200000000,6362,6680,6680,318,5.0,6680,318,5.0,6680,6680,1399-9-18
850,اخزا9062,اسنادخزانه-م6بودجه99-020321,1,200000,124400000000,628367,622000,622000,-6367,-1.01,622000,-6367,-1.01,622000,622000,1399-9-18
851,تبريز112,مشاركت شهرداري تبريز-3ماهه18%,1,227,210864386,977808,928918,928918,-48890,-5.0,928918,-48890,-5.0,928918,928918,1399-9-18
852,عفولاد2,اوراق سلف ورق گرم فولاد مباركه,1,19,10800417,570462,568443,568443,-2019,-0.35,568443,-2019,-0.35,568443,568443,1399-9-18
853,وتعاون2,بيمه  تعاون,1,14900000,110662300000,7211,7427,7427,216,3.0,7427,216,3.0,7427,7427,1399-9-18
854,ضغدر1121,اختيارخ وغدير-14000-1399/11/26,1,20,46000000,2697,2300,2300,-397,-14.72,2300,-397,-14.72,2300,2300,1399-9-18
855,سخند4,صندوق س.سپهرخبرگان نفت-د,1,8000000,80000000000,10003,10000,10000,-3,-0.03,10000,-3,-0.03,10000,10000,1399-9-18
856,اراد50,مرابحه عام دولت5-ش.خ0302,1,10000,10000000000,1000000,1000000,1000000,0,0.0,1000000,0,0.0,1000000,1000000,1399-9-18
857,ضخوز1015,اختيارخ فخوز-13715-1399/10/16,1,1,7000000,8250,7000,7000,-1250,-15.15,7000,-1250,-15.15,7000,7000,1399-9-18
858,سيدكو4,سرمايه گذاري توسعه صنايع سيمان,1,20000000,179400000000,8600,8970,8970,370,4.3,8970,370,4.3,8970,8970,1399-9-18
859,اراد554,مرابحه عام دولت5-ش.خ 0209,1,2162116,2000000542320,928350,925020,925020,-3330,-0.36,925020,-3330,-0.36,925020,925020,1399-9-18
860,دمعيار2,صندوق س. توازن معيار-د,1,5000000,5000000,10088,1,1,-10087,-99.99,1,-10087,-99.99,1,1,1399-9-18
861,ضپيك1022,اختيارخ تاپيكو-18000-99/10/16,1,1,1650000,1975,1650,1650,-325,-16.46,1650,-325,-16.46,1650,1650,1399-9-18
862,ضصاد1106,اختيارخ وبصادر-6000-1399/11/12,1,25,3000000,110,120,120,10,9.09,120,10,9.09,120,120,1399-9-18
863,پارتا2,مجتمع‌صنعتي‌آرتاويل‌تاير,1,2400000,136737600000,57337,56974,56974,-363,-0.63,56974,-363,-0.63,56974,56974,1399-9-18
864,فبستم,صنايع ‌بسته‌بندي‌ مشهد,1,6454,5369728,793,832,832,39,4.92,793,0,0.0,832,832,1399-9-18
865,ضسان1038,اختيارخ پارسان-18000-99/10/14,1,1,8000000,4200,8000,8000,3800,90.48,8000,3800,90.48,8000,8000,1399-9-18
866,گواهي ظرفيت,گواهي ظرفيت نقدي,1,375000,3989625000,10639,10639,10639,0,0.0,10639,0,0.0,10639,10639,1399-9-18
867,زعف0008پ12,زعفران0008پوشالمعمول سحرخيز(پ),1,1000,95082000,100083,95082,95082,-5001,-5.0,95082,-5001,-5.0,95082,95082,1399-9-18
868,دسبحا4,گروه دارويي سبحان,1,2000000,47680000000,22730,23840,23840,1110,4.88,23840,1110,4.88,23840,23840,1399-9-18
869,كشرق4,صنعتي و معدني شمال شرق شاهرود,1,500000,39958500000,80424,79917,79917,-507,-0.63,79917,-507,-0.63,79917,79917,1399-9-18
870,ضسپا1100,اختيارخ خساپا-1600-1399/11/26,1,10,17600000,1849,1760,1760,-89,-4.81,1760,-89,-4.81,1760,1760,1399-9-18
871,كتوكا4,توليدي و خدمات صنايع نسوز توكا,1,600000,13390800000,22269,22318,22318,49,0.22,22318,49,0.22,22318,22318,1399-9-18
872,ضپار1119,اختيارخ خپارس-9000-1399/11/19,1,20,20000000,918,1000,1000,82,8.93,1000,82,8.93,1000,1000,1399-9-18
873,شنفت4,نفت‌ پارس‌,1,2000000,123420000000,62420,61710,61710,-710,-1.14,61710,-710,-1.14,61710,61710,1399-9-18
874,غنيلي,مجتمع توليدي نيلي صنعت كرمان,1,7025,117317500,16700,16700,16700,0,0.0,16700,0,0.0,16700,16700,1399-9-18
875,فاذر4,صنايع‌ آذرآب‌,1,23000000,820410000000,34640,35670,35670,1030,2.97,35670,1030,2.97,35670,35670,1399-9-18
876,صايپا308,صكوك مرابحه سايپا308-3ماهه 18%,1,10,10000000,990000,1000000,1000000,10000,1.01,1000000,10000,1.01,1000000,1000000,1399-9-18
877,ضگل1150,اختيارخ كگل-12000-1399/11/21,1,1,6050000,8040,6050,6050,-1990,-24.75,6050,-1990,-24.75,6050,6050,1399-9-18
878,اراد44,مرابحه عام دولت4-ش.خ 0007,1,1000,1050000000,1030000,1050000,1050000,20000,1.94,1050000,20000,1.94,1050000,1050000,1399-9-18
879,ضمخا7067,اختيارخ اخابر-14000-1400/07/28,1,1,6980000,7000,6980,6980,-20,-0.29,6980,-20,-0.29,6980,6980,1399-9-18
880,ديران4,ايران‌دارو,1,1300000,37986000000,27830,29220,29220,1390,4.99,29220,1390,4.99,29220,29220,1399-9-18
881,شسم,توليد سموم‌ علف‌ كش,1,10,872610,85550,87261,87261,1711,2.0,85550,0,0.0,87261,87261,1399-9-18
882,وسرمد4,بيمه  سرمد,1,1220030,8315724480,7020,6816,6816,-204,-2.91,6816,-204,-2.91,6816,6816,1399-9-18
883,آرمان2,بيمه آرمان,1,14500000,161312500000,10801,11125,11125,324,3.0,11125,324,3.0,11125,11125,1399-9-18
884,ضپنا1023,اختيارخ رمپنا-21506-1399/10/09,1,5,10367000,1736,1400,1400,-336,-19.35,1400,-336,-19.35,1400,1400,1399-9-18
885,كايتا,ايتالران‌,1,546,5217030,9277,9555,9555,278,3.0,9277,0,0.0,9555,9555,1399-9-18
886,فرآور4,فرآوري‌موادمعدني‌ايران‌,1,812500,20808125000,24650,25610,25610,960,3.89,25610,960,3.89,25610,25610,1399-9-18
887,سامان2,بانك سامان,1,40000000,500000000000,12237,12500,12500,263,2.15,12500,263,2.15,12500,12500,1399-9-18
888,ركيش2,كارت اعتباري ايران كيش,1,6484130,111851242500,16830,17250,17250,420,2.5,17250,420,2.5,17250,17250,1399-9-18
889,حفاري2,حفاري شمال,1,15000000,205500000000,14280,13700,13700,-580,-4.06,13700,-580,-4.06,13700,13700,1399-9-18
890,اراد38,مرابحه عام دولت3-ش.خ 0105,1,100,94800000,957675,948000,948000,-9675,-1.01,948000,-9675,-1.01,948000,948000,1399-9-18
