,نماد,نام,تعداد,حجم,ارزش,دیروز,اولین,آخرین معامله - مقدار,آخرین معامله - تغییر,آخرین معامله - درصد,قیمت پایانی - مقدار,قیمت پایانی - تغییر,قیمت پایانی - درصد,کمترین,بیشترین,تاریخ
0,پالايش,صندوق پالايشي يکم-سهام,119785,50415527,5048480209350,100260,100800,100010,-250,-0.25,100140,-120,-0.12,99560,101500,1399-9-22
1,شستا,سرمايه گذاري تامين اجتماعي,97477,219716268,6345368849230,28870,29100,28450,-420,-1.45,28880,10,0.03,28370,29700,1399-9-22
2,خودرو,ايران‌ خودرو,90620,1593890231,6494601745000,4160,4200,4000,-160,-3.85,4070,-90,-2.16,3960,4240,1399-9-22
3,بپيوند,برق و انرژي پيوندگستر پارس,74854,59968125,1964935482732,34549,34150,31770,-2779,-8.04,32766,-1783,-5.16,31488,34549,1399-9-22
4,وتجارت,بانك تجارت,73988,1303743427,4989015816500,3940,3920,3770,-170,-4.31,3830,-110,-2.79,3750,4000,1399-9-22
5,فملي,ملي‌ صنايع‌ مس‌ ايران‌,71475,258066782,4299297371620,16060,16470,16330,270,1.68,16660,600,3.74,16180,16860,1399-9-22
6,خساپا,سايپا,67639,1631086981,5075427578050,3210,3220,3050,-160,-4.98,3110,-100,-3.12,3050,3270,1399-9-22
7,وسپهر,سرمايه گذاري مالي سپهرصادرات,56185,216998111,2715291663772,12043,12645,12200,157,1.3,12513,470,3.9,12090,12645,1399-9-22
8,ثاميد,توسعه و عمران اميد,55895,852086544,2196435491360,2500,2600,2540,40,1.6,2580,80,3.2,2470,2620,1399-9-22
9,دارا يكم,صندوق واسطه گري مالي يكم-سهام,52333,16996866,3205645152900,191050,192100,185500,-5550,-2.9,188600,-2450,-1.28,185200,192260,1399-9-22
10,شپنا,پالايش نفت اصفهان,51621,194091618,3392610754210,17470,17550,17030,-440,-2.52,17480,10,0.06,16950,18000,1399-9-22
11,فولاد,فولاد مباركه اصفهان,48448,602215894,9127601222970,14440,15130,15160,720,4.99,15160,720,4.99,14950,15160,1399-9-22
12,ثبهساز,بهساز كاشانه تهران,43957,561193226,1809192383240,3100,3250,3140,40,1.29,3220,120,3.87,3120,3250,1399-9-22
13,دي,بانك دي,43755,84124750,4448391748485,50676,53209,52887,2211,4.36,52879,2203,4.35,51355,53209,1399-9-22
14,بركت,گروه دارويي بركت,42806,100996014,2200943778480,22320,23350,21210,-1110,-4.97,21790,-530,-2.37,21210,23350,1399-9-22
15,خگستر,گسترش‌سرمايه‌گذاري‌ايران‌خودرو,39964,706947292,3648249594930,4970,5130,5140,170,3.42,5160,190,3.82,4980,5210,1399-9-22
16,وبصادر,بانك صادرات ايران,38729,750425801,2770476138050,3790,3770,3610,-180,-4.75,3690,-100,-2.64,3610,3880,1399-9-22
17,بگيلان,توسعه مسير برق گيلان,33816,19957251,586236686824,28691,30125,28255,-436,-1.52,29375,684,2.38,28100,30125,1399-9-22
18,آبادا,توليد نيروي برق آبادان,33736,22171283,463807821490,20870,21360,20380,-490,-2.35,20920,50,0.24,20010,21360,1399-9-22
19,شتران,پالايش نفت تهران,32534,107321395,1456549847630,13570,13630,13200,-370,-2.73,13570,0,0.0,13110,14000,1399-9-22
20,زملارد,كشاورزي و دامپروري ملارد شير,32513,6448635,297045402902,44057,46000,46259,2202,5.0,46063,2006,4.55,45000,46259,1399-9-22
21,شبندر,پالايش نفت بندرعباس,32163,71876203,2308517710750,31460,32100,31350,-110,-0.35,32120,660,2.1,31010,32900,1399-9-22
22,سيتا,سرمايه گذاري سيمان تامين,31919,99555265,1877660440820,18020,18920,18580,560,3.11,18860,840,4.66,18320,18920,1399-9-22
23,غزر,صنعتي زر ماكارون,31319,5849714,362637779640,62260,63200,62500,240,0.39,61990,-270,-0.43,60950,63550,1399-9-22
24,امين,تامين سرمايه امين,29174,35607028,442347206090,12310,12740,12160,-150,-1.22,12420,110,0.89,12050,12800,1399-9-22
25,وبملت,بانك ملت,28434,468597791,2497652637250,5310,5310,5210,-100,-1.88,5330,20,0.38,5190,5460,1399-9-22
26,آريا,پليمر آريا ساسول,27025,6596721,1257606377710,181955,187870,190000,8045,4.42,190641,8686,4.77,184500,191052,1399-9-22
27,حكشتي,كشتيراني جمهوري اسلامي ايران,26692,46555804,1490430546630,32040,32740,30970,-1070,-3.34,32010,-30,-0.09,30750,33560,1399-9-22
28,وپويا,سرمايه گذاري پويا,26652,67295366,652515377696,9684,10100,9459,-225,-2.32,9696,12,0.12,9251,10100,1399-9-22
29,پيزد,مجتمع صنايع لاستيك يزد,26279,3944312,368780775534,90139,91000,91900,1761,1.95,93497,3358,3.73,90206,94645,1399-9-22
30,پترول,گروه پتروشيمي س. ايرانيان,26163,133146976,1849900770600,13350,13900,13700,350,2.62,13890,540,4.04,13500,14010,1399-9-22
31,تليسه,دامداري تليسه نمونه,23313,126592952,995921890819,8146,8400,7739,-407,-5.0,7867,-279,-3.42,7739,8400,1399-9-22
32,چخزر,صنايع چوب خزر كاسپين,21640,152708,4206799984,26237,27548,27548,1311,5.0,26342,105,0.4,27548,27548,1399-9-22
33,شگويا,پتروشيمي تندگويان,21265,76963997,1006028719114,13006,13500,12650,-356,-2.74,13071,65,0.5,12610,13500,1399-9-22
34,گدنا,تهيه توزيع غذاي دنا آفرين فدك,20755,1688293,58946750095,33253,34915,34915,1662,5.0,34915,1662,5.0,34915,34915,1399-9-22
35,انرژي3,سايراشخاص بورس انرژي,19684,4518966,1715120704480,371050,387900,358500,-12550,-3.38,379540,8490,2.29,355500,389600,1399-9-22
36,البرز,بيمه البرز,19487,246612619,1391264840000,5820,5990,5530,-290,-4.98,5640,-180,-3.09,5530,5990,1399-9-22
37,وكبهمن,مديريت سرمايه گذاري كوثربهمن,17310,894209,13599130472,14484,15208,15208,724,5.0,14672,188,1.3,15208,15208,1399-9-22
38,كفپارس,فرآورده‌هاي‌ نسوز پارس‌,16782,120386969,1116097191360,9280,9740,8950,-330,-3.56,9270,-10,-0.11,8820,9740,1399-9-22
39,خزاميا,زامياد,16486,93804252,1485158295500,15290,15950,15450,160,1.05,15830,540,3.53,14990,16050,1399-9-22
40,وغدير,سرمايه‌گذاري‌غدير(هلدينگ‌,16040,106660261,1510574510790,13540,13740,13950,410,3.03,14160,620,4.58,13740,14210,1399-9-22
41,لپارس,پارس‌ الكتريك‌,15993,6728428,1114880202210,169230,177500,160770,-8460,-5.0,165700,-3530,-2.09,160770,177690,1399-9-22
42,آسيا,بيمه آسيا,15773,27768138,1023830275710,36040,37500,36900,860,2.39,36870,830,2.3,36250,37500,1399-9-22
43,رافزا,رايان هم افزا,15092,91496,3481148312,36236,38047,38047,1811,5.0,36356,120,0.33,38047,38047,1399-9-22
44,كرمان,س. توسعه و عمران استان كرمان,14307,15638569,1389918042465,90307,93890,86300,-4007,-4.44,88878,-1429,-1.58,85920,93890,1399-9-22
45,خصدرا,صنعتي‌ دريايي‌ ايران‌,14112,127626918,702917082327,5526,5649,5367,-159,-2.88,5508,-18,-0.33,5361,5649,1399-9-22
46,وساپا,سرمايه‌گذاري‌ سايپا,14027,78254423,811915246230,10400,10550,9990,-410,-3.94,10380,-20,-0.19,9950,10750,1399-9-22
47,لكما,كارخانجات‌مخابراتي‌ايران‌,13862,66991034,617699537890,9344,9620,9067,-277,-2.96,9221,-123,-1.32,9064,9620,1399-9-22
48,خپارس,پارس‌ خودرو,13378,114612968,1054160896970,8870,9250,9020,150,1.69,9200,330,3.72,8910,9310,1399-9-22
49,فروي,ذوب روي اصفهان,13074,9394153,653513594821,66970,70310,68000,1030,1.54,69566,2596,3.88,67510,70318,1399-9-22
50,حسينا,توسعه خدمات دريايي وبندري سينا,12860,10323301,925212410802,94615,94000,86700,-7915,-8.37,89624,-4991,-5.28,85156,94500,1399-9-22
51,ذوب,سهامي ذوب آهن  اصفهان,12762,261936330,1546137953867,5624,5890,5905,281,5.0,5903,279,4.96,5810,5905,1399-9-22
52,قنيشا,قند  نيشابور,12665,12253455,959276606760,79070,83020,75120,-3950,-5.0,78290,-780,-0.99,75120,83020,1399-9-22
53,فرابورس,فرابورس ايران,12649,21166379,1364164173746,61881,64500,63350,1469,2.37,64450,2569,4.15,62500,64975,1399-9-22
54,قصفها,قنداصفهان‌,12638,3701192,926828439920,256570,267000,241200,-15370,-5.99,250410,-6160,-2.4,238650,268100,1399-9-22
55,وخارزم,سرمايه گذاري خوارزمي,12615,83977576,973767770060,11090,11490,11400,310,2.8,11600,510,4.6,11170,11640,1399-9-22
56,تاپيكو,س. نفت و گاز و پتروشيمي تأمين,12249,79054060,1350729642860,16480,17100,16570,90,0.55,17090,610,3.7,16480,17300,1399-9-22
57,كالا,بورس كالاي ايران,12122,21230757,1110049093380,52280,53890,50000,-2280,-4.36,52280,0,0.0,49670,54890,1399-9-22
58,غگل,گلوكوزان‌,11964,123156609,711469534660,5550,5800,5650,100,1.8,5780,230,4.14,5570,5820,1399-9-22
59,شبريز,پالايش نفت تبريز,11861,25359435,918254197640,36410,36230,35080,-1330,-3.65,36210,-200,-0.55,34750,37680,1399-9-22
60,غپينو,پارس‌ مينو,11853,127281681,1293380572040,9780,10260,9950,170,1.74,10160,380,3.89,9810,10260,1399-9-22
61,خبهمن,گروه‌بهمن‌,11504,61999483,1847130965110,28660,30090,29390,730,2.55,29790,1130,3.94,27230,30090,1399-9-22
62,پتاير,ايران‌ تاير,11456,6171755,1208589268950,179090,195890,196990,17900,9.99,195830,16740,9.35,188000,196990,1399-9-22
63,شيران,س. صنايع‌شيميايي‌ايران,11401,22830729,902202780000,41010,40420,39900,-1110,-2.71,39520,-1490,-3.63,38960,41010,1399-9-22
64,ثشاهد,سرمايه‌ گذاري‌ شاهد,11369,34640540,1094807187470,30630,32160,30650,20,0.07,31600,970,3.17,29100,32160,1399-9-22
65,بجهرم,توسعه مولد نيروگاهي جهرم,10953,103698151,456227264013,4291,4505,4300,9,0.21,4400,109,2.54,4240,4505,1399-9-22
66,وملل,اعتباري ملل,10891,70897605,1151653134801,16773,17200,16200,-573,-3.42,16244,-529,-3.15,15935,17200,1399-9-22
67,بكهنوج,توليد برق ماهتاب كهنوج,10790,189122508,627477393653,3189,3299,3348,159,4.99,3318,129,4.05,3190,3348,1399-9-22
68,هاي وب,داده گسترعصرنوين-هاي وب,10759,31261627,982198794690,30820,32290,31010,190,0.62,31420,600,1.95,30200,32310,1399-9-22
69,فاسمين,كالسيمين‌,10659,50874043,1054729426300,20460,21480,19800,-660,-3.23,20730,270,1.32,19660,21480,1399-9-22
70,حفاري,حفاري شمال,10494,43342940,613436968200,14260,14720,13710,-550,-3.86,14150,-110,-0.77,13610,14720,1399-9-22
71,بوعلي,پتروشيمي بوعلي سينا,10094,725635,31565122500,41430,43500,43500,2070,5.0,42500,1070,2.58,43500,43500,1399-9-22
72,وصنعت,سرمايه گذاري توسعه صنعت وتجارت,9783,66858445,562663680520,8720,8690,8290,-430,-4.93,8420,-300,-3.44,8290,8780,1399-9-22
73,چكاپا,گروه صنايع كاغذ پارس,9629,66026011,439964890850,6740,6790,6420,-320,-4.75,6660,-80,-1.19,6410,6930,1399-9-22
74,ومعادن,توسعه‌معادن‌وفلزات‌,9618,59146496,934333502300,15180,15640,15410,230,1.52,15800,620,4.08,15270,15930,1399-9-22
75,ثاخت,بين‌المللي‌توسعه‌ساختمان,9406,106931276,478402939620,4620,4610,4390,-230,-4.98,4470,-150,-3.25,4390,4630,1399-9-22
76,بكام,كارخانجات توليدي شهيد قندي,9392,108052794,561890056210,4980,5220,5210,230,4.62,5200,220,4.42,5090,5220,1399-9-22
77,صبا,سرمايه گذاري صبا تامين,9334,25312764,241869676337,9526,9710,9320,-206,-2.16,9555,29,0.3,9192,9887,1399-9-22
78,ونوين,بانك‌اقتصادنوين‌,9331,164637798,934589597760,5640,5760,5500,-140,-2.48,5680,40,0.71,5470,5890,1399-9-22
79,فاذر,صنايع‌ آذرآب‌,9198,19670642,769382328500,37380,39240,39220,1840,4.92,39110,1730,4.63,37840,39240,1399-9-22
80,خرينگ,رينگ‌سازي‌مشهد,9182,11538570,765807647930,66860,70180,63520,-3340,-5.0,66370,-490,-0.73,63520,70200,1399-9-22
81,وپاسار,بانك  پاسارگاد,8841,69121793,851520204580,11830,11840,12410,580,4.9,12320,490,4.14,11840,12420,1399-9-22
82,زشگزا,شير و گوشت زاگرس شهركرد,8834,3213695,498101651931,159710,162500,151725,-7985,-5.0,154993,-4717,-2.95,151725,162500,1399-9-22
83,ونيرو,سرمايه‌گذاري‌نيرو,8709,94283813,477174409190,4930,5110,4850,-80,-1.62,5060,130,2.64,4800,5170,1399-9-22
84,كوير,توليدي فولاد سپيد فراب كوير,8300,32623492,743173280420,22170,23270,22400,230,1.04,22780,610,2.75,21860,23270,1399-9-22
85,دماوند,توليد نيروي برق دماوند,8115,6741067,514890828832,76937,77000,74220,-2717,-3.53,76381,-556,-0.72,74001,78500,1399-9-22
86,ورنا,سرمايه‌گذاري‌ رنا(هلدينگ‌,8109,63912107,630873506070,10080,10120,10000,-80,-0.79,9870,-210,-2.08,9580,10240,1399-9-22
87,ودي,بيمه  دي,8101,30009574,948657164256,30623,32154,30900,277,0.9,31612,989,3.23,30100,32154,1399-9-22
88,غشهداب,كشت و صنعت شهداب ناب خراسان,7971,91807851,516529871142,5394,5555,5440,46,0.85,5626,232,4.3,5400,5663,1399-9-22
89,زكوثر,سرمايه گذاري كشاورزي كوثر,7883,16249748,428450246940,26730,27790,25790,-940,-3.52,26370,-360,-1.35,25400,27790,1399-9-22
90,بنو,بيمه تجارت نو,7524,24652661,769310185448,31551,33128,29974,-1577,-5.0,31206,-345,-1.09,29974,33128,1399-9-22
91,ختور,رادياتور ايران‌,7424,12013108,557764719330,45720,47500,45130,-590,-1.29,46430,710,1.55,45130,49850,1399-9-22
92,كسعدي,كاشي‌ سعدي‌,7329,10511339,400966375250,38560,39900,37000,-1560,-4.05,38150,-410,-1.06,36700,39990,1399-9-22
93,سبزوا,سيمان لار سبزوار,7244,44294804,274039383134,6027,6210,6040,13,0.22,6187,160,2.65,6001,6320,1399-9-22
94,مدير,ص.س.مديريت ثروت ص.بازنشستگي-س,6950,45087751,594834589694,12136,13180,13349,1213,10.0,13193,1057,8.71,12512,13349,1399-9-22
95,ساوه,سيمان ساوه,6726,2712134,173996419975,65232,66600,62400,-2832,-4.34,64155,-1077,-1.65,61971,68000,1399-9-22
96,غديس,پاكديس,6705,22667546,286780695554,13138,12870,12482,-656,-4.99,12652,-486,-3.7,12482,13000,1399-9-22
97,وشهر,بانك شهر,6704,63341548,500048138505,7600,7650,7904,304,4.0,7894,294,3.87,7650,7904,1399-9-22
98,تپمپي,پمپ‌ سازي‌ ايران‌,6681,13027334,480681013710,37360,37500,36950,-410,-1.1,36900,-460,-1.23,35710,38400,1399-9-22
99,تكشا,گسترش‌صنايع‌وخدمات‌كشاورزي‌,6573,10037124,601350021720,59930,62900,61630,1700,2.84,59910,-20,-0.03,57010,62920,1399-9-22
100,كاوه,فولاد كاوه جنوب كيش,6527,53915007,1261440669340,22350,23460,22850,500,2.24,23400,1050,4.7,22800,23460,1399-9-22
101,سامان,بانك سامان,6449,71217661,880715363278,12723,12500,12342,-381,-2.99,12367,-356,-2.8,12342,12800,1399-9-22
102,خكمك,كمك‌فنرايندامين‌,6399,7787338,390425451100,50360,52400,49500,-860,-1.71,50140,-220,-0.44,48440,52400,1399-9-22
103,كگل,معدني و صنعتي گل گهر,6323,20076802,386094297500,19340,19060,18950,-390,-2.02,19230,-110,-0.57,18470,19740,1399-9-22
104,ثقزوي,شركت عمران و سازندگي قزوين,6297,13523141,372902243214,27459,28820,27220,-239,-0.87,27575,116,0.42,26100,28820,1399-9-22
105,وتوس,توسعه‌شهري‌توس‌گستر,6272,15878848,462441549050,27880,29270,29270,1390,4.99,29120,1240,4.45,28450,29270,1399-9-22
106,خكرمان,گروه اقتصادي كرمان خودرو,6172,54049568,326214277358,6033,6050,5910,-123,-2.04,6035,2,0.03,5870,6199,1399-9-22
107,اپرداز,آتيه داده پرداز,6039,12415859,387512452970,32174,31930,30571,-1603,-4.98,31211,-963,-2.99,30566,32600,1399-9-22
108,اخابر,مخابرات ايران,5966,66915591,1119406972340,15990,16780,16490,500,3.13,16730,740,4.63,16400,16780,1399-9-22
109,ولساپا,ليزينگ رايان‌ سايپا,5931,59878220,278410919990,4630,4780,4500,-130,-2.81,4650,20,0.43,4480,4790,1399-9-22
110,چدن,توليدي چدن سازان,5872,17404782,665730600570,38910,40000,36970,-1940,-4.99,38250,-660,-1.7,36970,40000,1399-9-22
111,سفارس,سيمان فارس و خوزستان,5799,19272439,387698915950,20290,20900,19350,-940,-4.63,20120,-170,-0.84,19290,21190,1399-9-22
112,غگيلا,شيرپاستوريزه پگاه گيلان,5762,83917,1524520139,17302,18167,18167,865,5.0,17327,25,0.14,18167,18167,1399-9-22
113,دانا,بيمه دانا,5735,37998454,327075082460,8880,9290,8440,-440,-4.95,8610,-270,-3.04,8440,9290,1399-9-22
114,ثعمرا,عمران و توسعه شاهد,5706,20746036,372536071392,17525,18401,16910,-615,-3.51,17957,432,2.47,16649,18401,1399-9-22
115,ختوقا,قطعات‌ اتومبيل‌ ايران‌,5682,98368885,430605575550,4190,4350,4390,200,4.77,4380,190,4.53,4250,4390,1399-9-22
116,كحافظ,كاشي‌ وسراميك‌ حافظ‌,5675,14793628,306391226110,20790,21590,20050,-740,-3.56,20710,-80,-0.38,20040,21590,1399-9-22
117,بالاس,مهندسي ساختمان تاسيسات راه آهن,5669,7921992,486594596819,61931,65027,58835,-3096,-5.0,61423,-508,-0.82,58835,65027,1399-9-22
118,كرازي,كارخانجات‌توليدي‌شيشه‌رازي‌,5622,12223424,302470820490,25470,26590,24200,-1270,-4.99,24750,-720,-2.83,24200,26590,1399-9-22
119,خمحركه,نيرو محركه‌,5613,50141381,413066955320,7870,8250,8260,390,4.96,8240,370,4.7,8010,8260,1399-9-22
120,كچاد,معدني‌وصنعتي‌چادرملو,5597,20539392,425460529210,20900,20890,20250,-650,-3.11,20710,-190,-0.91,20100,21490,1399-9-22
121,وبانك,سرمايه گذاري گروه توسعه ملي,5576,36347092,434439799580,11450,11550,11670,220,1.92,11950,500,4.37,11520,12020,1399-9-22
122,تبرك,گروه كارخانجات صنعتي تبرك,5527,16575918,472190998969,27233,28594,27860,627,2.3,28487,1254,4.6,27500,28594,1399-9-22
123,دتوليد,داروسازي توليد دارو,5503,8913506,320991267394,37479,36101,35606,-1873,-5.0,36012,-1467,-3.91,35606,36890,1399-9-22
124,سصوفي,سيمان‌ صوفيان‌,5378,20345883,340449074510,16890,17730,16090,-800,-4.74,16730,-160,-0.95,16050,17730,1399-9-22
125,دزهراوي,داروسازي‌زهراوي‌,5375,15813310,217960309750,14300,14350,13590,-710,-4.97,13780,-520,-3.64,13590,14350,1399-9-22
126,نوين,بيمه نوين,5327,30035245,297866045960,9627,10108,9660,33,0.34,9917,290,3.01,9649,10108,1399-9-22
127,ماديرا,صنايع ماشين هاي اداري ايران,5263,18434157,582330864848,30231,31500,31000,769,2.54,31590,1359,4.5,30360,31742,1399-9-22
128,بزاگرس,نيروگاه زاگرس كوثر,5204,29294818,428745037400,13997,14110,14690,693,4.95,14636,639,4.57,14110,14696,1399-9-22
129,وملي,گروه‌ صنعتي‌ ملي‌ (هلدينگ‌,5151,2432466,928254850210,366740,385070,366800,60,0.02,381610,14870,4.05,348420,385070,1399-9-22
130,ميهن,بيمه ميهن,5078,39363867,273322256670,7217,7450,6857,-360,-4.99,6943,-274,-3.8,6857,7450,1399-9-22
131,فسرب,ملي‌ سرب‌وروي‌ ايران‌,4939,2010475,297189278980,151870,155000,144280,-7590,-5.0,147820,-4050,-2.67,144280,155000,1399-9-22
132,شكلر,نيروكلر,4815,6184446,383898800270,63080,61000,61800,-1280,-2.03,62070,-1010,-1.6,60010,65000,1399-9-22
133,وپست,پست بانك ايران,4814,27045412,531605361960,19960,19900,18970,-990,-4.96,19660,-300,-1.5,18970,20940,1399-9-22
134,شفارس,صنايع‌ شيميايي‌ فارس‌,4790,7051471,426837292710,60850,61800,59000,-1850,-3.04,60530,-320,-0.53,58000,63440,1399-9-22
135,داراب,پتروشيمي داراب,4767,48767230,144901376536,2971,2970,2896,-75,-2.52,2971,0,0.0,2882,3050,1399-9-22
136,فزرين,زرين معدن آسيا,4741,14213904,420440475928,30393,30400,28874,-1519,-5.0,29580,-813,-2.67,28874,31100,1399-9-22
137,شلرد,كود شيميايي اوره لردگان,4729,27281991,309450499657,11628,11790,11280,-348,-2.99,11343,-285,-2.45,11280,11790,1399-9-22
138,خكاوه,سايپا ديزل,4723,48003541,257527062458,5471,5599,5307,-164,-3.0,5365,-106,-1.94,5307,5599,1399-9-22
139,تملت,تامين سرمايه بانك ملت,4687,53622414,530808537380,9430,9900,9900,470,4.98,9900,470,4.98,9810,9900,1399-9-22
140,كپارس,كاشي‌ پارس‌,4683,2432152,436731136410,172570,181170,174300,1730,1.0,179570,7000,4.06,172390,181190,1399-9-22
141,كيسون,شركت كيسون,4683,50082525,848506122356,16457,16950,16950,493,3.0,16942,485,2.95,16457,16950,1399-9-22
142,وهور,مديريت انرژي اميد  تابان هور,4634,8822735,399364546067,43547,44990,44483,936,2.15,45265,1718,3.95,43900,45724,1399-9-22
143,ديران,ايران‌دارو,4629,18237417,577919448950,30610,32140,30820,210,0.69,31690,1080,3.53,29350,32140,1399-9-22
144,وشمال,س. چشم انداز توسعه شمال,4600,3456552,353283469370,100914,103941,99820,-1094,-1.08,102207,1293,1.28,97887,103941,1399-9-22
145,وساخت,سرمايه‌ گذاري‌ ساختمان‌ايران‌,4595,5295857,365966649250,66090,68870,69390,3300,4.99,69100,3010,4.55,67300,69390,1399-9-22
146,جهرم,پتروشيمي جهرم,4578,50548484,157622712420,3103,3196,3012,-91,-2.93,3118,15,0.48,3010,3196,1399-9-22
147,كمند,صندوق س. با درآمد ثابت كمند,4568,203224583,2040118370145,10029,10038,10041,12,0.12,10039,10,0.1,10037,10042,1399-9-22
148,كسرا,سراميك‌هاي‌صنعتي‌اردكان‌,4543,10617579,372186506390,34530,35750,34200,-330,-0.96,35050,520,1.51,33850,36150,1399-9-22
149,قشير,قند شيروان قوچان و بجنورد,4528,8107616,283595641651,33662,33270,34615,953,2.83,34979,1317,3.91,33270,35345,1399-9-22
150,ثنام,س ساختماني ب نام آوران مهندسي,4304,15094245,339755644707,22239,22906,21700,-539,-2.42,22509,270,1.21,21650,22906,1399-9-22
151,وبوعلي,سرمايه‌گذاري‌بوعلي‌,4278,23002934,185946077290,7830,8220,8000,170,2.17,8080,250,3.19,7850,8220,1399-9-22
152,بپاس,بيمه پاسارگاد,4260,3802685,356654827782,91883,92953,92250,367,0.4,93790,1907,2.08,91900,94760,1399-9-22
153,آگاس,صندوق س.هستي بخش آگاه-س,4229,4974116,383800878158,76050,77000,76744,694,0.91,77160,1110,1.46,76439,78000,1399-9-22
154,كمرجان,بازرگاني و توليدي مرجان كار,4145,3007894,227777636137,76285,80000,72471,-3814,-5.0,75727,-558,-0.73,72471,80000,1399-9-22
155,بورس,بورس اوراق بهادار تهران,4133,5610892,386537359040,66750,70080,67650,900,1.35,68890,2140,3.21,65510,70080,1399-9-22
156,ملت,بيمه ملت,4132,19291319,361474832840,19460,19460,18490,-970,-4.98,18740,-720,-3.7,18490,19980,1399-9-22
157,حسير,ريل سير كوثر,4122,12070499,240152557188,19444,20100,20180,736,3.79,19896,452,2.32,19000,20400,1399-9-22
158,رمپنا,گروه مپنا (سهامي عام),4102,16488807,368980366650,21520,21900,21650,130,0.6,22380,860,4.0,21640,22590,1399-9-22
159,قثابت,قند ثابت‌ خراسان‌,4080,3915989,342528412060,84730,85990,85550,820,0.97,87470,2740,3.23,84760,88960,1399-9-22
160,كلر,كلر پارس,4073,2396536,182931508247,77745,78900,74011,-3734,-4.8,76332,-1413,-1.82,73858,80399,1399-9-22
161,لسرما,سرما آفرين‌,4040,8588631,305001514580,34140,35480,35840,1700,4.98,35510,1370,4.01,33000,35840,1399-9-22
162,تملتح,ح . تامين سرمايه بانك ملت,4017,301906827,2415254616000,8000,8000,8000,0,0.0,8000,0,0.0,8000,8000,1399-9-22
163,زبينا,كشاورزي و دامپروري بينالود,3995,3917484,217485652219,55207,56910,53510,-1697,-3.07,55517,310,0.56,53400,56920,1399-9-22
164,زمگسا,كشاورزي‌ ودامپروي‌ مگسال‌,3912,8092499,476430312980,53950,57800,59340,5390,9.99,58870,4920,9.12,54920,59340,1399-9-22
165,پاسا,ايران‌ياساتايرورابر,3908,15459388,454938384210,28240,27950,29650,1410,4.99,29430,1190,4.21,27950,29650,1399-9-22
166,وبيمه,سرمايه‌ گذاري‌ صنعت‌ بيمه‌,3907,38366716,152117991400,3860,4050,3800,-60,-1.55,3960,100,2.59,3760,4050,1399-9-22
167,حريل,ريل پردازسير,3871,48226357,219008368782,4367,4520,4585,218,4.99,4541,174,3.98,4421,4585,1399-9-22
168,قرن,پديده شيمي قرن,3822,3285266,200825663990,61350,62400,59800,-1550,-2.53,61130,-220,-0.36,59000,62400,1399-9-22
169,ريشمك,توليد و صادرات ريشمك,3821,5916160,353538820140,57211,60071,60071,2860,5.0,59758,2547,4.45,58350,60071,1399-9-22
170,ونفت,سرمايه‌گذاري‌ صنعت‌ نفت‌,3793,13301472,234946378250,17930,17260,17800,-130,-0.73,17660,-270,-1.51,17260,18090,1399-9-22
171,كروي,توسعه‌ معادن‌ روي‌ ايران‌,3770,9445491,360774534470,37390,37850,37110,-280,-0.75,38200,810,2.17,37100,39250,1399-9-22
172,كهمدا,شيشه‌ همدان‌,3763,12453534,173181146170,14450,14000,13730,-720,-4.98,13910,-540,-3.74,13730,14440,1399-9-22
173,كساوه,صنايع‌ كاشي‌ و سراميك‌ سينا,3759,8786062,875174546900,100180,100190,98010,-2170,-2.17,99610,-570,-0.57,95180,104550,1399-9-22
174,حفارس,حمل و نقل بين المللي خليج فارس,3719,41197400,208583455380,4900,5080,4960,60,1.22,5060,160,3.27,4880,5140,1399-9-22
175,ثپرديس,سرمايه گذاري مسكن پرديس,3631,18425971,216482019251,12011,12550,11810,-201,-1.67,11749,-262,-2.18,11411,12550,1399-9-22
176,خاهن,آهنگري‌ تراكتورسازي‌ ايران‌,3617,8721627,342259906410,40810,41000,38770,-2040,-5.0,39240,-1570,-3.85,38770,41500,1399-9-22
177,تنوينح,ح . تامين سرمايه نوين,3595,15969708,86352748810,5281,5400,5273,-8,-0.15,5407,126,2.39,5251,5550,1399-9-22
178,ورازي,بيمه رازي,3563,22091229,303753396471,13669,14352,13110,-559,-4.09,13750,81,0.59,12986,14352,1399-9-22
179,ثرود,سرمايه‌گذاري مسكن زاينده رود,3527,12259097,147264621944,12107,12500,11800,-307,-2.54,12013,-94,-0.78,11520,12700,1399-9-22
180,پاكشو,گروه صنعتي پاكشو,3525,2034162,176684699890,86020,90000,85040,-980,-1.14,86860,840,0.98,84740,90000,1399-9-22
181,فرآور,فرآوري‌موادمعدني‌ايران‌,3512,14265917,399505778400,26890,28230,27220,330,1.23,28000,1110,4.13,26890,28230,1399-9-22
182,وحافظ,بيمه حافظ,3508,7125426,489297975208,69709,71799,67618,-2091,-3.0,68669,-1040,-1.49,67618,71799,1399-9-22
183,ما,بيمه  ما,3493,38303311,389340755160,9720,10200,10200,480,4.94,10160,440,4.53,9820,10200,1399-9-22
184,پارسان,گسترش نفت و گاز پارسيان,3446,10647753,263503380550,24110,24860,24000,-110,-0.46,24750,640,2.65,23910,25310,1399-9-22
185,زاگرس,پتروشيمي زاگرس,3439,5269022,1026034544082,185603,190000,194883,9280,5.0,194730,9127,4.92,189907,194883,1399-9-22
186,كيميا,معدني كيمياي زنجان گستران,3434,7272124,252026281490,33521,34000,34239,718,2.14,34656,1135,3.39,31900,35197,1399-9-22
187,كگاز,شيشه‌ و گاز,3393,6839427,171870043950,24410,25600,24700,290,1.19,25130,720,2.95,24600,25630,1399-9-22
188,بساما,بيمه سامان,3350,6636530,242871324299,35005,36755,35800,795,2.27,36596,1591,4.55,35800,36755,1399-9-22
189,ثنوسا,نوسازي‌وساختمان‌تهران‌,3308,40378002,551949929940,13100,13750,13210,110,0.84,13670,570,4.35,13100,13750,1399-9-22
190,ثاباد,توريستي ورفاهي آبادگران ايران,3296,4865054,169075124940,35070,36820,33320,-1750,-4.99,34750,-320,-0.91,33320,36820,1399-9-22
191,ثغرب,شركت سرمايه گذاري مسكن شمالغرب,3285,21620319,280309917198,12490,13114,12630,140,1.12,12965,475,3.8,12511,13114,1399-9-22
192,والبر,سرمايه‌ گذاري‌ البرز(هلدينگ‌,3280,11863146,245476789350,21140,22000,20150,-990,-4.68,20690,-450,-2.13,20120,22000,1399-9-22
193,رانفور,خدمات‌انفورماتيك‌,3273,4862595,168461780200,34750,36000,33400,-1350,-3.88,34640,-110,-0.32,33020,36000,1399-9-22
194,خاذين,سايپاآذين‌,3257,40606767,271029851170,6370,6680,6680,310,4.87,6670,300,4.71,6550,6680,1399-9-22
195,ثمسكن,سرمايه‌گذاري‌ مسكن‌,3250,30175395,207625345780,6930,7140,6680,-250,-3.61,6880,-50,-0.72,6630,7140,1399-9-22
196,ميدكو,هلدينگ صنايع  معدني خاورميانه,3228,13376452,370332370749,26660,26600,27993,1333,5.0,27685,1025,3.84,26251,27993,1399-9-22
197,وسينا,بانك سينا,3198,19719604,273529779340,13810,14330,13620,-190,-1.38,13870,60,0.43,13620,14350,1399-9-22
198,وپترو,سرمايه‌گذاري صنايع پتروشيمي‌,3155,9778337,192081518790,20050,20890,19050,-1000,-4.99,19640,-410,-2.04,19050,20890,1399-9-22
199,وسين,بيمه سينا,3106,10147178,269960709283,26092,27396,26092,0,0.0,26605,513,1.97,25500,27396,1399-9-22
200,ارزش,صندوق س ارزش آفرين بيدار-سهام,3097,19917432,240733538470,11670,12030,12090,420,3.6,12090,420,3.6,11940,12290,1399-9-22
201,خريخت,صنايع‌ريخته‌گري‌ايران‌,3059,46226799,226915862870,4700,4900,4900,200,4.26,4910,210,4.47,4730,4930,1399-9-22
202,آ س پ,آ.س.پ,3032,11118274,132259213391,12041,12600,11511,-530,-4.4,11896,-145,-1.2,11490,12600,1399-9-22
203,همراه,شركت ارتباطات سيار ايران,3028,8131773,307867659830,36380,38100,37000,620,1.7,37860,1480,4.07,36980,38190,1399-9-22
204,ولشرق,ليزينگ ايران و شرق,3001,18373004,140137652075,7860,8150,7467,-393,-5.0,7627,-233,-2.96,7467,8150,1399-9-22
205,سرو,صندوق س سروسودمند مدبران-سهام,2990,2832533,209276032950,73140,73470,73680,540,0.74,73880,740,1.01,73470,74500,1399-9-22
206,ثتران,سرمايه گذاري مسكن تهران,2964,25493257,145017361083,5779,5950,5520,-259,-4.48,5688,-91,-1.57,5491,5986,1399-9-22
207,وگردش,بانك گردشگري,2937,14648640,303903802636,21255,21800,20618,-637,-3.0,20746,-509,-2.39,20618,21800,1399-9-22
208,ومهان,گروه توسعه مالي مهر آيندگان,2934,8552368,152187696604,17621,17620,17661,40,0.23,17795,174,0.99,17600,18130,1399-9-22
209,فولاي,صنايع فولاد آلياژي يزد,2911,3809052,146478513784,37572,38320,37800,228,0.61,38455,883,2.35,36500,39400,1399-9-22
210,سپح,ح . پرداخت الكترونيك سامان كيش,2900,4782591,89674492470,19060,19670,18400,-660,-3.46,18750,-310,-1.63,17410,19670,1399-9-22
211,فسا,پتروشيمي فسا,2879,26822530,73342694592,2763,2837,2681,-82,-2.97,2734,-29,-1.05,2681,2837,1399-9-22
212,واتي,سرمايه‌ گذاري‌ آتيه‌ دماوند,2871,14026873,220722644610,16190,16500,15390,-800,-4.94,15740,-450,-2.78,15390,16500,1399-9-22
213,سشرق,سيمان‌ شرق‌,2871,29503840,214370172420,6940,7270,7280,340,4.9,7270,330,4.76,7040,7280,1399-9-22
214,فمراد,آلومراد,2855,1988754,271504984470,130990,137530,132250,1260,0.96,136520,5530,4.22,131090,137530,1399-9-22
215,سپ,پرداخت الكترونيك سامان كيش,2843,5562888,114003481840,19920,20700,20910,990,4.97,20490,570,2.86,19410,20910,1399-9-22
216,شسپا,نفت سپاهان,2834,8384981,232325113330,27580,28410,27320,-260,-0.94,27710,130,0.47,27210,28700,1399-9-22
217,دكوثر,داروسازي‌ كوثر,2799,6069891,168782651850,26950,28180,27890,940,3.49,27810,860,3.19,26610,28290,1399-9-22
218,ثباغ,شهر سازي و خانه سازي باغميشه,2797,9065671,215229057614,24606,24700,23420,-1186,-4.82,23741,-865,-3.52,23376,25100,1399-9-22
219,وصندوق,سرمايه‌گذاري‌صندوق‌بازنشستگي‌,2791,11443988,195680928120,17110,16810,16710,-400,-2.34,17100,-10,-0.06,16710,17780,1399-9-22
220,جم,پتروشيمي جم,2777,10272717,531883170380,49450,49600,51300,1850,3.74,51780,2330,4.71,49600,51920,1399-9-22
221,ساربيل,سيمان آرتا اردبيل,2771,4222850,225588200920,51260,53430,53820,2560,4.99,53420,2160,4.21,49360,53820,1399-9-22
222,رتاپح,ح.تجارت الكترونيك پارسيان,2771,19998832,117820434480,5450,5540,6000,550,10.09,5890,440,8.07,5470,6000,1399-9-22
223,مرقام,ايران‌ارقام‌,2761,9153341,249341123240,26100,27380,26750,650,2.49,27240,1140,4.37,26300,27400,1399-9-22
224,قشرين,قند شيرين خراسان,2744,13744412,319958954253,23591,24290,22884,-707,-3.0,23279,-312,-1.32,22884,24290,1399-9-22
225,فسپا,گروه‌صنعتي‌سپاهان‌,2739,4745842,254108786940,54400,52710,53410,-990,-1.82,53540,-860,-1.58,52500,56000,1399-9-22
226,سدور,سيمان‌ دورود,2737,20715267,216430188370,10110,10610,10080,-30,-0.3,10450,340,3.36,9920,10610,1399-9-22
227,ارفع,شركت آهن و فولاد ارفع,2735,28440743,453180558903,15177,15935,15935,758,4.99,15934,757,4.99,15700,15935,1399-9-22
228,شمواد,توليد مواداوليه الياف مصنوعي,2719,2170596,137785146918,64947,66800,62999,-1948,-3.0,63478,-1469,-2.26,62999,66800,1399-9-22
229,غپاك,لبنيات‌ پاك‌,2712,15678253,249041006300,15170,15920,15920,750,4.94,15880,710,4.68,15400,15920,1399-9-22
230,دسبحان,سبحان دارو,2712,6074839,153828908640,26230,25760,25990,-240,-0.91,25320,-910,-3.47,24920,26230,1399-9-22
231,پرديس,سرمايه گذاري پرديس,2712,14719802,119498732910,8330,8490,8080,-250,-3.0,8120,-210,-2.52,7920,8490,1399-9-22
232,كبافق,معادن‌ بافق‌,2693,4756528,238741534920,47870,50250,50260,2390,4.99,50190,2320,4.85,49000,50260,1399-9-22
233,لخانه,لوازم‌ خانگي‌ پارس‌,2644,4528204,267331667347,57530,54654,60406,2876,5.0,59037,1507,2.62,54654,60406,1399-9-22
234,وثنو,سرمايه گذاري ساختماني نوين,2636,7784543,142058276191,18926,18950,17980,-946,-5.0,18249,-677,-3.58,17980,18950,1399-9-22
235,شدوص,دوده‌ صنعتي‌ پارس‌,2618,6645209,158118292680,24480,23800,23300,-1180,-4.82,23790,-690,-2.82,23260,25000,1399-9-22
236,ونيكي,سرمايه‌گذاري‌ ملي‌ايران‌,2612,11717160,231902264000,18860,19800,19800,940,4.98,19790,930,4.93,19330,19800,1399-9-22
237,غمارگ,مارگارين‌,2612,4851119,196834649010,39050,40480,40200,1150,2.94,40580,1530,3.92,39000,41000,1399-9-22
238,چافست,افست‌,2603,6457154,161336686520,24450,25000,24500,50,0.2,24990,540,2.21,24400,25660,1399-9-22
239,پلاسك,پلاسكوكار,2589,18796659,172448992900,8790,9100,9140,350,3.98,9170,380,4.32,8900,9220,1399-9-22
240,وآذر,سرمايه‌گذاري‌توسعه‌آذربايجان‌,2579,1387041,171036945520,126470,129800,121800,-4670,-3.69,123310,-3160,-2.5,120150,129800,1399-9-22
241,كترام,توليدي‌ كاشي‌ تكسرام‌,2577,3753104,143672798940,38430,39500,37300,-1130,-2.94,38280,-150,-0.39,36890,39500,1399-9-22
242,فافزا,فولاد افزا سپاهان,2538,2736090,117888531208,44212,45538,42888,-1324,-2.99,43086,-1126,-2.55,42886,45538,1399-9-22
243,آريان,سرمايه گذاري پارس آريان,2532,58514231,924175431501,15400,15400,15862,462,3.0,15794,394,2.56,15160,15862,1399-9-22
244,خمهر,مهركام‌پارس‌,2532,36561562,298974651760,7810,8180,7880,70,0.9,8180,370,4.74,7840,8200,1399-9-22
245,وسپه,سرمايه‌گذاري‌ سپه‌,2524,10176258,152286065710,14650,14660,14790,140,0.96,14960,310,2.12,14660,15170,1399-9-22
246,ومعلم,بيمه معلم,2515,10591374,90102708677,8504,8890,8250,-254,-2.99,8507,3,0.04,8130,8890,1399-9-22
247,فايرا,آلومينيوم‌ايران‌,2509,6428957,186342224580,28000,28850,28990,990,3.54,28980,980,3.5,27500,29400,1399-9-22
248,ثفارس,عمران‌وتوسعه‌فارس‌,2478,25424370,250615445650,9400,9870,9870,470,5.0,9860,460,4.89,9580,9870,1399-9-22
249,وسكاب,س.ص.بازنشستگي كاركنان بانكها,2473,18717981,135540976070,7030,7280,7130,100,1.42,7240,210,2.99,7060,7350,1399-9-22
250,فاما,صنعتي‌ آما,2470,4875386,142571235290,30250,30450,28740,-1510,-4.99,29240,-1010,-3.34,28740,30500,1399-9-22
251,لابسا,آبسال‌,2418,2790175,117880897280,43280,45290,41120,-2160,-4.99,42250,-1030,-2.38,41120,45400,1399-9-22
252,پكوير,كوير تاير,2396,6980828,139073539270,19080,19250,20030,950,4.98,19920,840,4.4,19250,20030,1399-9-22
253,زقيام,كشت و دام قيام اصفهان,2376,5361074,228437112641,41218,43278,41000,-218,-0.53,42610,1392,3.38,40850,43278,1399-9-22
254,دلقما,دارويي‌ لقمان‌,2371,5703439,191641764650,32240,33290,33200,960,2.98,33600,1360,4.22,32420,33850,1399-9-22
255,ستران,سيمان‌ تهران‌,2367,5174315,209297357310,38640,40570,39910,1270,3.29,40450,1810,4.68,39000,40570,1399-9-22
256,كلوند,كاشي‌ الوند,2362,5001487,150086889010,29080,30200,30530,1450,4.99,30010,930,3.2,27900,30530,1399-9-22
257,زفكا,كشت و دامداري فكا,2359,1692691,90974597437,54079,56100,52300,-1779,-3.29,53746,-333,-0.62,52190,56100,1399-9-22
258,شاراك,پتروشيمي شازند,2319,12959879,338248424730,24970,25100,26210,1240,4.97,26100,1130,4.53,25100,26210,1399-9-22
259,رنيك,جنرال مكانيك,2305,4333144,120853072495,27989,29000,27390,-599,-2.14,27890,-99,-0.35,26800,29000,1399-9-22
260,خوساز,محورسازان‌ايران‌خودرو,2292,17280714,144408346130,7990,8380,8380,390,4.88,8360,370,4.63,8140,8380,1399-9-22
261,وگستر,گسترش سرمايه گذاري ايرانيان,2286,8456564,208163777624,25499,25180,24480,-1019,-4.0,24616,-883,-3.46,24225,25940,1399-9-22
262,سخوز,سيمان خوزستان,2286,3912045,108522428120,26790,27780,27000,210,0.78,27740,950,3.55,26800,28110,1399-9-22
263,اميد,تامين سرمايه اميد,2276,10010644,141869572920,14510,14510,13790,-720,-4.96,14170,-340,-2.34,13790,14940,1399-9-22
264,شفن,پتروشيمي فناوران,2252,541798,182807370860,340350,352940,328050,-12300,-3.61,337410,-2940,-0.86,327010,352940,1399-9-22
265,افق,فروشگاههاي زنجيره اي افق كوروش,2242,1040684,85261402900,82150,83900,81240,-910,-1.11,81960,-190,-0.23,81160,83900,1399-9-22
266,شصدف,صنعتي دوده فام,2212,77303,2003771063,24687,25921,25921,1234,5.0,24734,47,0.19,25921,25921,1399-9-22
267,گشان,توسعه بين المللي پديده شانديز,2210,2291776,159505317824,72498,69599,69599,-2899,-4.0,69599,-2899,-4.0,69599,69599,1399-9-22
268,ولبهمن,شركت بهمن ليزينگ,2177,15299058,171723423407,11574,11585,11001,-573,-4.95,11224,-350,-3.02,10996,11810,1399-9-22
269,دسبحا,گروه دارويي سبحان,2164,4954866,119384847260,24350,24810,23290,-1060,-4.35,24090,-260,-1.07,23150,25000,1399-9-22
270,كقزوي,شيشه‌ قزوين‌,2149,14402005,128023502137,8748,9010,9010,262,2.99,8889,141,1.61,8486,9010,1399-9-22
271,شاوان,پالايش نفت لاوان,2143,1507989,170611555366,116571,118000,110743,-5828,-5.0,113138,-3433,-2.94,110743,119999,1399-9-22
272,ثامان,سامان‌ گستراصفهان‌,2142,5048489,123691872340,24770,25890,23700,-1070,-4.32,24500,-270,-1.09,23540,25890,1399-9-22
273,اتكام,شركت بيمه اتكايي امين,2111,44733586,362791325557,7726,8112,8112,386,5.0,8110,384,4.97,7911,8112,1399-9-22
274,خفناور,مهندسي صنعتي روان فن آور,2104,4619702,132565774362,28980,29849,28111,-869,-3.0,28696,-284,-0.98,28111,29849,1399-9-22
275,فلوله,لوله‌وماشين‌سازي‌ايران‌,2097,7545510,194230337090,24910,25990,25290,380,1.53,25740,830,3.33,24910,26150,1399-9-22
276,كوثر,بيمه كوثر,2087,31093699,691961416935,21237,22298,22298,1061,5.0,22254,1017,4.79,21276,22298,1399-9-22
277,سرچشمه,سرمايه گذاري مس سرچشمه,2085,10579042,96197048844,9081,9350,8989,-92,-1.01,9093,12,0.13,8650,9400,1399-9-22
278,كطبس,ذغال‌سنگ‌ نگين‌ ط‌بس‌,2084,2182630,148459897240,70210,69010,66770,-3440,-4.9,68020,-2190,-3.12,66700,72990,1399-9-22
279,چفيبر,فيبر ايران‌,2083,17596953,149167796870,8100,8400,8500,400,4.94,8480,380,4.69,8210,8500,1399-9-22
280,توريل,توکاريل,2081,8180199,199952926565,23297,24461,24461,1164,5.0,24444,1147,4.92,23521,24461,1399-9-22
281,شكربن,كربن‌ ايران‌,2081,2090761,191559819510,95560,93000,90790,-4770,-4.99,91620,-3940,-4.12,90790,96800,1399-9-22
282,فبيرا,بسته‌ بندي‌ ايران‌,2077,25992152,133664836258,4998,5147,5147,149,2.98,5143,145,2.9,5025,5147,1399-9-22
283,اعتماد,صندوق س.اعتماد آفرين پارسيان-د,2047,55071720,1860439545880,33733,33780,33780,47,0.14,33782,49,0.15,33780,33790,1399-9-22
284,ثالوند,سرمايه گذاري مسكن الوند,2043,7416469,128423467309,17196,17350,17320,124,0.72,17316,120,0.7,16490,17850,1399-9-22
285,حآسا,آسيا سير ارس,2032,9011059,244962891176,25938,26200,27234,1296,5.0,27185,1247,4.81,26200,27234,1399-9-22
286,آپ,آسان پرداخت پرشين,2018,6423307,128441291660,19080,19800,20030,950,4.98,20000,920,4.82,19790,20030,1399-9-22
287,كنور,توسعه معدني و صنعتي صبانور,2016,7703434,380632722690,47280,47320,48200,920,1.95,49410,2130,4.51,47280,49640,1399-9-22
288,دابور,داروسازي‌ ابوريحان‌,2000,2082318,103226195580,50770,50900,48250,-2520,-4.96,49570,-1200,-2.36,48240,51700,1399-9-22
289,شبهرن,نفت‌ بهران‌,1998,3068592,194405458510,63190,65500,62640,-550,-0.87,63350,160,0.25,62410,65500,1399-9-22
290,دشيمي,شيمي‌ داروئي‌ داروپخش‌,1994,8341610,516707754660,59020,60000,61970,2950,5.0,61940,2920,4.95,59900,61970,1399-9-22
291,ثشرق,سرمايه گذاري مسكن شمال شرق,1974,16618391,107875620730,6310,6620,6280,-30,-0.48,6490,180,2.85,6230,6620,1399-9-22
292,فولاژ,فولاد آلياژي ايران,1968,5231861,148370914960,27190,28400,26600,-590,-2.17,28360,1170,4.3,26550,28540,1399-9-22
293,فسازان,غلتك سازان سپاهان,1955,8929319,335044455720,35920,37710,37200,1280,3.56,37520,1600,4.45,34130,37710,1399-9-22
294,كخاك,صنايع‌خاك‌چيني‌ايران‌,1936,3531968,189226613620,54090,56780,51390,-2700,-4.99,53580,-510,-0.94,51390,56780,1399-9-22
295,وحكمت,بيمه حكمت صبا,1927,19825126,123290552330,6175,6360,5990,-185,-3.0,6219,44,0.71,5990,6360,1399-9-22
296,سيدكو,سرمايه گذاري توسعه صنايع سيمان,1918,11413476,102256640810,9110,9150,8800,-310,-3.4,8960,-150,-1.65,8700,9380,1399-9-22
297,رتكو,كنترل‌خوردگي‌تكين‌كو,1917,15640858,322235624840,19630,20610,20590,960,4.89,20600,970,4.94,20000,20610,1399-9-22
298,طلا,صندوق س.پشتوانه طلاي لوتوس,1913,852087,75959404457,92392,92000,88102,-4290,-4.64,89145,-3247,-3.51,88000,92000,1399-9-22
299,وبشهر,توسعه‌ صنايع‌ بهشهر(هلدينگ,1896,7177895,125124826360,17990,18000,17110,-880,-4.89,17430,-560,-3.11,17100,18500,1399-9-22
300,شپديس,پتروشيمي پرديس,1896,1759715,193363765480,109810,112000,108560,-1250,-1.14,109880,70,0.06,108560,113000,1399-9-22
301,فخاس,فولاد خراسان,1892,2016577,72369585910,36360,36450,34750,-1610,-4.43,36010,-350,-0.96,34600,37490,1399-9-22
302,فباهنر,مس‌ شهيدباهنر,1880,2411007,133105418020,53080,54420,54470,1390,2.62,55210,2130,4.01,53010,55730,1399-9-22
303,وايرا,سرمايه گذاري صنايع ايران,1869,16120021,150726295177,9180,9455,9455,275,3.0,9350,170,1.85,8905,9455,1399-9-22
304,دفارا,داروسازي‌ فارابي‌,1823,2742118,182418142660,67780,70300,66690,-1090,-1.61,66520,-1260,-1.86,64420,70300,1399-9-22
305,ددام,داروسازي زاگرس فارمد پارس,1818,5602993,99734959610,17460,18330,16950,-510,-2.92,17800,340,1.95,16730,18330,1399-9-22
306,حتايد,تايدواترخاورميانه,1817,9137870,205930158580,21560,22630,22620,1060,4.92,22540,980,4.55,21650,22630,1399-9-22
307,سپاها,سيمان‌سپاهان‌,1813,13317021,130587475790,9360,9820,9620,260,2.78,9810,450,4.81,9380,9820,1399-9-22
308,دجابر,داروسازي‌ جابرابن‌حيان‌,1810,2513105,124963701090,49060,51510,48500,-560,-1.14,49720,660,1.35,48000,51510,1399-9-22
309,شتوكا,توكا رنگ فولاد سپاهان,1789,2248244,100544202928,43103,43935,45258,2155,5.0,44721,1618,3.75,42930,45258,1399-9-22
310,تسه9908,امتياز تسهيلات مسكن آبان99,1779,39907,24007441867,602934,605000,600000,-2934,-0.49,601585,-1349,-0.22,585080,605000,1399-9-22
311,وبهمن,سرمايه‌گذاري‌بهمن‌,1774,5922084,126665735650,21290,22100,21450,160,0.75,21390,100,0.47,20600,22340,1399-9-22
312,امين يكم,صندوق درآمد ثابت امين يكم فردا,1744,58029250,593530862349,10220,10228,10230,10,0.1,10228,8,0.08,10220,10233,1399-9-22
313,قجام,فرآوردههاي غذايي وقندتربت‌جام‌,1743,8666919,111373762932,12298,12912,12790,492,4.0,12850,552,4.49,12500,12912,1399-9-22
314,شپاكسا,پاكسان‌,1743,3127902,101979251980,32620,33490,31750,-870,-2.67,32600,-20,-0.06,31500,33600,1399-9-22
315,فجر,فولاد اميركبيركاشان,1734,1953983,132214828970,65250,66550,66690,1440,2.21,67660,2410,3.69,65250,68400,1399-9-22
316,شخارك,پتروشيمي‌ خارك‌,1733,2749568,130033629190,45450,45100,47650,2200,4.84,47290,1840,4.05,45100,47720,1399-9-22
317,شبصير,توليدات پتروشيمي قائد بصير,1720,3343139,436078629933,124301,130514,130516,6215,5.0,130440,6139,4.94,125800,130516,1399-9-22
318,بهپاك,صنعتي بهپاك,1708,3385370,158879559323,44791,47030,47030,2239,5.0,46931,2140,4.78,45840,47030,1399-9-22
319,تنوين,تامين سرمايه نوين,1707,18694060,142992362840,7520,7650,7440,-80,-1.06,7650,130,1.73,7310,7810,1399-9-22
320,شپاس,نفت پاسارگاد,1701,25877482,619188125311,22856,23998,23100,244,1.07,23928,1072,4.69,21714,23998,1399-9-22
321,پخش,پخش البرز,1698,2559730,114545831711,46303,44700,43988,-2315,-5.0,44749,-1554,-3.36,43988,46490,1399-9-22
322,مارون,پتروشيمي مارون,1694,631021,94666967291,155597,154000,147818,-7779,-5.0,150123,-5474,-3.52,147818,155500,1399-9-22
323,غبشهر,صنعتي‌ بهشهر,1688,3509234,97541549920,28280,27700,27450,-830,-2.93,27800,-480,-1.7,26900,29450,1399-9-22
324,كهمداح,ح . شيشه‌ همدان‌,1669,5646683,64282778750,11980,11980,11130,-850,-7.1,11380,-600,-5.01,10920,12110,1399-9-22
325,وهنر,گروه توسعه هنر ايران,1648,16045551,84066874197,5290,5400,5132,-158,-2.99,5239,-51,-0.96,5132,5400,1399-9-22
326,بميلا,توسعه بازرگاني آهن وفولادميلاد,1624,4995423,111983337934,21928,22880,21700,-228,-1.04,22417,489,2.23,21000,22950,1399-9-22
327,وكادو,تكادو,1614,5866510,130532517461,22430,22880,21758,-672,-3.0,22250,-180,-0.8,21758,23102,1399-9-22
328,پارس,پتروشيمي پارس,1607,1099765,174513108120,158520,159000,156620,-1900,-1.2,158680,160,0.1,156500,161390,1399-9-22
329,وپارس,بانك‌پارسيان‌,1598,59825954,266823754840,4250,4460,4460,210,4.94,4460,210,4.94,4460,4460,1399-9-22
330,خچرخش,چرخشگر,1593,5123324,99100134330,19140,19900,18910,-230,-1.2,19340,200,1.04,18910,19940,1399-9-22
331,غنوش,نوش‌ مازندران‌,1584,1994404,133086578920,63560,66730,66730,3170,4.99,66730,3170,4.99,66730,66730,1399-9-22
332,گوهران,سرمايه گذاري توسعه گوهران اميد,1570,5476832,52473500668,9791,9791,9310,-481,-4.91,9581,-210,-2.14,9305,9970,1399-9-22
333,افرا,افرانت,1567,3382679,162695603965,45851,45732,48143,2292,5.0,48097,2246,4.9,45732,48143,1399-9-22
334,غشصفا,شيرپاستوريزه‌پگاه‌اصفهان‌,1566,4079458,130167379080,30580,32100,32100,1520,4.97,31910,1330,4.35,30250,32100,1399-9-22
335,تابا,تابان نيرو سپاهان,1563,2873882,88801898919,30766,31688,30350,-416,-1.35,30900,134,0.44,29844,31688,1399-9-22
336,آوا,صندوق س.سهام آواي معيار-س,1540,10247808,101920819414,9680,9800,9850,170,1.76,9946,266,2.75,9782,10095,1399-9-22
337,وصنا,گروه‌صنايع‌بهشهرايران‌,1536,11462366,158889146990,13210,13550,13870,660,5.0,13860,650,4.92,13550,13870,1399-9-22
338,شراز,پالايش نفت شيراز,1517,914885,113913501346,128055,133000,121653,-6402,-5.0,124511,-3544,-2.77,121653,133000,1399-9-22
339,خمحور,توليدمحورخودرو,1509,2246482,151605959270,65720,64240,69000,3280,4.99,67490,1770,2.69,63350,69000,1399-9-22
340,زنگان,صنعت روي زنگان,1501,698873,77702893115,107980,113300,109000,1020,0.94,111183,3203,2.97,108651,113300,1399-9-22
341,شوينده,مديريت صنعت شوينده ت.ص.بهشهر,1497,2606786,105872278200,41150,41150,40150,-1000,-2.43,40610,-540,-1.31,39700,41800,1399-9-22
342,قشكر,شكرشاهرود,1483,2588891,126237993300,46600,48920,48310,1710,3.67,48760,2160,4.64,47000,48930,1399-9-22
343,وتعاون,بيمه  تعاون,1474,9827202,77088148526,7618,7750,7737,119,1.56,7844,226,2.97,7634,7998,1399-9-22
344,وخاور,بانك خاورميانه,1470,10100802,113318239460,11070,11490,11050,-20,-0.18,11220,150,1.36,11050,11490,1399-9-22
345,خفنر,فنرسازي‌خاور,1460,5488856,125757608470,21970,23060,22400,430,1.96,22910,940,4.28,22000,23060,1399-9-22
346,وتوسم,سرمايه‌گذاري‌توسعه‌ملي‌,1431,6032317,87386660410,14220,14500,14200,-20,-0.14,14490,270,1.9,14150,14890,1399-9-22
347,دسانكو,داروسازي سبحان انكولوژي,1426,3276186,62850714385,19090,20000,18530,-560,-2.93,19184,94,0.49,18220,20000,1399-9-22
348,فن آوا,گروه فن آوا,1426,4862848,68536314791,13982,14401,13760,-222,-1.59,14094,112,0.8,13563,14401,1399-9-22
349,غشان,شيرپاستوريزه‌پگاه‌خراسان‌,1406,13073168,122694624240,8950,9390,9390,440,4.92,9390,440,4.92,9050,9390,1399-9-22
350,تماوند,تامين سرمايه دماوند,1391,11920957,179746559408,15106,15000,15320,214,1.42,15078,-28,-0.19,14720,15650,1399-9-22
351,كرماشا,صنايع پتروشيمي كرمانشاه,1385,1771001,77349717330,43330,44000,43380,50,0.12,43680,350,0.81,42510,45000,1399-9-22
352,بنيرو,نيروترانس‌,1384,1363780,79435787910,56780,59290,56700,-80,-0.14,58250,1470,2.59,56180,59610,1399-9-22
353,سكرد,سيمان كردستان,1378,6766218,67307615170,9760,9990,9700,-60,-0.61,9950,190,1.95,9610,10200,1399-9-22
354,غشوكو,شوكو پارس,1354,3227619,140372143401,43040,41749,44331,1291,3.0,43491,451,1.05,41749,44331,1399-9-22
355,وسبحان,سرمايه گذاري سبحان,1353,9268617,84980668979,9068,9250,9090,22,0.24,9169,101,1.11,9050,9350,1399-9-22
356,سفارود,كارخانه فارسيت درود,1351,7074393,75589256778,10670,10883,10457,-213,-2.0,10685,15,0.14,10457,10883,1399-9-22
357,حبندر,دريايي و کشتيراني خط دريابندر,1351,2752377,92754638564,32824,33808,33808,984,3.0,33700,876,2.67,32844,33808,1399-9-22
358,وملت,سرمايه گذاري ملت,1349,12026267,51355326569,4200,4284,4284,84,2.0,4270,70,1.67,4195,4284,1399-9-22
359,سمگا,گروه سرمايه گذاري ميراث فرهنگي,1344,13404420,399733208820,28401,29821,29821,1420,5.0,29821,1420,5.0,29821,29821,1399-9-22
360,ثنظام,س. ساختماني نظام مهندسي ايران,1343,2097289,98352563245,45335,47601,45900,565,1.25,46895,1560,3.44,43069,47601,1399-9-22
361,دتماد,توليدمواداوليه‌داروپخش‌,1342,2606960,138736993540,55690,54100,52910,-2780,-4.99,53220,-2470,-4.44,52910,55700,1399-9-22
362,سمازن,سيمان‌مازندران‌,1337,7245488,88518683500,11700,12000,12040,340,2.91,12220,520,4.44,11760,12280,1399-9-22
363,دامين,داروسازي‌ امين‌,1319,3761948,60734491430,16000,16390,15770,-230,-1.44,16140,140,0.88,15620,16630,1399-9-22
364,غشاذر,پگاه‌آذربايجان‌غربي‌,1315,2662436,58022662680,21750,22810,21070,-680,-3.13,21790,40,0.18,20990,22810,1399-9-22
365,غاذر,كشت‌وصنعت‌پياذر,1299,1512088,144138306360,91170,94050,94500,3330,3.65,95320,4150,4.55,92000,95720,1399-9-22
366,غشهد,شهد ايران ‌,1298,9793113,77717505770,7580,7660,7800,220,2.9,7940,360,4.75,7660,7950,1399-9-22
367,ولتجار,واسپاري تجارت وسرمايه ايرانيان,1292,9396394,68269274588,7288,7506,7070,-218,-2.99,7265,-23,-0.32,7070,7506,1399-9-22
368,زشريف,كشت وصنعت شريف آباد,1288,4245115,118091920811,26533,27859,27840,1307,4.93,27818,1285,4.84,27200,27859,1399-9-22
369,پارند,صندوق س. پارند پايدار سپهر,1280,47861385,539689028904,11250,11275,11272,22,0.2,11276,26,0.23,11270,11300,1399-9-22
370,وپسا,س. پتروشيمي ساختمان  خليج فارس,1278,16094004,65093834726,3943,4059,4061,118,2.99,4045,102,2.59,4000,4061,1399-9-22
371,دسينا,داروسازي‌ سينا,1262,1668243,54675321000,32960,34550,31370,-1590,-4.82,32770,-190,-0.58,31320,34550,1399-9-22
372,كمينا,شيشه سازي مينا,1252,2088065,84320373079,40056,42058,38054,-2002,-5.0,40382,326,0.81,38054,42058,1399-9-22
373,كاذر,فرآورده‌هاي‌نسوزآذر,1251,4564344,107374130130,22660,23790,22640,-20,-0.09,23520,860,3.8,22000,23790,1399-9-22
374,واميد,گروه مديريت سرمايه گذاري اميد,1239,2992668,118413953950,39110,39110,39890,780,1.99,39560,450,1.15,38010,40300,1399-9-22
375,پلاست,كارخانجات توليدي پلاستيران,1239,1514537,64850900587,41596,42843,42843,1247,3.0,42819,1223,2.94,41596,42843,1399-9-22
376,شفارا,پتروشيمي فارابي,1226,12056320,60900869453,4916,5040,5063,147,2.99,5051,135,2.75,4970,5063,1399-9-22
377,تاصيكو,سرمايه گذاري صدرتامين,1200,31631045,382342851270,11530,11530,12100,570,4.94,12090,560,4.86,11410,12100,1399-9-22
378,شگل,گلتاش‌,1197,2537156,73059639590,29320,29320,28020,-1300,-4.43,28800,-520,-1.77,27860,29980,1399-9-22
379,كاذرح,ح . فرآورده‌هاي‌نسوزآذر,1195,2691733,52084157930,19550,20320,18310,-1240,-6.34,19350,-200,-1.02,18010,20450,1399-9-22
380,ركيش,كارت اعتباري ايران كيش,1194,5958278,103648489530,17050,17200,17900,850,4.99,17400,350,2.05,17000,17900,1399-9-22
381,مداران,داده‌پردازي‌ايران‌,1191,3266764,92102482910,26960,28300,27320,360,1.34,28190,1230,4.56,26960,28300,1399-9-22
382,زكشت,كشاورزي مكانيزه اصفهان كشت,1188,3398277,114558963615,32110,33715,33715,1605,5.0,33711,1601,4.99,33298,33715,1399-9-22
383,لخزر,پارس‌ خزر,1169,719910,145220495530,196220,204000,206030,9810,5.0,201720,5500,2.8,196000,206030,1399-9-22
384,جم پيلن,پلي پروپيلن جم - جم پيلن,1164,2638235,234269987660,85420,86100,86990,1570,1.84,88800,3380,3.96,81150,89690,1399-9-22
385,شاروم,پتروشيمي اروميه,1158,723438,21415211676,28193,29602,29602,1409,5.0,28768,575,2.04,29602,29602,1399-9-22
386,غمهراح,ح . توليدي‌مهرام‌,1157,993376,61062142980,56480,60000,62130,5650,10.0,61470,4990,8.83,57100,62130,1399-9-22
387,تيپيكو,سرمايه گذاري دارويي تامين,1155,1238864,74126150630,59600,60880,58830,-770,-1.29,59770,170,0.29,58510,61000,1399-9-22
388,چكارن,كارتن‌ ايران‌,1139,11799651,53090747800,4290,4490,4500,210,4.9,4500,210,4.9,4490,4500,1399-9-22
389,سخزر,سيمان‌ خزر,1110,2069121,61831492040,29340,28150,28800,-540,-1.84,29880,540,1.84,27880,30790,1399-9-22
390,قزوين,كارخانجات‌ قند قزوين‌,1097,1269355,53520252580,42670,43000,41350,-1320,-3.09,42160,-510,-1.2,41350,43520,1399-9-22
391,بايكا,كارخانجات كابلسازي ‌ايران‌,1092,1811235,114554434340,61405,63247,63247,1842,3.0,63247,1842,3.0,63240,63247,1399-9-22
392,دالبر,البرزدارو,1073,2379852,57754390170,24960,24390,23920,-1040,-4.17,24270,-690,-2.76,23800,25680,1399-9-22
393,لوتوس,تامين سرمايه لوتوس پارسيان,1064,2863271,44215416670,15220,15890,15120,-100,-0.66,15400,180,1.18,15100,15890,1399-9-22
394,ساروم,سيمان‌اروميه‌,1061,2113972,60244339140,27920,29290,28280,360,1.29,28500,580,2.08,27170,29290,1399-9-22
395,وتوشه,سرمايه‌ گذاري‌ پارس‌ توشه‌,1057,2020344,51155455460,24860,25980,25250,390,1.57,25320,460,1.85,24870,26000,1399-9-22
396,اوان,مبين وان كيش,1057,1154649,71205751364,63328,64399,60162,-3166,-5.0,61669,-1659,-2.62,60162,64399,1399-9-22
397,شرانل,نفت ايرانول,1055,1562611,58460438354,37391,37391,37250,-141,-0.38,37412,21,0.06,36020,38230,1399-9-22
398,ساراب,سيمان‌ داراب‌,1046,4078547,56749212360,14240,13950,13540,-700,-4.92,13910,-330,-2.32,13530,14770,1399-9-22
399,دعبيد,لابراتوارداروسازي‌  دكترعبيدي‌,1044,1198903,40435952220,33350,34870,32630,-720,-2.16,33600,250,0.75,32620,34870,1399-9-22
400,بالبر,كابل‌ البرز,1034,3288453,88291426980,25580,26850,26850,1270,4.96,26850,1270,4.96,26600,26850,1399-9-22
401,كاريس,صندوق س.سپهر كاريزما-س,1031,407540,89323257810,216577,217500,218000,1423,0.66,219177,2600,1.2,214170,221999,1399-9-22
402,كپرور,فرآوري زغال سنگ پروده طبس,1029,1351650,62899748929,45760,47000,45020,-740,-1.62,46536,776,1.7,45010,48000,1399-9-22
403,كاردان,صندوق س تجارت شاخصي كاردان,1027,590438,114226682150,191790,192500,191990,200,0.1,193460,1670,0.87,190900,194990,1399-9-22
404,بخاور,بيمه زندگي خاورميانه,1023,9619995,95817427688,9584,9970,10063,479,5.0,9960,376,3.92,9600,10063,1399-9-22
405,غدشت,دشت‌ مرغاب‌,1020,310824,82770630300,264200,270000,260000,-4200,-1.59,266290,2090,0.79,260000,276000,1399-9-22
406,حپترو,حمل و نقل پتروشيمي( سهامي عام,1013,1845362,54027046480,29990,31460,28500,-1490,-4.97,29280,-710,-2.37,28500,31460,1399-9-22
407,پسهند,صنايع‌ لاستيكي‌  سهند,1009,2094231,93821845090,42840,43980,44980,2140,5.0,44800,1960,4.58,42850,44980,1399-9-22
408,كفرآور,فرآورده هاي سيمان شرق,1008,3599229,70480421334,19027,19597,19390,363,1.91,19582,555,2.92,19200,19597,1399-9-22
409,هرمز,فولاد هرمزگان جنوب,1007,14285230,210135733300,14010,14710,14710,700,5.0,14710,700,5.0,14710,14710,1399-9-22
410,فلامي,لاميران‌,1007,1710153,72486667160,40390,42400,42400,2010,4.98,42390,2000,4.95,41720,42400,1399-9-22
411,درازك,دارويي‌ رازك‌,994,1662961,74767324310,45290,44000,45000,-290,-0.64,44960,-330,-0.73,44000,46880,1399-9-22
412,سجام,مجتمع سيمان غرب آسيا,993,3166446,46449934664,14906,14459,14459,-447,-3.0,14669,-237,-1.59,14459,15250,1399-9-22
413,شاملا,معدني‌ املاح‌  ايران‌,991,1630992,116890234710,68260,71670,71610,3350,4.91,71670,3410,5.0,71600,71670,1399-9-22
414,سكرما,سيمان‌ كرمان‌,980,4117462,72664090510,16880,17720,17720,840,4.98,17650,770,4.56,17200,17720,1399-9-22
415,غالبر,لبنيات‌ كالبر,980,9112960,121882556000,12750,13380,13380,630,4.94,13370,620,4.86,12950,13380,1399-9-22
416,شساخت,مهندسي و ساختمان صنايع نفت,979,4444971,209074098867,45831,47200,47205,1374,3.0,47036,1205,2.63,44457,47205,1399-9-22
417,پكرمان,گروه‌ صنعتي‌ بارز,978,4330155,144737330650,31910,32870,33500,1590,4.98,33430,1520,4.76,31930,33500,1399-9-22
418,بفجر,فجر انرژي خليج فارس,955,1632592,50183470870,30230,31600,30220,-10,-0.03,30550,320,1.06,30220,31600,1399-9-22
419,تكنو,تكنوتار,953,3794899,58514396320,14690,15420,15420,730,4.97,15420,730,4.97,15300,15420,1399-9-22
420,قچار,فراوردههاي غذايي وقند چهارمحال,940,1147993,72754933294,66192,63170,62883,-3309,-5.0,63376,-2816,-4.25,62883,65000,1399-9-22
421,واعتبار,سرمايه گذاري اعتبار ايران,932,9183994,57327100820,6190,6400,6230,40,0.65,6240,50,0.81,6200,6400,1399-9-22
422,فلات,گروه صنايع معادن فلات ايرانيان,929,15423489,263770910728,16290,17104,17104,814,5.0,17102,812,4.98,16700,17104,1399-9-22
423,غسالم,سالمين‌,912,14507950,91835323500,6030,6330,6330,300,4.98,6330,300,4.98,6330,6330,1399-9-22
424,كيان,صندوق س. با درآمد ثابت كيان,897,26149975,687080176106,26242,26275,26279,37,0.14,26275,33,0.13,26266,26280,1399-9-22
425,سغرب,سيمان‌غرب‌,892,2142486,44288220770,21030,22080,20700,-330,-1.57,20710,-320,-1.52,19980,22080,1399-9-22
426,كمنگنز,معادن‌منگنزايران‌,888,494290,49497883570,102590,103800,99820,-2770,-2.7,100140,-2450,-2.39,99700,103800,1399-9-22
427,زپارس,ملي كشت و صنعت و دامپروري پارس,883,753319,68498824010,87050,91400,90950,3900,4.48,90930,3880,4.46,87220,91400,1399-9-22
428,عيار,صندوق س. پشتوانه طلاي مفيد,882,824806,25216204587,31594,31300,30370,-1224,-3.87,30572,-1022,-3.23,30200,31300,1399-9-22
429,سفار,سيمان‌فارس‌,873,655097,67872483920,98700,103630,103630,4930,4.99,103610,4910,4.97,102000,103630,1399-9-22
430,دارا,صندوق س. دارا الگوريتم-د,864,37076665,372916881637,10050,10068,10055,5,0.05,10058,8,0.08,10047,10068,1399-9-22
431,حاريا,كشتيراني آريا,850,3938118,118249354495,28986,30435,29230,244,0.84,30027,1041,3.59,28142,30435,1399-9-22
432,سبهان,سيمان‌ بهبهان‌,850,637688,42731610780,64000,67200,67190,3190,4.98,66460,2460,3.84,65450,67200,1399-9-22
433,وثخوز,سرمايه گذاري و توسعه خوزستان,841,1115185,56076113731,48554,50981,50981,2427,5.0,50284,1730,3.56,46500,50981,1399-9-22
434,كشرق,صنعتي و معدني شمال شرق شاهرود,838,514969,42430227501,81764,84000,81900,136,0.17,82294,530,0.65,78874,85341,1399-9-22
435,خپويش,سازه‌ پويش‌,838,1279118,50885881680,38840,39490,38890,50,0.13,39780,940,2.42,38840,40610,1399-9-22
436,وتوصا,گروه س توسعه صنعتي ايران,828,3762173,63091641210,15980,16770,16770,790,4.94,16770,790,4.94,16770,16770,1399-9-22
437,سفانو,سيمان فارس نو,812,1307167,46983002130,35550,36000,36100,550,1.55,35910,360,1.01,35550,37000,1399-9-22
438,رتاپ,تجارت الكترونيك  پارسيان,804,6963606,54584866850,7480,7500,7850,370,4.95,7840,360,4.81,7500,7850,1399-9-22
439,اطلس,صندوق س.توسعه اندوخته آينده-س,793,182267,39454651492,213854,215800,215519,1665,0.78,216466,2612,1.22,215511,217980,1399-9-22
440,ثاژن,سخت آژند,787,6759813,54488217250,8147,8280,8000,-147,-1.8,8061,-86,-1.06,7985,8280,1399-9-22
441,فيروزه,صندوق شاخص30 شركت فيروزه- سهام,785,383144,72678956570,187450,190000,188360,910,0.49,189690,2240,1.19,188360,191000,1399-9-22
442,قلرست,قند لرستان‌,784,1071725,28221208260,26630,27400,25720,-910,-3.42,26460,-170,-0.64,25700,27400,1399-9-22
443,شيراز,پتروشيمي‌شيراز,783,1005991,59502669340,59940,59940,58120,-1820,-3.04,59460,-480,-0.8,58110,60150,1399-9-22
444,ثعتما,س. ساختماني اعتماد گستر,771,1241272,54472169642,42872,44000,43210,338,0.79,43884,1012,2.36,43000,44158,1399-9-22
445,نيرو,نيرو سرمايه,763,822359,41998360034,49944,51442,51400,1456,2.92,51071,1127,2.26,48600,51442,1399-9-22
446,شنفت,نفت‌ پارس‌,753,758892,45838269260,61290,61000,59800,-1490,-2.43,60620,-670,-1.09,58240,62800,1399-9-22
447,سشمال,سيمان‌ شمال‌,752,3828619,37424706230,9340,9400,9680,340,3.64,9650,310,3.32,9400,9800,1399-9-22
448,غبهار,كشت وصنعت بهاران گلبهار خراسان,744,1772454,83778583218,45891,47267,47267,1376,3.0,47267,1376,3.0,47267,47267,1399-9-22
449,ولصنم,ليزينگ‌صنعت‌ومعدن‌,742,6297658,72870736650,12100,12440,11680,-420,-3.47,11570,-530,-4.38,11500,12440,1399-9-22
450,كساپا,سايپاشيشه‌,741,3080015,89320056340,27620,29000,29000,1380,5.0,29000,1380,5.0,28280,29000,1399-9-22
451,دلر,داروسازي‌ اكسير,738,852721,105373925000,117960,118100,123830,5870,4.98,123570,5610,4.76,118100,123850,1399-9-22
452,سنير,سيمان‌ سفيد ني‌ريز,735,764722,67426099700,84290,85980,88500,4210,4.99,88170,3880,4.6,84500,88500,1399-9-22
453,زر,صندوق س.پشتوانه سكه طلاي زر,720,676061,34865668734,53181,52105,50669,-2512,-4.72,51572,-1609,-3.03,50521,52200,1399-9-22
454,ضفلا1157,اختيارخ فولاد-18000-1399/11/28,691,30178,28313325000,1044,1115,1059,15,1.44,938,-106,-10.15,600,1500,1399-9-22
455,سمايه,بانك سرمايه,687,4094009,34880956680,8272,8520,8520,248,3.0,8520,248,3.0,8520,8520,1399-9-22
456,غويتا,ويتانا,686,2477839,124974765643,48036,50437,50437,2401,5.0,50437,2401,5.0,50437,50437,1399-9-22
457,حخزر,كشتيراني درياي خزر,677,2492128,64966594529,24893,25480,26137,1244,5.0,26069,1176,4.72,25480,26137,1399-9-22
458,اتكاي,بيمه اتكايي ايرانيان,675,2736775,41794453361,15104,15200,15390,286,1.89,15242,138,0.91,14650,15450,1399-9-22
459,وثوق,سرمايه گذاري وثوق امين,658,1828765,22323760783,12448,12500,12075,-373,-3.0,12207,-241,-1.94,12075,12740,1399-9-22
460,آساس,صندوق س.آسمان آرماني سهام-س,656,471045,84971758476,177548,179500,180698,3150,1.77,180390,2842,1.6,178000,181999,1399-9-22
461,سباقر,سيمان باقران,651,2746271,44545920184,15470,16243,16243,773,5.0,16221,751,4.85,15579,16243,1399-9-22
462,نمرينو,ايران‌ مرينوس‌,650,1013723,60906635160,57230,60090,60090,2860,5.0,60080,2850,4.98,58100,60090,1399-9-22
463,قمرو,قند مرودشت‌,648,845049,24431402590,28960,28010,28850,-110,-0.38,28940,-20,-0.07,28010,29700,1399-9-22
464,وسرمد,بيمه  سرمد,645,19282919,150153896507,7417,7787,7787,370,4.99,7787,370,4.99,7660,7787,1399-9-22
465,فنوال,نورد آلومينيوم‌,644,4130865,129709161000,29910,31400,31400,1490,4.98,31400,1490,4.98,31400,31400,1399-9-22
466,وآرين,شركت توسعه اقتصادي آرين,643,4893838,28544422813,5664,5833,5833,169,2.98,5833,169,2.98,5771,5833,1399-9-22
467,قهكمت,قندهكمتان‌,643,782910,41626608020,52380,52620,52420,40,0.08,53030,650,1.24,52420,53990,1399-9-22
468,داسوه,داروسازي‌ اسوه‌,641,923867,27322184380,30270,30440,29200,-1070,-3.53,29880,-390,-1.29,28900,30500,1399-9-22
469,شفا,سرمايه گذاري شفادارو,641,546102,34118162510,62470,61610,60300,-2170,-3.47,62470,0,0.0,60000,63920,1399-9-22
470,وسكرد,شركت س استان كردستان,640,27648488,22506155300,840,810,810,-30,-3.57,830,-10,-1.19,810,830,1399-9-22
471,دپارس,پارس‌ دارو,633,280515,28915538770,104640,104500,102400,-2240,-2.14,103720,-920,-0.88,101520,105970,1399-9-22
472,دمعيار,صندوق س. توازن معيار-د,631,31395549,317173293493,10093,10110,10100,7,0.07,10102,9,0.09,10100,10110,1399-9-22
473,ضخود1044,اختيارخ خودرو-4000-1399/10/07,631,20980,8730530000,448,433,370,-78,-17.41,416,-32,-7.14,362,465,1399-9-22
474,سفاسي,شركت فارسيت اهواز,625,3816771,57488204802,14624,15062,15062,438,3.0,15062,438,3.0,15062,15062,1399-9-22
475,بشهاب,لامپ‌  پارس‌ شهاب‌,596,451050,34535980210,72950,76590,76590,3640,4.99,75330,2380,3.26,74220,76590,1399-9-22
476,افق ملت,صندوق س در سهام افق ملت,591,215266,32166700100,147260,149700,148800,1540,1.05,149430,2170,1.47,147300,151300,1399-9-22
477,ولملت,واسپاري ملت,575,1599210,18146778250,11420,11800,11300,-120,-1.05,11390,-30,-0.26,11010,11860,1399-9-22
478,دكيمي,كيميدارو,573,930848,26799951770,28750,29480,28400,-350,-1.22,28770,20,0.07,28120,29500,1399-9-22
479,وسديد,گروه ‌صنعتي‌سديد,572,8361546,199314172002,23143,23837,23837,694,3.0,23837,694,3.0,23837,23837,1399-9-22
480,سلار,شركت سيمان لارستان,571,1971670,79601084564,38795,40734,40734,1939,5.0,40372,1577,4.06,36880,40734,1399-9-22
481,وسكرمان,س.سهام عدالت استان كرمان,568,23760620,24923178280,1020,1050,1070,50,4.9,1030,10,0.98,1000,1070,1399-9-22
482,سيستم,همكاران سيستم,568,810402,26597409690,31980,32550,32440,460,1.44,32420,440,1.38,32100,33480,1399-9-22
483,بسويچ,پارس‌سويچ‌,566,824908,39829513970,46030,48330,48330,2300,5.0,47740,1710,3.71,47000,48330,1399-9-22
484,كسرام,پارس‌ سرام‌,562,3766146,38226381900,9670,10150,10150,480,4.96,10020,350,3.62,10150,10150,1399-9-22
485,شزنگ,تجهيزنيروي‌زنگان‌,559,283720,54055537943,184995,190544,190544,5549,3.0,190524,5529,2.99,188700,190544,1399-9-22
486,قشهد,شهد,547,547201,16268982650,30250,29840,28950,-1300,-4.3,30080,-170,-0.56,28740,30580,1399-9-22
487,خاور,ايران خودرو ديزل,541,5676979,40227073194,6880,7086,7086,206,2.99,7086,206,2.99,7086,7086,1399-9-22
488,دقاضي,داروسازي شهيد قاضي,539,189506,17883830969,94000,95000,94560,560,0.6,94330,330,0.35,91180,96820,1399-9-22
489,پارتا,مجتمع‌صنعتي‌آرتاويل‌تاير,531,815596,45895916766,54833,55988,56477,1644,3.0,56273,1440,2.63,55000,56477,1399-9-22
490,زعف0008پ10,زعفران0008نگين طلاي سرخ(پ),520,131957,16690194824,126289,126950,125760,-529,-0.42,126482,193,0.15,124030,126950,1399-9-22
491,خراسان,پتروشيمي خراسان,510,504664,37561793580,74150,74150,74250,100,0.13,74350,200,0.27,73500,75670,1399-9-22
492,تاپكيش,تجارت الكترونيك پارسيان كيش,510,2348240,62007625440,25149,26406,26406,1257,5.0,26406,1257,5.0,26406,26406,1399-9-22
493,ثزاگرس,سرمايه گذاري توسعه عمران زاگرس,498,580923,23949949288,41301,43366,40400,-901,-2.18,41227,-74,-0.18,39700,43366,1399-9-22
494,آتيمس,صندوق س.آرمان آتيه درخشان مس-س,487,160024,37345651070,229302,229551,230501,1199,0.52,233375,4073,1.78,229551,236500,1399-9-22
495,كاسپين,داروسازي كاسپين تامين,479,641487,19543146784,30614,32100,29501,-1113,-3.64,30556,-58,-0.19,29084,32100,1399-9-22
496,غپآذر,شير پگاه آذربايجان شرقي,479,2324938,141611750784,58031,60932,60210,2179,3.75,60910,2879,4.96,58100,60932,1399-9-22
497,سبجنو,سيمان‌ بجنورد,462,756311,29253211950,36840,38680,38680,1840,4.99,37860,1020,2.77,38500,38680,1399-9-22
498,كي بي سي,شركت كي بي سي,453,4684583,161971527800,32958,34330,34605,1647,5.0,34575,1617,4.91,33500,34605,1399-9-22
499,دروز,داروسازي‌ روزدارو,446,672043,11708693090,17620,18500,17440,-180,-1.02,17570,-50,-0.28,16750,18500,1399-9-22
500,وسيستا,شركت س استان سيستان وبلوچستان,446,18977874,15661867490,860,820,830,-30,-3.49,850,-10,-1.16,820,860,1399-9-22
501,ضملت1128,اختيارخ وبملت-6000-1399/11/28,445,14908,10767212000,681,745,654,-27,-3.96,722,41,6.02,650,789,1399-9-22
502,ساينا,صنايع بهداشتي ساينا,444,82292,17189713910,205218,209560,206800,1582,0.77,206457,1239,0.6,201300,215400,1399-9-22
503,سهرمز,سيمان‌هرمزگان‌,441,1053183,22783343020,21140,22050,21570,430,2.03,21360,220,1.04,20100,22050,1399-9-22
504,زماهان,مجتمع توليد گوشت مرغ ماهان,441,798305,23462982255,27992,29391,29391,1399,5.0,28617,625,2.23,29391,29391,1399-9-22
505,غشوكوح,ح . شوكو پارس,436,7245628,218194968496,29028,30656,30769,1741,6.0,30114,1086,3.74,29030,30769,1399-9-22
506,سقاين,سيمان‌ قائن‌,432,590255,30138385470,48650,51080,51080,2430,4.99,50030,1380,2.84,50450,51080,1399-9-22
507,مفاخر,توسعه فناوري اطلاعات خوارزمي,424,643701,30768657076,47216,48047,45700,-1516,-3.21,47571,355,0.75,45000,49000,1399-9-22
508,وپخش,داروپخش‌ (هلدينگ‌,424,87504,12270252270,145100,145100,139440,-5660,-3.9,143860,-1240,-0.85,139440,145100,1399-9-22
509,سكه0012پ01,سكه تمام بهارتحويلي 1روزه رفاه,423,130900,158879429800,1254421,1222332,1209977,-44444,-3.54,1213747,-40674,-3.24,1203000,1222332,1399-9-22
510,گوهر,صندوق سكه طلاي كيان,423,384240,23466877575,61921,61780,60500,-1421,-2.29,61073,-848,-1.37,60151,63600,1399-9-22
511,دتوزيع,توزيع دارو پخش,417,1461932,43393065624,28269,29682,29682,1413,5.0,29437,1168,4.13,29682,29682,1399-9-22
512,لپيام,گسترش صنايع پيام,415,660714,21388621160,31430,32372,32372,942,3.0,32372,942,3.0,32370,32372,1399-9-22
513,كپشير,پشم‌شيشه‌ايران‌,413,1760468,36512106320,19760,20740,20740,980,4.96,20440,680,3.44,20740,20740,1399-9-22
514,دشيري,شيرين دارو,398,213555,35509761220,161523,163500,166368,4845,3.0,166279,4756,2.94,163000,166368,1399-9-22
515,نطرين,عطرين نخ قم,386,2955503,36733946787,11838,12429,12429,591,4.99,12252,414,3.5,12429,12429,1399-9-22
516,ضفلا1158,اختيارخ فولاد-20000-1399/11/28,377,19624,11443599000,1,550,571,570,57000.0,583,582,58200.0,500,700,1399-9-22
517,سخاش,سيمان‌خاش‌,372,136825,13965727750,97210,102070,102070,4860,5.0,98500,1290,1.33,102070,102070,1399-9-22
518,وسلرستا,شركت س استان لرستان,362,11024398,9601438200,910,870,870,-40,-4.4,900,-10,-1.1,870,890,1399-9-22
519,دفرا,فرآورده‌هاي‌ تزريقي‌ ايران‌,353,416713,11421213870,26850,28170,26600,-250,-0.93,26970,120,0.45,26510,28170,1399-9-22
520,ياقوت,صندوق س ياقوت آگاه-ثابت,352,8984919,103864366268,11559,11565,11574,15,0.13,11560,1,0.01,11554,11580,1399-9-22
521,خلنت,لنت‌ ترمزايران‌,351,342744,29430318400,81920,85700,86010,4090,4.99,84140,2220,2.71,85000,86010,1399-9-22
522,درهآور,دارويي ره آورد تامين,345,1273638,55959832806,41845,43937,43937,2092,5.0,43937,2092,5.0,43937,43937,1399-9-22
523,وسنا,سرمايه گذاري نيروگاهي ايران,340,1329689,25315067475,18141,19040,19048,907,5.0,19003,862,4.75,18907,19048,1399-9-22
524,وسفارس,شركت س استان فارس,340,9094374,8912486520,1030,980,980,-50,-4.85,1030,0,0.0,980,980,1399-9-22
525,وسگيلا,شركت س استان گيلان,339,10707294,9003507200,880,840,840,-40,-4.55,870,-10,-1.14,840,850,1399-9-22
526,سپاس,صندوق س. پاداش سهامداري توسعه1,331,10624659,106473542758,10007,10039,10025,18,0.18,10021,14,0.14,10009,10039,1399-9-22
527,ولراز,ليزينگ رازي,324,446203,18989060833,40531,42557,42557,2026,5.0,42363,1832,4.52,42556,42557,1399-9-22
528,بمپنا,توليد برق عسلويه  مپنا,323,631308,63020840450,100504,96690,100000,-504,-0.5,99826,-678,-0.67,96690,101980,1399-9-22
529,تسه9907,امتياز تسهيلات مسكن مهر99,323,4270,2560273180,600404,602002,596000,-4404,-0.73,599596,-808,-0.13,578522,610000,1399-9-22
530,حتوكا,حمل‌ونقل‌توكا,309,1060355,24642650200,22140,23240,23240,1100,4.97,22660,520,2.35,23240,23240,1399-9-22
531,وآتوس,س.آرين توسكا قيمت اسمي 350ريال,304,586654,19177245897,31767,32000,32720,953,3.0,32626,859,2.7,32000,32720,1399-9-22
532,معيار,سرمايه گذاري معيار صنعت پارس,300,380971,11409319508,28797,29948,29948,1151,4.0,29948,1151,4.0,29948,29948,1399-9-22
533,سيمرغ,سيمرغ,295,1850098,36520934520,18800,19740,19740,940,5.0,19450,650,3.46,19740,19740,1399-9-22
534,دبالك,مواد اوليه دارويي البرز بالك,294,1209512,25648911472,20197,21206,21206,1009,5.0,20690,493,2.44,21206,21206,1399-9-22
535,پلوله,گازلوله‌,288,905047,16504125432,18075,18255,18255,180,1.0,18236,161,0.89,17895,18255,1399-9-22
536,سكه9912پ04,سكه تمام بهارتحويل1روزه صادرات,281,105200,127372674900,1254748,1220000,1205555,-49193,-3.92,1210767,-43981,-3.51,1196000,1220000,1399-9-22
537,پارسيان,بيمه پارسيان,276,5487610,89887051800,15600,16380,16380,780,5.0,16380,780,5.0,16380,16380,1399-9-22
538,گپارس,امور رفاهي كارگزاران پارس,273,97107,13243658943,135691,139761,135000,-691,-0.51,136146,455,0.34,131621,139761,1399-9-22
539,ثنور,سرمايه گذاري كوه نور,272,2785605,22312696050,7777,8010,8010,233,3.0,8010,233,3.0,8010,8010,1399-9-22
540,فروس,فروسيليس‌ ايران‌,270,2178137,12066878980,5280,5540,5540,260,4.92,5340,60,1.14,5540,5540,1399-9-22
541,شپترو,پتروشيمي آبادان,268,5408624,29401280064,5178,5436,5436,258,4.98,5436,258,4.98,5436,5436,1399-9-22
542,غگلستا,شير پاستوريزه پگاه گلستان,264,689344,14724764131,20750,21750,21650,900,4.34,20925,175,0.84,21004,21750,1399-9-22
543,كفرا,فراورده‌ هاي‌ نسوزايران‌,262,1251519,79696729920,60650,63680,63680,3030,5.0,63680,3030,5.0,63680,63680,1399-9-22
544,سخواف,سيمان مجد خواف,247,1543369,23082626764,14244,14956,14956,712,5.0,14956,712,5.0,14956,14956,1399-9-22
545,دكپسول,توليد ژلاتين كپسول ايران,247,1343286,61698469266,43744,45931,45931,2187,5.0,45931,2187,5.0,45931,45931,1399-9-22
546,ثشرقح,ح. سرمايه گذاري مسكن شمال شرق,245,1090002,7172213050,6000,6600,6400,400,6.67,6580,580,9.67,6400,6600,1399-9-22
547,ثاصفا,شركت‌ ساختمان‌ اصفهان‌,244,738210,25249734840,35261,34204,34204,-1057,-3.0,34204,-1057,-3.0,34204,34204,1399-9-22
548,فنرژي,گسترش صنايع انرژي آذرآب,241,879873,9361056500,10346,10757,10759,413,3.99,10613,267,2.58,10202,10759,1399-9-22
549,خنصير,مهندسي‌نصيرماشين‌,234,1146556,63920497000,53100,55750,55750,2650,4.99,55750,2650,4.99,55750,55750,1399-9-22
550,سرود,سيمان‌شاهرود,233,2547819,44714223450,16720,17550,17550,830,4.96,17430,710,4.25,17550,17550,1399-9-22
551,غگلپا,شير پاستوريزه پگاه گلپايگان,231,296298,23577024456,75783,79572,79572,3789,5.0,77485,1702,2.25,79572,79572,1399-9-22
552,فوكا,فولاد كاويان,229,2669253,48815298864,18853,18288,18288,-565,-3.0,18288,-565,-3.0,18288,18288,1399-9-22
553,صايند,صندوق س. گنجينه آينده روشن-د,228,3887150,38806015050,9989,10008,9970,-19,-0.19,9983,-6,-0.06,9950,10008,1399-9-22
554,ضپاس1005,اختيارخ وپارس-4500-1399/10/30,224,6519,4488036000,484,500,655,171,35.33,688,204,42.15,500,759,1399-9-22
555,شپارس,بين‌ المللي‌ محصولات‌  پارس‌,215,707065,11970610450,16130,16930,16930,800,4.96,16310,180,1.12,16930,16930,1399-9-22
556,غدام,خوراك‌  دام‌ پارس‌,213,75281,26484608610,335060,351810,351810,16750,5.0,343510,8450,2.52,351810,351810,1399-9-22
557,زگلدشت,كشت و دام گلدشت نمونه اصفهان,209,146208,7659978955,51321,53400,52499,1178,2.3,51482,161,0.31,51520,53400,1399-9-22
558,خديزل,بهمن  ديزل,207,3078054,171321407586,53009,55659,55659,2650,5.0,55659,2650,5.0,55659,55659,1399-9-22
559,تسه9711,امتياز تسهيلات مسكن بهمن 97,206,2080,1235241281,593104,592000,591002,-2102,-0.35,593866,762,0.13,563449,620000,1399-9-22
560,تسه9906,امتياز تسهيلات مسكن شهريور99,206,3682,2217938252,608731,602000,609900,1169,0.19,602373,-6358,-1.04,585000,639167,1399-9-22
561,شغدير,پتروشيمي غدير,205,922134,71908009320,74267,77980,77980,3713,5.0,77980,3713,5.0,77980,77980,1399-9-22
562,تسه9904,امتياز تسهيلات مسكن تير99,205,2359,1433608689,613860,583522,591000,-22860,-3.72,607719,-6141,-1.0,583522,644553,1399-9-22
563,الماس,صندوق س.امين تدبيرگران فردا-س,205,47850,6702146935,137243,140000,140000,2757,2.01,140066,2823,2.06,139000,140828,1399-9-22
564,كماسه,تامين‌ ماسه‌ ريخته‌گري‌,204,385149,18718241400,46290,48600,48600,2310,4.99,47110,820,1.77,48600,48600,1399-9-22
565,غفارس,شير پاستوريزه پگاه فارس,203,1425567,14733234945,9843,10335,10335,492,5.0,9981,138,1.4,10335,10335,1399-9-22
566,شجم,صنايع پتروشيمي تخت جمشيد,196,4175670,44128480560,10261,10568,10568,307,2.99,10568,307,2.99,10568,10568,1399-9-22
567,تسه9902,امتياز تسهيلات مسكن ارديبهشت99,193,2688,1607138140,608888,581522,590000,-18888,-3.1,597894,-10994,-1.81,581522,630000,1399-9-22
568,ضفلا1156,اختيارخ فولاد-16000-1399/11/28,189,4663,8383425000,1536,1700,1730,194,12.63,1798,262,17.06,1671,1979,1399-9-22
569,ساذريح,ح . آذريت‌,188,2332349,12222427669,5152,5279,5306,154,2.99,5240,88,1.71,5050,5306,1399-9-22
570,تسه9810,امتياز تسهيلات مسكن دي98,186,3107,1852152607,598714,571444,588001,-10713,-1.79,596122,-2592,-0.43,571444,628648,1399-9-22
571,آكورد,صندوق س. آرمان آتي كوثر-د,184,3560428,105753043718,29653,29709,29701,48,0.16,29702,49,0.17,29700,29710,1399-9-22
572,غپونه,نوش پونه مشهد,183,998143,20342154340,19787,20380,20380,593,3.0,20373,586,2.96,20380,20380,1399-9-22
573,شلعاب,لعابيران‌,180,1271812,12120368360,9080,9530,9530,450,4.96,9180,100,1.1,9530,9530,1399-9-22
574,فپنتا,سپنتا,178,39092,14620798920,356200,374010,374010,17810,5.0,361160,4960,1.39,374010,374010,1399-9-22
575,ضسپا1104,اختيارخ خساپا-3000-1399/11/26,176,6332,4400356000,733,740,650,-83,-11.32,695,-38,-5.18,649,790,1399-9-22
576,شسينا,صنايع‌شيميايي‌سينا,175,362418,53688602520,141090,148140,148140,7050,5.0,148140,7050,5.0,148140,148140,1399-9-22
577,گكيش,توريستي ورفاهي آبادگران كيش,174,163698,10624327596,66909,64902,64902,-2007,-3.0,65810,-1099,-1.64,64902,64902,1399-9-22
578,فيروزا,صندوق بادرآمد ثابت فيروزه آسيا,174,2496451,53901201994,21526,21420,21591,65,0.3,21591,65,0.3,21420,21600,1399-9-22
579,وگردشح,ح . بانك گردشگري,172,838282,14885246821,18382,19484,17280,-1102,-5.99,17757,-625,-3.4,17280,19484,1399-9-22
580,سصفها,سيمان‌اصفهان‌,169,273961,73051700650,253960,266650,266650,12690,5.0,266650,12690,5.0,266650,266650,1399-9-22
581,وسهمدا,شركت س استان همدان,168,4951093,4257939980,900,860,860,-40,-4.44,900,0,0.0,860,860,1399-9-22
582,اعتلا,شركت سرمايه گذاري اعتلاء البرز,168,2806231,29726404983,10089,10593,10593,504,5.0,10374,285,2.82,10593,10593,1399-9-22
583,قپيرا,فرآورده‌هاي‌غدايي‌وقندپيرانشهر,165,51177,4505096020,89150,88850,87130,-2020,-2.27,89050,-100,-0.11,87130,90970,1399-9-22
584,تسه9712,امتياز تسهيلات مسكن اسفند97,158,1136,678254862,603449,592130,595001,-8448,-1.4,597055,-6394,-1.06,574000,633610,1399-9-22
585,بوعلي4,پتروشيمي بوعلي سينا,158,74953046,3105304695780,41430,41430,41430,0,0.0,41430,0,0.0,41430,41430,1399-9-22
586,وكار,بانك‌ كارآفرين‌,157,8383221,43425084780,4940,5180,5180,240,4.86,5130,190,3.85,5180,5180,1399-9-22
587,ضصاد1104,اختيارخ وبصادر-4500-1399/11/12,157,5751,1750350000,284,300,284,0,0.0,304,20,7.04,271,329,1399-9-22
588,ضفلا1155,اختيارخ فولاد-14000-1399/11/28,156,3550,10238628000,2501,2800,2750,249,9.96,2884,383,15.31,2601,3200,1399-9-22
589,فالوم,آلومتك‌,156,1815453,42499754730,22729,23410,23410,681,3.0,23410,681,3.0,23410,23410,1399-9-22
590,تسه9710,امتياز تسهيلات مسكن دي 97,154,2345,1351617365,575029,572000,560201,-14828,-2.58,576383,1354,0.24,553111,599979,1399-9-22
591,داوه,داروسازي آوه سينا,153,620642,11206932594,17198,18057,18057,859,4.99,17381,183,1.06,18057,18057,1399-9-22
592,خشرق,الكتريك‌ خودرو شرق‌,153,1224208,31143851520,24230,25440,25440,1210,4.99,24950,720,2.97,25440,25440,1399-9-22
593,وتوكا,سرمايه‌گذاري‌توكافولاد(هلدينگ,151,1799925,22589058750,11960,12550,12550,590,4.93,12210,250,2.09,12550,12550,1399-9-22
594,نتوس,پشم‌ بافي‌ توس,150,591105,6593776275,10831,11155,11155,324,2.99,10935,104,0.96,11155,11155,1399-9-22
595,ضپاس1003,اختيارخ وپارس-3500-1399/10/30,150,4838,6491614000,1077,1300,1340,263,24.42,1342,265,24.61,1300,1440,1399-9-22
596,آبين,كشت و صنعت آبشيرين,149,2773004,12708677332,4450,4583,4583,133,2.99,4532,82,1.84,4583,4583,1399-9-22
597,واحصا,احياء صنايع خراسان,145,690000,20265990000,28516,29371,29371,855,3.0,29357,841,2.95,29371,29371,1399-9-22
598,آساميد,صندوق س.مشترك آسمان اميد -د,144,4929625,55185378159,11170,11194,11187,17,0.15,11195,25,0.22,11186,11196,1399-9-22
599,آرمان,بيمه آرمان,143,1807351,21653872331,11411,11981,11981,570,5.0,11981,570,5.0,11981,11981,1399-9-22
600,پست0008پ08,پسته فندقي32-30مه ولات0008(پ),140,7589,13407377173,1775157,1800000,1800000,24843,1.4,1766686,-8471,-0.48,1756609,1840000,1399-9-22
601,تشتاد,صنايع توليدي اشتاد ايران‌,140,219851,3497114406,16162,16320,15710,-452,-2.8,16117,-45,-0.28,15710,16320,1399-9-22
602,كگهر,سنگ آهن گهرزمين,139,279379,13291455925,45310,47575,47575,2265,5.0,45549,239,0.53,47575,47575,1399-9-22
603,بذر,صندوق س بذر اميد آفرين-سهام,137,59373,6978794240,115660,116540,117010,1350,1.17,117540,1880,1.63,116540,118000,1399-9-22
604,وكبهمن4,مديريت سرمايه گذاري كوثربهمن,137,45210474,654828505416,14484,14484,14484,0,0.0,14484,0,0.0,14484,14484,1399-9-22
605,تسه9801,امتياز تسهيلات مسكن فروردين98,135,914,546937613,608934,592120,595021,-13913,-2.28,598400,-10534,-1.73,585001,609970,1399-9-22
606,ثاختح,ح . بين‌المللي‌توسعه‌ساختمان,133,2964854,9249638820,3220,3220,3100,-120,-3.73,3120,-100,-3.11,3100,3220,1399-9-22
607,اوصتا,صندوق انديشه ورزان صباتامين -د,130,6234573,107876884422,17289,17309,17289,0,0.0,17303,14,0.08,17289,17309,1399-9-22
608,پست0008پ04,پسته فندقي32-30سبزدانه0008(پ),130,17785,31620485807,1876794,1930000,1780001,-96793,-5.16,1777930,-98864,-5.27,1756609,1930000,1399-9-22
609,ضصاد1102,اختيارخ وبصادر-3500-1399/11/12,129,4248,3153027000,732,839,710,-22,-3.01,742,10,1.37,700,840,1399-9-22
610,شكف,كف,129,152372,10786413880,69402,70790,70790,1388,2.0,70790,1388,2.0,70790,70790,1399-9-22
611,تسه9905,امتياز تسهيلات مسكن مرداد99,129,1220,729361967,602485,575122,595000,-7485,-1.24,597838,-4647,-0.77,575122,610000,1399-9-22
612,تسه9903,امتياز تسهيلات مسكن خرداد99,124,1134,679046199,610139,582722,604000,-6139,-1.01,598806,-11333,-1.86,582722,604000,1399-9-22
613,لبوتان,گروه‌صنعتي‌بوتان‌,124,622063,55755506690,85370,89630,89630,4260,4.99,89630,4260,4.99,89630,89630,1399-9-22
614,ضپاس1002,اختيارخ وپارس-3000-1399/10/30,124,3089,5572547000,1446,1849,1780,334,23.1,1804,358,24.76,1750,1899,1399-9-22
615,ضخود1048,اختيارخ خودرو-7000-1399/10/07,123,6245,21486000,5,5,3,-2,-40.0,3,-2,-40.0,2,5,1399-9-22
616,ضخود1043,اختيارخ خودرو-3500-1399/10/07,122,3546,2560942000,779,710,680,-99,-12.71,722,-57,-7.32,680,790,1399-9-22
617,ضصاد1103,اختيارخ وبصادر-4000-1399/11/12,122,4697,2180872000,463,460,440,-23,-4.97,464,1,0.22,440,474,1399-9-22
618,ضجار1015,اختيارخ وتجارت-3500-1399/10/21,119,2739,1941736000,738,775,715,-23,-3.12,709,-29,-3.93,671,775,1399-9-22
619,ضجار1016,اختيارخ وتجارت-4000-1399/10/21,119,4453,1929200000,443,477,400,-43,-9.71,433,-10,-2.26,400,480,1399-9-22
620,فاهواز,نورد و لوله اهواز,116,252220,4727611680,19126,18744,18744,-382,-2.0,19083,-43,-0.22,18744,18744,1399-9-22
621,ثجوان,تامين مسكن جوانان,113,2292299,21726409922,9027,9478,9478,451,5.0,9478,451,5.0,9478,9478,1399-9-22
622,ضملت1129,اختيارخ وبملت-7000-1399/11/28,113,4322,1460772000,306,329,338,32,10.46,338,32,10.46,300,353,1399-9-22
623,سكه0112پ03,سكه تمام بهارتحويلي1روزه سامان,113,32000,38776214400,1250135,1209000,1210001,-40134,-3.21,1211757,-38378,-3.07,1205000,1220000,1399-9-22
624,سكه0011پ02,سكه تمام بهارتحويلي 1روزه ملت,113,28400,34436901300,1256120,1210040,1207000,-49120,-3.91,1212567,-43553,-3.47,1204009,1219000,1399-9-22
625,ضخود1045,اختيارخ خودرو-4500-1399/10/07,112,3756,771955000,228,230,193,-35,-15.35,206,-22,-9.65,180,248,1399-9-22
626,بموتو,موتوژن‌,112,106752,5221240320,46590,48910,48910,2320,4.98,46820,230,0.49,48910,48910,1399-9-22
627,كيان2,صندوق س. با درآمد ثابت كيان,110,11000000,11000000,26242,1,1,-26241,-100.0,1,-26241,-100.0,1,1,1399-9-22
628,آكورد2,صندوق س. آرمان آتي كوثر-د,109,10900000,10900000,29653,1,1,-29652,-100.0,1,-29652,-100.0,1,1,1399-9-22
629,خفولا,خدمات فني فولاد يزد,108,371061,14050966887,36765,37867,37867,1102,3.0,37517,752,2.05,37867,37867,1399-9-22
630,كتوكا,توليدي و خدمات صنايع نسوز توكا,107,1149197,27171613868,22519,23644,23644,1125,5.0,23101,582,2.58,23644,23644,1399-9-22
631,فنورد,نوردوقطعات‌ فولادي‌,107,219339,42646081770,185180,194430,194430,9250,5.0,192690,7510,4.06,194430,194430,1399-9-22
632,ولانا,شركت ليزينگ آريا دانا,106,673866,13574356704,19558,20144,20144,586,3.0,19944,386,1.97,20144,20144,1399-9-22
633,تصميم,صندوق س با درآمد ثابت تصميم,104,741117,11215008482,15143,15210,15148,5,0.03,15133,-10,-0.07,15100,15210,1399-9-22
634,زعف0008پ05,زعفران0008نگين زرين(پ),102,98157,12350283479,125488,124500,126000,512,0.41,125822,334,0.27,123500,126500,1399-9-22
635,تسه9803,امتياز تسهيلات مسكن خرداد98,101,894,528619995,598784,568905,570000,-28784,-4.81,591298,-7486,-1.25,568905,600000,1399-9-22
636,صنوين,صندوق سرمايه‌گذاري صنوين-مختلط,101,37248,3970873430,104520,106000,106150,1630,1.56,106610,2090,2.0,106000,106990,1399-9-22
637,وارس,سرمايه گذاري ارس صبا,97,423575,40215481225,92178,94943,94943,2765,3.0,94943,2765,3.0,94943,94943,1399-9-22
638,ضخود1042,اختيارخ خودرو-3000-1399/10/07,94,2157,2322435000,1187,1200,1050,-137,-11.54,1077,-110,-9.27,1001,1200,1399-9-22
639,زعف0008پ11,زعفران0008نگين سحرخيز(پ),94,105783,13345578229,126059,125900,125600,-459,-0.36,126160,101,0.08,125000,129000,1399-9-22
640,زعف0008پ15,زعفران0008پوشالمعمول طلاسرخ(پ),90,50791,4683237315,91080,95270,92000,920,1.01,92206,1126,1.24,88112,95270,1399-9-22
641,فنفت,صنايع تجهيزات نفت,89,544995,8464862340,15080,15532,15532,452,3.0,15266,186,1.23,15532,15532,1399-9-22
642,پدرخش,درخشان‌ تهران‌,87,14333,2858143530,209900,199410,199410,-10490,-5.0,209270,-630,-0.3,199410,199410,1399-9-22
643,تسه9802,امتياز تسهيلات مسكن ارديبهشت98,86,479,285810337,614965,584217,586000,-28965,-4.71,596681,-18284,-2.97,584217,609900,1399-9-22
644,سنوين,سرمايه گذاري اقتصاد نوين,85,273358,2748571337,10083,10280,10130,47,0.47,10075,-8,-0.08,9980,10280,1399-9-22
645,وجامي,سرمايه گذاري جامي,85,723213,7510567005,10083,10385,10385,302,3.0,10193,110,1.09,10385,10385,1399-9-22
646,زعف0008پ08,زعفران0008نگين روستا(پ),85,8954,1125658593,124821,125001,125500,679,0.54,125716,895,0.72,123200,126498,1399-9-22
647,تسه9901,امتياز تسهيلات مسكن فروردين99,84,1036,617079283,603274,575555,600000,-3274,-0.54,595636,-7638,-1.27,575555,606000,1399-9-22
648,اخزا902,اسنادخزانه-م2بودجه99-011019,83,179232,121240041400,675031,676000,676011,980,0.15,676442,1411,0.21,672000,679400,1399-9-22
649,تسه9811,امتياز تسهيلات مسكن بهمن98,82,630,375603851,596600,596267,615000,18400,3.08,596197,-403,-0.07,566770,615000,1399-9-22
650,افران,صندوق س افرا نماد پايدار-ثابت,81,1693366,20799438517,12258,12274,12282,24,0.2,12283,25,0.2,12274,12295,1399-9-22
651,ارمغان,ص سرمايه گذاري ارمغان ايرانيان,79,1081595,10855241793,10031,10079,10033,2,0.02,10036,5,0.05,10032,10119,1399-9-22
652,شتولي,تولي‌پرس‌,77,138220,3865875180,26894,27969,27969,1075,4.0,27294,400,1.49,27969,27969,1399-9-22
653,ضملي1152,اختيارخ فملي-18252-1399/11/05,76,802,1700475320,914,1165,995,81,8.86,1075,161,17.61,964,1168,1399-9-22
654,ضجار1014,اختيارخ وتجارت-3000-1399/10/21,73,2020,2026127000,1036,1000,940,-96,-9.27,1003,-33,-3.19,912,1051,1399-9-22
655,غمهرا,توليدي‌مهرام‌,70,181902,11561691120,60540,63560,63560,3020,4.99,61210,670,1.11,63560,63560,1399-9-22
656,ضپنا1022,اختيارخ رمپنا-18806-1399/10/09,69,413,2120763861,3117,3210,3200,83,2.66,3467,350,11.23,3200,3780,1399-9-22
657,زعف0008پ16,زعفران0008نگين بيرجند(پ),69,41268,5164366330,124545,124010,126500,1955,1.57,125142,597,0.48,124010,127380,1399-9-22
658,آسام,صندوق س.آرمان سپهر آشنا-م,69,35360,3918485940,108672,108100,111900,3228,2.97,110817,2145,1.97,108100,112000,1399-9-22
659,ثروتم,صندوق س. ثروت آفرين پارسيان-س,68,19140,1908392520,98229,99000,100000,1771,1.8,99707,1478,1.5,99000,100000,1399-9-22
660,جوين,كشت و صنعت جوين,67,246978,6119126928,24055,24776,24776,721,3.0,24269,214,0.89,24776,24776,1399-9-22
661,سپر,صندوق س سپر سرمايه بيدار- ثابت,67,266119,2941018702,10948,10951,11053,105,0.96,11052,104,0.95,10950,11074,1399-9-22
662,اخزا808,اسنادخزانه-م8بودجه98-000817,63,43541,37560567761,862000,859011,867500,5500,0.64,862648,648,0.08,851000,867500,1399-9-22
663,تسه9812,امتياز تسهيلات مسكن اسفند98,62,302,180716966,598824,600000,610000,11176,1.87,598401,-423,-0.07,568883,610000,1399-9-22
664,كهرام,توليدي گرانيت بهسرام,62,193778,12817639588,64220,66146,66146,1926,3.0,65418,1198,1.87,66146,66146,1399-9-22
665,شصفها,پتروشيمي‌ اصفهان‌,61,73049,7921141364,104266,108436,108436,4170,4.0,106804,2538,2.43,108436,108436,1399-9-22
666,سايرا,ايرانيت‌,59,71618,2483745842,34979,34280,34280,-699,-2.0,34904,-75,-0.21,34280,35168,1399-9-22
667,اخزا817,اسنادخزانه-م17بودجه98-010512,58,73468,54753342813,745228,741105,745550,322,0.04,745268,40,0.01,741105,747000,1399-9-22
668,اخزا815,اسنادخزانه-م15بودجه98-010406,54,40029,30389086698,758177,758200,760000,1823,0.24,759177,1000,0.13,758100,762800,1399-9-22
669,سمتاز,سيمان ممتازان كرمان,53,710400,17073753600,23334,24034,24034,700,3.0,23914,580,2.49,24034,24034,1399-9-22
670,زعف0008پ12,زعفران0008پوشالمعمول سحرخيز(پ),52,38546,3338671787,90333,86198,87500,-2833,-3.14,86615,-3718,-4.12,86198,87999,1399-9-22
671,تسه9806,امتياز تسهيلات مسكن شهريور98,51,680,407170458,593513,563838,623187,29674,5.0,598780,5267,0.89,563838,623187,1399-9-22
672,ضسپا1103,اختيارخ خساپا-2500-1399/11/26,49,2176,2025017000,964,1002,872,-92,-9.54,931,-33,-3.42,872,1100,1399-9-22
673,تسه9805,امتياز تسهيلات مسكن مرداد98,48,342,202007430,592404,570000,600000,7596,1.28,590665,-1739,-0.29,570000,600000,1399-9-22
674,سخند,صندوق س.سپهرخبرگان نفت-د,48,198600,1986475550,10000,10024,10002,2,0.02,10002,2,0.02,10000,10024,1399-9-22
675,تسه9809,امتياز تسهيلات مسكن آذر98,48,357,213442264,599325,569360,570003,-29322,-4.89,597877,-1448,-0.24,569360,629291,1399-9-22
676,تكنار,مجتمع معادن مس تكنار,48,120809,14658480824,117802,121336,121336,3534,3.0,120317,2515,2.13,121336,121336,1399-9-22
677,اخزا903,اسنادخزانه-م3بودجه99-011110,47,84797,56736982189,670780,670010,672000,1220,0.18,669092,-1688,-0.25,665126,679899,1399-9-22
678,ضشنا1035,اختيارخ شپنا-14000-1399/10/23,46,454,2096174000,4500,4201,4302,-198,-4.4,4617,117,2.6,4200,5000,1399-9-22
679,آينده,بازرگاني آينده سازان بهشت پارس,46,135119,2815474603,21481,20837,20837,-644,-3.0,21388,-93,-0.43,20837,20837,1399-9-22
680,تسه9807,امتياز تسهيلات مسكن مهر98,44,237,141527873,590544,562222,620071,29527,5.0,597164,6620,1.12,562222,620071,1399-9-22
681,ساروج,بين المللي ساروج بوشهر,42,1420753,29824446976,20381,20992,20992,611,3.0,20992,611,3.0,20992,20992,1399-9-22
682,تسه9808,امتياز تسهيلات مسكن آبان98,42,514,306090123,608176,610000,580001,-28175,-4.63,595506,-12670,-2.08,578000,638584,1399-9-22
683,وسخوز,شركت س استان خوزستان,41,655329,609455970,970,930,930,-40,-4.12,970,0,0.0,930,930,1399-9-22
684,كصدف,كاشي صدف سرام استقلال آباده,40,170091,3825856863,21422,22493,22493,1071,5.0,21617,195,0.91,22493,22493,1399-9-22
685,اخزا809,اسنادخزانه-م9بودجه98-000923,39,19229,16304820846,848654,841011,849991,1337,0.16,847929,-725,-0.09,841011,850000,1399-9-22
686,اخزا814,اسنادخزانه-م14بودجه98-010318,39,107422,82732633044,769182,764500,770114,932,0.12,770165,983,0.13,763000,771990,1399-9-22
687,داريك,صندوق س.اعتماد داريك-د,38,1138501,11755698430,10324,10330,10320,-4,-0.04,10326,2,0.02,10320,10429,1399-9-22
688,ضپاس1001,اختيارخ وپارس-2500-1399/10/30,37,400,919670000,1782,2500,2300,518,29.07,2299,517,29.01,2200,2500,1399-9-22
689,ضشنا1036,اختيارخ شپنا-16000-1399/10/23,37,359,1274392000,3111,4004,3299,188,6.04,3550,439,14.11,2950,4004,1399-9-22
690,وسخراج,شركت س استان خراسان جنوبي,35,1219152,2584602240,2230,2120,2120,-110,-4.93,2220,-10,-0.45,2120,2120,1399-9-22
691,پست0008پ02,پسته فندقي32-30طلاسبززرند0008,34,161,303310000,1863369,1890000,1870000,6631,0.36,1883913,20544,1.1,1870000,1890000,1399-9-22
692,وآفري,بيمه كارآفرين,34,285286,4924321646,16759,17261,17261,502,3.0,16879,120,0.72,17261,17261,1399-9-22
693,زعف0008پ18,زعفران0008نگين بهرامن(پ),34,82155,10512690920,130058,130995,128700,-1358,-1.04,127962,-2096,-1.61,125000,130995,1399-9-22
694,اخزا816,اسنادخزانه-م16بودجه98-010503,33,45707,34180023708,747373,747372,747870,497,0.07,747807,434,0.06,747372,748000,1399-9-22
695,ضجار1018,اختيارخ وتجارت-5000-1399/10/21,33,2104,243872000,149,125,106,-43,-28.86,116,-33,-22.15,106,144,1399-9-22
696,شكبير,پتروشيمي اميركبير,33,45203,2925990190,62845,64730,64730,1885,3.0,62904,59,0.09,64730,64730,1399-9-22
697,هصيكو402,اختيارف ت تاصيكو13500-00/02/20,32,230232,320022480,1189,1390,1390,201,16.9,1390,201,16.9,1390,1390,1399-9-22
698,اخزا901,اسنادخزانه-م1بودجه99-010621,32,30163,22010812615,724029,728000,729001,4972,0.69,729729,5700,0.79,725011,732000,1399-9-22
699,اخزا812,اسنادخزانه-م12بودجه98-001111,32,49728,41313688084,830040,827905,826016,-4024,-0.48,830793,753,0.09,825106,834000,1399-9-22
700,ضملي1153,اختيارخ فملي-20280-1399/11/05,31,463,497342344,499,500,588,89,17.84,545,46,9.22,500,641,1399-9-22
701,شسم,توليد سموم‌ علف‌ كش,31,62450,5450136400,85561,87272,87272,1711,2.0,86475,914,1.07,87272,87272,1399-9-22
702,وسقم,شركت س استان قم,29,449393,602186620,1410,1340,1340,-70,-4.96,1410,0,0.0,1340,1340,1399-9-22
703,ضخود1040,اختيارخ خودرو-2000-1399/10/07,29,1123,2328513000,2000,2000,2000,0,0.0,2073,73,3.65,2000,2250,1399-9-22
704,ضخود1046,اختيارخ خودرو-5000-1399/10/07,28,730,79955000,132,110,85,-47,-35.61,110,-22,-16.67,85,130,1399-9-22
705,ضغدر1119,اختيارخ وغدير-10000-1399/11/26,28,254,1302977000,4531,5000,5190,659,14.54,5130,599,13.22,5000,5555,1399-9-22
706,اخزا811,اسنادخزانه-م11بودجه98-001013,28,24024,20138030327,838218,835203,842541,4323,0.52,838246,28,0.0,835202,842801,1399-9-22
707,ضصاد1101,اختيارخ وبصادر-3000-1399/11/12,27,579,579392000,983,952,955,-28,-2.85,1001,18,1.83,952,1099,1399-9-22
708,حرهشا,رهشاد سپاهان (سهامي عام,27,9149,543972093,61295,59457,59457,-1838,-3.0,61243,-52,-0.08,59457,59457,1399-9-22
709,نگين,ص.س. زمين و ساختمان نگين شهرري,27,8656,416581490,49010,47540,48960,-50,-0.1,48130,-880,-1.8,47530,49000,1399-9-22
710,ثروت,ص.خ.ثروت آفرين فيروزه 35%تاديه,26,41230,14430500000,350000,350000,350000,0,0.0,350000,0,0.0,350000,350000,1399-9-22
711,اخزا704,اسنادخزانه-م4بودجه97-991022,26,8072,7967054583,988356,986100,986200,-2156,-0.22,986999,-1357,-0.14,986100,989000,1399-9-22
712,تسه9804,امتياز تسهيلات مسكن تير98,26,256,167302322,661328,680000,628262,-33066,-5.0,653525,-7803,-1.18,628262,680000,1399-9-22
713,ضپاس1006,اختيارخ وپارس-5000-1399/10/30,25,1071,523795000,300,500,500,200,66.67,489,189,63.0,450,500,1399-9-22
714,اخزا820,اسنادخزانه-م20بودجه98-020806,24,5171,3005586141,582298,581111,582000,-298,-0.05,581239,-1059,-0.18,580000,582000,1399-9-22
715,سدبير,س. تدبيرگران فارس وخوزستان,24,110265,5372221065,46401,48721,48721,2320,5.0,46638,237,0.51,48721,48721,1399-9-22
716,ضصاد1100,اختيارخ وبصادر-2500-1399/11/12,23,186,254750000,1388,1500,1400,12,0.86,1370,-18,-1.3,1300,1500,1399-9-22
717,اخزا821,اسنادخزانه-م21بودجه98-020906,23,7771,4433280923,572711,570010,571200,-1511,-0.26,570490,-2221,-0.39,570010,574000,1399-9-22
718,ضسپا1105,اختيارخ خساپا-3500-1399/11/26,22,829,378598000,556,500,440,-116,-20.86,457,-99,-17.81,430,500,1399-9-22
719,هترول911,اختيارف ت پترول-14730-99/11/15,22,85614,82531896,1261,964,964,-297,-23.55,964,-297,-23.55,964,964,1399-9-22
720,شستا991,اجاره تامين اجتماعي-امين991226,21,708,710788587,1003294,1000000,1000020,-3274,-0.33,1003939,645,0.06,1000000,1008983,1399-9-22
721,ضخود1041,اختيارخ خودرو-2500-1399/10/07,21,1018,1586969000,1577,1599,1500,-77,-4.88,1559,-18,-1.14,1500,1600,1399-9-22
722,هبركت912,اختيارف ت بركت-22100-99/12/17,20,310000,310000,1,1,1,0,0.0,1,0,0.0,1,1,1399-9-22
723,ضچاد1017,اختيارخ كچاد-20000-1399/10/02,20,214,428192000,1919,2500,1400,-519,-27.05,2001,82,4.27,1400,2500,1399-9-22
724,اخزا813,اسنادخزانه-م13بودجه98-010219,20,10715,8371723969,778701,778700,781611,2910,0.37,781309,2608,0.33,778700,788000,1399-9-22
725,وسرضوي,س.سهام عدالت استان خراسان رضوي,20,203531,199460380,1030,980,980,-50,-4.85,1030,0,0.0,980,980,1399-9-22
726,ضملي1148,اختيارخ فملي-10140-1399/11/05,19,67,846473112,5516,6600,6000,484,8.77,6407,891,16.15,5811,6610,1399-9-22
727,عيار2,صندوق س. پشتوانه طلاي مفيد,19,190000,190000,31594,1,1,-31593,-100.0,1,-31593,-100.0,1,1,1399-9-22
728,فسديد,لوله‌وتجهيزات‌ سديد - ورشكسته,19,47892,5427456684,111105,113327,113327,2222,2.0,113327,2222,2.0,113327,113327,1399-9-22
729,ضملت1126,اختيارخ وبملت-4500-1399/11/28,18,163,252260000,1513,1890,1450,-63,-4.16,1548,35,2.31,1450,1900,1399-9-22
730,اخزا806,اسنادخزانه-م6بودجه98-000519,18,24511,21837414672,893544,889053,897000,3456,0.39,890923,-2621,-0.29,889051,897000,1399-9-22
731,اخزا818,اسنادخزانه-م18بودجه98-010614,17,12861,9436755016,732515,732207,734000,1485,0.2,733750,1235,0.17,732207,734000,1399-9-22
732,وسيلام,شركت س استان ايلام,17,341234,402656120,1240,1180,1180,-60,-4.84,1240,0,0.0,1180,1180,1399-9-22
733,وساربيل,شركت س استان اردبيل,16,309223,377252060,1280,1220,1220,-60,-4.69,1280,0,0.0,1220,1220,1399-9-22
734,ضسپا1106,اختيارخ خساپا-4000-1399/11/26,15,448,149711000,376,378,310,-66,-17.55,334,-42,-11.17,300,378,1399-9-22
735,ضپيك1020,اختيارخ تاپيكو-14000-99/10/16,15,44,156063000,3694,3900,3400,-294,-7.96,3547,-147,-3.98,3300,4000,1399-9-22
736,ضچاد1014,اختيارخ كچاد-14000-1399/10/02,15,534,3404440000,6967,6700,6640,-327,-4.69,6375,-592,-8.5,6000,6700,1399-9-22
737,ضپنا1023,اختيارخ رمپنا-21506-1399/10/09,14,183,454047942,1400,1288,1700,300,21.43,1675,275,19.64,1288,1850,1399-9-22
738,اخزا810,اسنادخزانه-م10بودجه98-001006,14,7268,6107863493,840743,840400,838016,-2727,-0.32,840377,-366,-0.04,838013,842161,1399-9-22
739,ضمخا1024,اختيارخ اخابر-14000-1399/10/30,14,58,215495000,2933,4280,3005,72,2.45,3715,782,26.66,3002,4280,1399-9-22
740,ضپاس1004,اختيارخ وپارس-4000-1399/10/30,13,107,102820000,896,960,980,84,9.38,961,65,7.25,960,980,1399-9-22
741,ضفلا1154,اختيارخ فولاد-12000-1399/11/28,13,60,291217000,3986,4850,4701,715,17.94,4854,868,21.78,4700,5000,1399-9-22
742,ضچاد1015,اختيارخ كچاد-16000-1399/10/02,13,114,524924000,5501,5001,4603,-898,-16.32,4605,-896,-16.29,4500,5001,1399-9-22
743,وسخراش,شركت س استان خراسان شمالي,13,253813,332495030,1370,1310,1310,-60,-4.38,1370,0,0.0,1310,1310,1399-9-22
744,ضترا1118,اختيارخ شتران-12000-1399/11/14,13,128,394780000,3344,3200,3010,-334,-9.99,3084,-260,-7.78,3010,3200,1399-9-22
745,ضشنا1038,اختيارخ شپنا-20000-1399/10/23,12,48,109619000,2180,2352,2000,-180,-8.26,2284,104,4.77,2000,2400,1399-9-22
746,كشم0001پ01,كشمش سبز0001خليل آباد(پ),12,90,33760411,369580,355000,388010,18430,4.99,375116,5536,1.5,355000,388010,1399-9-22
747,ضمخا7070,اختيارخ اخابر-20000-1400/07/28,12,48,233242000,4662,4700,4783,121,2.6,4859,197,4.23,4670,5500,1399-9-22
748,وسزنجان,شركت س استان زنجان,11,94755,127919250,1420,1350,1350,-70,-4.93,1420,0,0.0,1350,1350,1399-9-22
749,گنجين,صندوق س. گنجينه يكم آويد-د,11,104012,1226796452,11777,11793,11795,18,0.15,11795,18,0.15,11793,11805,1399-9-22
750,ضشنا1037,اختيارخ شپنا-18000-1399/10/23,10,42,117936000,3039,3000,2800,-239,-7.86,2808,-231,-7.6,2800,3000,1399-9-22
751,فيروزه2,صندوق شاخص30 شركت فيروزه- سهام,10,100000,100000,187450,1,1,-187449,-100.0,1,-187449,-100.0,1,1,1399-9-22
752,گوهر2,صندوق سكه طلاي كيان,10,100000,100000,61921,1,1,-61920,-100.0,1,-61920,-100.0,1,1,1399-9-22
753,فماك,ماداكتو استيل كرد,10,450000,12546000000,26989,27880,27880,891,3.3,27880,891,3.3,27880,27880,1399-9-22
754,اخزا721,اسنادخزانه-م21بودجه97-000728,10,9291,8082385862,861392,860151,860173,-1219,-0.14,869916,8524,0.99,860151,873600,1399-9-22
755,وسگلستا,شركت س استان گلستان,9,81920,96665600,1240,1180,1180,-60,-4.84,1240,0,0.0,1180,1180,1399-9-22
756,كابگن,توليدي و صنعتي آبگينه‌,9,20605,103807990,4940,5038,5038,98,1.98,4942,2,0.04,5038,5038,1399-9-22
757,اخزا904,اسنادخزانه-م4بودجه99-011215,9,4838,3175040219,656699,655300,657490,791,0.12,656271,-428,-0.07,655000,657490,1399-9-22
758,اخزا905,اسنادخزانه-م5بودجه99-020218,8,28325,17713735378,629979,620000,625250,-4729,-0.75,625375,-4604,-0.73,620000,628000,1399-9-22
759,زير0003پ02,زيره سبز0003 دانش(پ),8,280,172542899,594586,620000,610000,15414,2.59,616225,21639,3.64,564857,624315,1399-9-22
760,ومشان,س. فني و مهندسي مشانير,8,1667,95572444,59105,57332,57332,-1773,-3.0,59096,-9,-0.02,57332,57332,1399-9-22
761,كرونا2,تامين مالي جمعي صرفا اهداي سود,8,6306,63060000,10000,10000,10000,0,0.0,10000,0,0.0,10000,10000,1399-9-22
762,وسيزد,شركت س استان يزد,7,34400,41968000,1280,1220,1220,-60,-4.69,1280,0,0.0,1220,1220,1399-9-22
763,صمعاد412,صكوك اجاره معادن412-6ماهه21%,7,55100,54003510000,980100,980100,980100,0,0.0,980100,0,0.0,980100,980100,1399-9-22
764,اخزا804,اسنادخزانه-م4بودجه98-000421,6,2657,2404693329,904935,905001,905103,168,0.02,905041,106,0.01,905001,905103,1399-9-22
765,تملي706,تسهيلات مسكن ب. ملي-شهريور97,6,83,67008058,849816,807326,807326,-42490,-5.0,807326,-42490,-5.0,807326,807326,1399-9-22
766,ضفلا1151,اختيارخ فولاد-8000-1399/11/28,6,48,366900000,7149,7500,7500,351,4.91,7644,495,6.92,7500,7800,1399-9-22
767,ضفلا1159,اختيارخ فولاد-24000-1399/11/28,6,104,27326000,245,300,260,15,6.12,263,18,7.35,260,500,1399-9-22
768,ساذري,آذريت‌,6,1543,9233312,5810,5984,5984,174,2.99,5810,0,0.0,5984,5984,1399-9-22
769,ضبدر1149,اختيارخ شبندر-28000-1399/11/19,5,6,41302000,6518,7000,6701,183,2.81,6884,366,5.62,6701,7100,1399-9-22
770,اطلس2,صندوق س.توسعه اندوخته آينده-س,5,50000,50000,213854,1,1,-213853,-100.0,1,-213853,-100.0,1,1,1399-9-22
771,وسكرشا,س.سهام عدالت استان كرمانشاه,5,60864,73036800,1260,1200,1200,-60,-4.76,1260,0,0.0,1200,1200,1399-9-22
772,صمسكن912,ص دين مسكن جنوب-ماهانه16درصد,5,306,18840508,61108,61719,61108,0,0.0,61570,462,0.76,61108,61719,1399-9-22
773,صخود412,ص مرابحه خودرو412- 3ماهه 18%,5,2083,2054170087,982000,989999,986000,4000,0.41,986159,4159,0.42,986000,990003,1399-9-22
774,ضخود1047,اختيارخ خودرو-6000-1399/10/07,5,402,8020000,21,20,10,-11,-52.38,20,-1,-4.76,10,20,1399-9-22
775,ضغدر1120,اختيارخ وغدير-12000-1399/11/26,5,52,191500000,3032,3900,3350,318,10.49,3683,651,21.47,3350,3900,1399-9-22
776,اخزا807,اسنادخزانه-م7بودجه98-000719,5,2448,2122549165,873648,862505,864002,-9646,-1.1,867054,-6594,-0.75,862505,875000,1399-9-22
777,فبستم,صنايع ‌بسته‌بندي‌ مشهد,5,78109,63736944,793,816,816,23,2.9,793,0,0.0,816,816,1399-9-22
778,تملي612,تسهيلات مسكن بانك ملي-اسفند96,5,29,26820737,880813,924853,924853,44040,5.0,924853,44040,5.0,924853,924853,1399-9-22
779,ضپار1117,اختيارخ خپارس-7000-1399/11/19,5,33,96500000,2500,2500,3000,500,20.0,2924,424,16.96,2500,3000,1399-9-22
780,اراد50,مرابحه عام دولت5-ش.خ0302,5,100000,100000100000,1000000,1000001,1000001,1,0.0,1000001,1,0.0,1000001,1000001,1399-9-22
781,ضغدر1121,اختيارخ وغدير-14000-1399/11/26,5,54,140000000,2126,2500,2700,574,27.0,2593,467,21.97,2500,2700,1399-9-22
782,اخزا720,اسنادخزانه-م20بودجه97-000324,4,734,673725250,917000,913090,920000,3000,0.33,917882,882,0.1,913090,920000,1399-9-22
783,هاباد912,اختيارف ت آبادا-30100-99/12/12,4,1105,8405735,7561,7607,7607,46,0.61,7607,46,0.61,7607,7607,1399-9-22
784,ضمخا1025,اختيارخ اخابر-16000-1399/10/30,4,61,157199000,2218,2699,2600,382,17.22,2577,359,16.19,2400,2699,1399-9-22
785,صينا205,صكوك منفعت سينا دارو-3ماهه 19%,4,175,175480000,1000000,1000000,1048000,48000,4.8,1002743,2743,0.27,1000000,1048000,1399-9-22
786,ضصاد1106,اختيارخ وبصادر-6000-1399/11/12,4,167,19022000,68,99,119,51,75.0,114,46,67.65,99,120,1399-9-22
787,ضسپا1102,اختيارخ خساپا-2000-1399/11/26,4,102,144550000,1206,1420,1250,44,3.65,1417,211,17.5,1250,1420,1399-9-22
788,ضپاس1000,اختيارخ وپارس-2000-1399/10/30,4,28,82700000,2425,2800,2980,555,22.89,2954,529,21.81,2800,2980,1399-9-22
789,اخزا718,اسنادخزانه-م18بودجه97-000525,4,5908,5264053233,890996,890997,891004,8,0.0,891004,8,0.0,890997,891418,1399-9-22
790,ضملت1130,اختيارخ وبملت-8000-1399/11/28,4,61,12829000,200,229,210,10,5.0,210,10,5.0,210,229,1399-9-22
791,پست0008پ09,پسته بادامي30-28مه ولات0008(پ),4,340,512402000,1544739,1520000,1500000,-44739,-2.9,1507065,-37674,-2.44,1500000,1520000,1399-9-22
792,اخزا713,اسنادخزانه-م13بودجه97-000518,4,7062,6351598736,893035,899650,895128,2093,0.23,899405,6370,0.71,895128,899700,1399-9-22
793,كباده,توليد خاك نسوزاستقلال آباده,4,4000,93696000,22309,23424,23424,1115,5.0,22314,5,0.02,23424,23424,1399-9-22
794,تملي702,تسهيلات مسكن ب. ملي-ارديبهشت97,4,32,26624928,792409,832029,832029,39620,5.0,832029,39620,5.0,832029,832029,1399-9-22
795,ضملي1151,اختيارخ فملي-16224-1399/11/05,4,151,744035600,2173,2500,2300,127,5.84,2499,326,15.0,2300,2500,1399-9-22
796,ضپار1118,اختيارخ خپارس-8000-1399/11/19,4,38,85500000,1500,2250,2250,750,50.0,2250,750,50.0,2250,2250,1399-9-22
797,ضچاد1012,اختيارخ كچاد-10000-1399/10/02,3,5,31001000,10967,7001,5000,-5967,-54.41,6200,-4767,-43.47,5000,7001,1399-9-22
798,ضگل1144,اختيارخ كگل-20000-1399/11/21,3,50,123000000,2157,2300,2500,343,15.9,2460,303,14.05,2300,2500,1399-9-22
799,ضمخا7067,اختيارخ اخابر-14000-1400/07/28,3,12,102000000,7500,8500,8500,1000,13.33,8500,1000,13.33,8500,8500,1399-9-22
800,ضگل1141,اختيارخ كگل-14000-1399/11/21,3,15,91700000,7665,6500,6000,-1665,-21.72,6113,-1552,-20.25,6000,6500,1399-9-22
801,صايپا308,صكوك مرابحه سايپا308-3ماهه 18%,3,30,29800000,995556,990000,1000000,4444,0.45,993333,-2223,-0.22,990000,1000000,1399-9-22
802,ضپيك1022,اختيارخ تاپيكو-18000-99/10/16,3,8,14993000,1650,1999,1666,16,0.97,1874,224,13.58,1666,1999,1399-9-22
803,شگامرن,مجتمع پترو صنعت گامرون,3,42000,10000200000,238000,238100,238100,100,0.04,238100,100,0.04,238100,238100,1399-9-22
804,كيا,كيا الكترود شرق,3,150000,842550000,5617,5617,5617,0,0.0,5617,0,0.0,5617,5617,1399-9-22
805,اخزا716,اسنادخزانه-م16بودجه97-000407,3,514,467853700,910007,915700,913000,2993,0.33,910221,214,0.02,910111,915700,1399-9-22
806,ضپار1119,اختيارخ خپارس-9000-1399/11/19,3,15,27750000,1000,1850,1850,850,85.0,1850,850,85.0,1850,1850,1399-9-22
807,سپرمي,پرميت‌,3,2290,19277220,8335,8418,8418,83,1.0,8335,0,0.0,8418,8418,1399-9-22
808,كايتا,ايتالران‌,3,4924,47048820,9277,9555,9555,278,3.0,9278,1,0.01,9555,9555,1399-9-22
809,وسبوشهر,شركت س استان بوشهر,3,24500,29400000,1260,1200,1200,-60,-4.76,1260,0,0.0,1200,1200,1399-9-22
810,اخزا723,اسنادخزانه-م23بودجه97-000824,2,12,10295406,863000,847901,868000,5000,0.58,857950,-5050,-0.59,847901,868000,1399-9-22
811,اخزا805,اسنادخزانه-م5بودجه98-000422,2,422,382536935,905998,901273,908000,2002,0.22,906486,488,0.05,901273,908000,1399-9-22
812,آكورد4,صندوق س. آرمان آتي كوثر-د,2,10850000,322012250000,29653,29675,29685,32,0.11,29679,26,0.09,29675,29685,1399-9-22
813,تبريز112,مشاركت شهرداري تبريز-3ماهه18%,2,99,94365000,928918,965000,935000,6082,0.65,953182,24264,2.61,935000,965000,1399-9-22
814,ارزش2,صندوق س ارزش آفرين بيدار-سهام,2,10000000,10000000,11670,1,1,-11669,-99.99,1,-11669,-99.99,1,1,1399-9-22
815,زير0003پ01,زيره سبز0003كيميابذر(پ),2,115,64958555,594586,564857,564857,-29729,-5.0,564857,-29729,-5.0,564857,564857,1399-9-22
816,ضچاد1019,اختيارخ كچاد-28000-1399/10/02,2,11,416000,276,100,24,-252,-91.3,38,-238,-86.23,24,100,1399-9-22
817,افق ملت2,صندوق س در سهام افق ملت,2,200000,200000,147260,1,1,-147259,-100.0,1,-147259,-100.0,1,1,1399-9-22
818,وسمركز,شركت س استان مركزي,2,13475,17921750,1400,1330,1330,-70,-5.0,1400,0,0.0,1330,1330,1399-9-22
819,ضصاد1107,اختيارخ وبصادر-7000-1399/11/12,2,200,14000000,77,70,70,-7,-9.09,70,-7,-9.09,70,70,1399-9-22
820,ضپيك1019,اختيارخ تاپيكو-12000-99/10/16,2,15,85500000,5372,5700,5700,328,6.11,5700,328,6.11,5700,5700,1399-9-22
821,گواهي ظرفيت,گواهي ظرفيت نقدي,2,5038000,53599282000,10639,10639,10639,0,0.0,10639,0,0.0,10639,10639,1399-9-22
822,ضجار1017,اختيارخ وتجارت-4500-1399/10/21,2,6,1619000,246,294,265,19,7.72,270,24,9.76,265,294,1399-9-22
823,ضبدر1150,اختيارخ شبندر-32000-1399/11/19,2,3,16000000,4204,6000,5000,796,18.93,5333,1129,26.86,5000,6000,1399-9-22
824,تسه99042,امتياز تسهيلات مسكن تير99,2,74,740,613860,10,10,-613850,-100.0,10,-613850,-100.0,10,10,1399-9-22
825,ضمخا1023,اختيارخ اخابر-12000-1399/10/30,2,6,33330000,4520,5555,5555,1035,22.9,5555,1035,22.9,5555,5555,1399-9-22
826,زعف0008پ09,زعفران0008نگين نوين(پ),2,1052,131552000,125999,125000,126000,1,0.0,125049,-950,-0.75,125000,126000,1399-9-22
827,كمند2,صندوق س. با درآمد ثابت كمند,2,80000000,80000000,10029,1,1,-10028,-99.99,1,-10028,-99.99,1,1,1399-9-22
828,ضملت1124,اختيارخ وبملت-3500-1399/11/28,2,6,14800000,2031,2500,2400,369,18.17,2467,436,21.47,2400,2500,1399-9-22
829,ضملت1123,اختيارخ وبملت-3000-1399/11/28,2,15,44500000,2500,2900,3000,500,20.0,2967,467,18.68,2900,3000,1399-9-22
830,كيش1402,اجاره س. و توسعه كيش14020820,2,48,47520000,980000,1000000,980000,0,0.0,990000,10000,1.02,980000,1000000,1399-9-22
831,ضملي1149,اختيارخ فملي-12168-1399/11/05,2,6,58568400,4842,5200,4900,58,1.2,4950,108,2.23,4900,5200,1399-9-22
832,صگل309,صكوك اجاره گل گهر309-3ماهه20%,1,1000,1020000000,1000000,1020000,1020000,20000,2.0,1020000,20000,2.0,1020000,1020000,1399-9-22
833,سصوفي2,سيمان‌ صوفيان‌,1,11842000,200011380000,16890,16890,16890,0,0.0,16890,0,0.0,16890,16890,1399-9-22
834,البرز2,بيمه البرز,1,30000000,171000000000,5820,5700,5700,-120,-2.06,5700,-120,-2.06,5700,5700,1399-9-22
835,وبملت2,بانك ملت,1,15099863,80784267050,5310,5350,5350,40,0.75,5350,40,0.75,5350,5350,1399-9-22
836,خديزل4,بهمن  ديزل,1,5000000,278295000000,53009,55659,55659,2650,5.0,55659,2650,5.0,55659,55659,1399-9-22
837,ساينا4,صنايع بهداشتي ساينا,1,600000,123874200000,205218,206457,206457,1239,0.6,206457,1239,0.6,206457,206457,1399-9-22
838,صگل1411,ص اجاره گل گهر 1411-3 ماهه 17%,1,4,3920000,976000,980000,980000,4000,0.41,980000,4000,0.41,980000,980000,1399-9-22
839,اتكام2,شركت بيمه اتكايي امين,1,38500000,312312000000,7726,8112,8112,386,5.0,8112,386,5.0,8112,8112,1399-9-22
840,غيوان,كيوان,1,333,5208120,15334,15640,15640,306,2.0,15334,0,0.0,15640,15640,1399-9-22
841,اراد49,مرابحه عام دولت4-ش.خ 0206,1,1000,940460000,933720,940460,940460,6740,0.72,940460,6740,0.72,940460,940460,1399-9-22
842,ضسپا1101,اختيارخ خساپا-1800-1399/11/26,1,1,1450000,1497,1450,1450,-47,-3.14,1450,-47,-3.14,1450,1450,1399-9-22
843,ضپاس1008,اختيارخ وپارس-7000-1399/10/30,1,25,2500000,80,100,100,20,25.0,100,20,25.0,100,100,1399-9-22
844,تسه99082,امتياز تسهيلات مسكن آبان99,1,109,1090,602934,10,10,-602924,-100.0,10,-602924,-100.0,10,10,1399-9-22
845,تنوين2,تامين سرمايه نوين,1,66000000,519420000000,7520,7870,7870,350,4.65,7870,350,4.65,7870,7870,1399-9-22
846,تسه99022,امتياز تسهيلات مسكن ارديبهشت99,1,18,180,608888,10,10,-608878,-100.0,10,-608878,-100.0,10,10,1399-9-22
847,ضصاد1105,اختيارخ وبصادر-5000-1399/11/12,1,100,20000000,201,200,200,-1,-0.5,200,-1,-0.5,200,200,1399-9-22
848,ميدكو2,هلدينگ صنايع  معدني خاورميانه,1,20000000,534000000000,26660,26700,26700,40,0.15,26700,40,0.15,26700,26700,1399-9-22
849,ضچاد1016,اختيارخ كچاد-18000-1399/10/02,1,2,6600000,4077,3300,3300,-777,-19.06,3300,-777,-19.06,3300,3300,1399-9-22
850,شپديس2,پتروشيمي پرديس,1,1000000,110700000000,109810,110700,110700,890,0.81,110700,890,0.81,110700,110700,1399-9-22
851,اراد494,مرابحه عام دولت4-ش.خ 0206,1,4999000,4701359540000,933720,940460,940460,6740,0.72,940460,6740,0.72,940460,940460,1399-9-22
852,تسه99062,امتياز تسهيلات مسكن شهريور99,1,158,1580,608731,10,10,-608721,-100.0,10,-608721,-100.0,10,10,1399-9-22
853,پارسان2,گسترش نفت و گاز پارسيان,1,20000000,500000000000,24110,25000,25000,890,3.69,25000,890,3.69,25000,25000,1399-9-22
854,ضملت1125,اختيارخ وبملت-4000-1399/11/28,1,20,30000000,2352,1500,1500,-852,-36.22,1500,-852,-36.22,1500,1500,1399-9-22
855,اراد22,مرابحه عام دولت2-ش.خ لوتوس0212,1,2000,1712000000,862000,856000,856000,-6000,-0.7,856000,-6000,-0.7,856000,856000,1399-9-22
856,افاد4,منفعت دولتي4-شرايط خاص14010729,1,500,510000000,1030000,1020000,1020000,-10000,-0.97,1020000,-10000,-0.97,1020000,1020000,1399-9-22
857,كاوه2,فولاد كاوه جنوب كيش,1,15773188,370038990480,22350,23460,23460,1110,4.97,23460,1110,4.97,23460,23460,1399-9-22
858,تاپيكو2,س. نفت و گاز و پتروشيمي تأمين,1,2237423,38506049830,16480,17210,17210,730,4.43,17210,730,4.43,17210,17210,1399-9-22
859,حفارس4,حمل و نقل بين المللي خليج فارس,1,20000000,101200000000,4900,5060,5060,160,3.27,5060,160,3.27,5060,5060,1399-9-22
860,سلامت4,مرابحه دولتي تعاون-لوتوس991118,1,2000,2010000000,1000010,1005000,1005000,4990,0.5,1005000,4990,0.5,1005000,1005000,1399-9-22
861,ضفلا1153,اختيارخ فولاد-10000-1399/11/28,1,2,12000000,5500,6000,6000,500,9.09,6000,500,9.09,6000,6000,1399-9-22
862,ضملي1150,اختيارخ فملي-14196-1399/11/05,1,2,14987200,3300,3800,3800,500,15.15,3800,500,15.15,3800,3800,1399-9-22
863,مشير112,مشاركت شهرداري شيراز-3ماهه18%,1,6,5940000,990179,990000,990000,-179,-0.02,990000,-179,-0.02,990000,990000,1399-9-22
864,ضترا1117,اختيارخ شتران-10000-1399/11/14,1,66,290400000,4887,4400,4400,-487,-9.97,4400,-487,-9.97,4400,4400,1399-9-22
865,اخزا9062,اسنادخزانه-م6بودجه99-020321,1,320000,199040000000,626056,622000,622000,-4056,-0.65,622000,-4056,-0.65,622000,622000,1399-9-22
866,ضچاد1018,اختيارخ كچاد-24000-1399/10/02,1,1,86000,700,86,86,-614,-87.71,86,-614,-87.71,86,86,1399-9-22
867,صخابر102,صكوك اجاره مخابرات-3 ماهه 16%,1,1,936982,936982,936982,936982,0,0.0,936982,0,0.0,936982,936982,1399-9-22
868,شسپا2,نفت سپاهان,1,5000000,137900000000,27580,27580,27580,0,0.0,27580,0,0.0,27580,27580,1399-9-22
869,صگل411,ص اجاره گل گهر 411- 3 ماهه 17%,1,5,4900000,980000,980000,980000,0,0.0,980000,0,0.0,980000,980000,1399-9-22
870,عفولاد2,اوراق سلف ورق گرم فولاد مباركه,1,15,8712345,568443,580823,580823,12380,2.18,580823,12380,2.18,580823,580823,1399-9-22
871,تسه99012,امتياز تسهيلات مسكن فروردين99,1,19,190,603274,10,10,-603264,-100.0,10,-603264,-100.0,10,10,1399-9-22
872,ضپار1115,اختيارخ خپارس-5000-1399/11/19,1,4,16000000,4069,4000,4000,-69,-1.7,4000,-69,-1.7,4000,4000,1399-9-22
