,نماد,نام,تعداد,حجم,ارزش,دیروز,اولین,آخرین معامله - مقدار,آخرین معامله - تغییر,آخرین معامله - درصد,قیمت پایانی - مقدار,قیمت پایانی - تغییر,قیمت پایانی - درصد,کمترین,بیشترین,تاریخ
0,پالايش,صندوق پالايشي يکم-سهام,142333,65859801,7130698380870,105990,107900,107170,1180,1.11,108270,2280,2.15,106050,110000,1399-9-16
1,خودرو,ايران‌ خودرو,89587,2537553220,10922485293770,4110,4270,4310,200,4.87,4300,190,4.62,4230,4310,1399-9-16
2,شستا,سرمايه گذاري تامين اجتماعي,85549,321281867,9828235729880,29190,30140,30640,1450,4.97,30590,1400,4.8,29600,30640,1399-9-16
3,دي,بانك دي,83875,131275870,6972819896126,54320,56500,51604,-2716,-5.0,53116,-1204,-2.22,51604,56600,1399-9-16
4,وسپهر,سرمايه گذاري مالي سپهرصادرات,71899,169695283,2034423143072,11978,12050,11893,-85,-0.71,11989,11,0.09,11738,12300,1399-9-16
5,شپنا,پالايش نفت اصفهان,67932,366919826,7020760292320,18380,18500,19290,910,4.95,19130,750,4.08,18380,19290,1399-9-16
6,وتجارت,بانك تجارت,65981,1379999732,5446852472240,3940,4000,3900,-40,-1.02,3950,10,0.25,3850,4070,1399-9-16
7,بپيوند,برق و انرژي پيوندگستر پارس,64023,59830266,1883555906830,29047,30500,31951,2904,10.0,31482,2435,8.38,30000,31951,1399-9-16
8,دارا يكم,صندوق واسطه گري مالي يكم-سهام,61257,26310728,5217194075980,197510,200100,195400,-2110,-1.07,198290,780,0.39,194010,204480,1399-9-16
9,فولاد,فولاد مباركه اصفهان,44264,206649764,3009050319240,14310,14560,14520,210,1.47,14560,250,1.75,14300,14840,1399-9-16
10,شتران,پالايش نفت تهران,44149,209805943,3142759135220,14400,14400,15120,720,5.0,14980,580,4.03,14300,15120,1399-9-16
11,حكشتي,كشتيراني جمهوري اسلامي ايران,42602,78613010,2561339040880,32490,33780,31970,-520,-1.6,32580,90,0.28,31000,33990,1399-9-16
12,چخزر,صنايع چوب خزر كاسپين,41597,971069,25646903359,25154,26411,26411,1257,5.0,25764,610,2.43,26411,26411,1399-9-16
13,ثاميد,توسعه و عمران اميد,40044,266615943,633898709210,2380,2440,2340,-40,-1.68,2380,0,0.0,2320,2450,1399-9-16
14,سيتا,سرمايه گذاري سيمان تامين,37716,54788531,993706969860,17930,18290,18080,150,0.84,18140,210,1.17,17780,18690,1399-9-16
15,وپارس,بانك‌پارسيان‌,36388,737348192,3300538639710,4570,4620,4410,-160,-3.5,4480,-90,-1.97,4350,4730,1399-9-16
16,امين,تامين سرمايه امين,36127,40359025,510093254670,12650,12540,12650,0,0.0,12640,-10,-0.08,12320,12850,1399-9-16
17,غزر,صنعتي زر ماكارون,34633,5989498,355822904900,57040,59380,59880,2840,4.98,59410,2370,4.15,57770,59890,1399-9-16
18,ذوب,سهامي ذوب آهن  اصفهان,33793,305424437,1766015620843,5749,6001,5688,-61,-1.06,5782,33,0.57,5520,6020,1399-9-16
19,وبملت,بانك ملت,32872,425684861,2329084563700,5500,5570,5390,-110,-2.0,5470,-30,-0.55,5330,5650,1399-9-16
20,تليسه,دامداري تليسه نمونه,32761,198504755,1747781943411,9119,9339,8664,-455,-4.99,8805,-314,-3.44,8664,9448,1399-9-16
21,آبادا,توليد نيروي برق آبادان,31109,22150894,477138377940,20600,21630,21630,1030,5.0,21540,940,4.56,21160,21630,1399-9-16
22,ثبهساز,بهساز كاشانه تهران,30820,151755129,436435483290,2860,2910,2860,0,0.0,2880,20,0.7,2820,2940,1399-9-16
23,وبصادر,بانك صادرات ايران,30707,532754506,1913842061060,3590,3660,3550,-40,-1.11,3590,0,0.0,3500,3690,1399-9-16
24,زملارد,كشاورزي و دامپروري ملارد شير,30406,3149893,138086377574,43323,45080,44000,677,1.56,43838,515,1.19,42298,45080,1399-9-16
25,خصدرا,صنعتي‌ دريايي‌ ايران‌,29489,263043055,1486735487314,5670,5600,5570,-100,-1.76,5652,-18,-0.32,5551,5839,1399-9-16
26,زدشت,كشت و صنعت دشت خرم دره,28033,45326886,2625731666520,54581,57400,59399,4818,8.83,57929,3348,6.13,55120,59997,1399-9-16
27,آريا,پليمر آريا ساسول,27593,8248400,1594100634749,184381,184390,193600,9219,5.0,193262,8881,4.82,184390,193600,1399-9-16
28,هاي وب,داده گسترعصرنوين-هاي وب,26188,97188050,3065163339390,31180,32730,30400,-780,-2.5,31540,360,1.15,30100,32730,1399-9-16
29,پترول,گروه پتروشيمي س. ايرانيان,25637,109776583,1527658886740,13630,13800,13840,210,1.54,13920,290,2.13,13700,14100,1399-9-16
30,شاروم,پتروشيمي اروميه,24467,9464129,232382223466,23385,24554,24554,1169,5.0,24554,1169,5.0,24554,24554,1399-9-16
31,گدنا,تهيه توزيع غذاي دنا آفرين فدك,24320,2204407,63323795482,27359,28726,28726,1367,5.0,28726,1367,5.0,28726,28726,1399-9-16
32,پيزد,مجتمع صنايع لاستيك يزد,24254,2230023,205124824369,90198,91500,90777,579,0.64,91983,1785,1.98,90000,93600,1399-9-16
33,وپويا,سرمايه گذاري پويا,23106,36762917,336416291781,9075,9250,8999,-76,-0.84,9151,76,0.84,8930,9350,1399-9-16
34,شگويا,پتروشيمي تندگويان,23013,100159055,1334098338164,13188,13100,13161,-27,-0.2,13320,132,1.0,12960,13670,1399-9-16
35,اخابر,مخابرات ايران,21875,73249564,1185873303320,16500,16720,15950,-550,-3.33,16190,-310,-1.88,15700,16990,1399-9-16
36,شبندر,پالايش نفت بندرعباس,20735,130213582,4026042214250,29510,29670,30980,1470,4.98,30920,1410,4.78,29650,30980,1399-9-16
37,بكهنوج,توليد برق ماهتاب كهنوج,19596,374092886,1216930744162,3395,3304,3260,-135,-3.98,3253,-142,-4.18,3226,3389,1399-9-16
38,لكما,كارخانجات‌مخابراتي‌ايران‌,19359,126990286,1152445308508,9306,9027,9070,-236,-2.54,9075,-231,-2.48,9027,9451,1399-9-16
39,خبهمن,گروه‌بهمن‌,19325,67392080,1979697085710,29450,30300,28640,-810,-2.75,29380,-70,-0.24,28100,30500,1399-9-16
40,وغدير,سرمايه‌گذاري‌غدير(هلدينگ‌,18999,103030042,1525761848940,14390,15100,14620,230,1.6,14810,420,2.92,14390,15100,1399-9-16
41,ولپارس,ليزينگ پارسيان,17920,6439838,45980443320,6800,7140,7140,340,5.0,7090,290,4.26,7140,7140,1399-9-16
42,زشگزا,شير و گوشت زاگرس شهركرد,17310,8465173,1312678945907,160986,158533,157500,-3486,-2.17,155068,-5918,-3.68,152937,164840,1399-9-16
43,رافزا,رايان هم افزا,16546,98293,3656696186,35431,37202,37202,1771,5.0,35554,123,0.35,37202,37202,1399-9-16
44,تاپيكو,س. نفت و گاز و پتروشيمي تأمين,15970,93583144,1648215478340,17080,17200,17360,280,1.64,17610,530,3.1,17030,17930,1399-9-16
45,حفاري,حفاري شمال,15629,90604437,1337164461670,15010,14830,14480,-530,-3.53,14760,-250,-1.67,14260,15280,1399-9-16
46,آسيا,بيمه آسيا,15520,36476487,1370994384350,37070,38920,36120,-950,-2.56,37590,520,1.4,35600,38920,1399-9-16
47,وحكمت,بيمه حكمت صبا,14902,167895210,930866960882,5568,5401,5735,167,3.0,5544,-24,-0.43,5401,5735,1399-9-16
48,داراب,پتروشيمي داراب,14411,207976348,637492973503,3116,2961,3018,-98,-3.15,3065,-51,-1.64,2961,3190,1399-9-16
49,بكام,كارخانجات توليدي شهيد قندي,13896,125609690,633778327060,5200,5200,4980,-220,-4.23,5050,-150,-2.88,4940,5290,1399-9-16
50,شيران,س. صنايع‌شيميايي‌ايران,13677,31582730,1225310138640,38640,39390,39000,360,0.93,38800,160,0.41,37700,40490,1399-9-16
51,ونوين,بانك‌اقتصادنوين‌,13018,226991291,1342652780580,5740,6020,5830,90,1.57,5910,170,2.96,5750,6020,1399-9-16
52,قصفها,قنداصفهان‌,12531,4539376,1098846256680,234430,246150,236000,1570,0.67,242070,7640,3.26,227020,255400,1399-9-16
53,جهرم,پتروشيمي جهرم,12323,178849347,564796080245,3112,2957,3192,80,2.57,3158,46,1.48,2957,3267,1399-9-16
54,غگل,گلوكوزان‌,12143,130446929,684812579560,5050,5250,5300,250,4.95,5250,200,3.96,5070,5300,1399-9-16
55,گكوثر,هتل پارسيان كوثر اصفهان,11916,5859871,955516157051,170434,170000,160220,-10214,-5.99,163061,-7373,-4.33,158000,171000,1399-9-16
56,ولساپا,ليزينگ رايان‌ سايپا,11759,153512445,742256326590,4810,4900,4720,-90,-1.87,4840,30,0.62,4610,5050,1399-9-16
57,فارس,صنايع پتروشيمي خليج فارس,11738,42487287,616977883430,14280,14590,14410,130,0.91,14520,240,1.68,14270,14790,1399-9-16
58,كفپارس,فرآورده‌هاي‌ نسوز پارس‌,11663,63155597,508895265040,8010,8240,8090,80,1.0,8060,50,0.62,7800,8300,1399-9-16
59,پتاير,ايران‌ تاير,11309,4887731,825852291100,174740,175500,166600,-8140,-4.66,168960,-5780,-3.31,163460,178600,1399-9-16
60,ثغرب,شركت سرمايه گذاري مسكن شمالغرب,11123,56941818,679523889089,12257,12860,11660,-597,-4.87,11934,-323,-2.64,11645,12860,1399-9-16
61,زبينا,كشاورزي و دامپروري بينالود,11071,14459900,843592587132,60907,60399,58000,-2907,-4.77,58340,-2567,-4.21,57862,62667,1399-9-16
62,البرز,بيمه البرز,10887,153185175,779016533980,5170,5160,5160,-10,-0.19,5090,-80,-1.55,5010,5300,1399-9-16
63,بجهرم,توسعه مولد نيروگاهي جهرم,10744,92011245,405933953758,4351,4470,4344,-7,-0.16,4412,61,1.4,4299,4530,1399-9-16
64,صبا,سرمايه گذاري صبا تامين,10624,39178728,385499974618,9647,9746,9939,292,3.03,9840,193,2.0,9690,10047,1399-9-16
65,خزاميا,زامياد,10480,85694371,1383474024580,15400,16170,16170,770,5.0,16140,740,4.81,15800,16170,1399-9-16
66,فروي,ذوب روي اصفهان,10417,10014913,637400843820,64505,67000,62600,-1905,-2.95,63645,-860,-1.33,61280,67000,1399-9-16
67,وملي,گروه‌ صنعتي‌ ملي‌ (هلدينگ‌,10235,3562768,1152060241390,313160,317300,328810,15650,5.0,323360,10200,3.26,304550,328810,1399-9-16
68,سبزوا,سيمان لار سبزوار,10215,61396516,384191135103,6319,6240,6200,-119,-1.88,6258,-61,-0.97,6100,6499,1399-9-16
69,خريخت,صنايع‌ريخته‌گري‌ايران‌,9906,137296481,651823951330,4250,4890,4720,470,11.06,4750,500,11.76,4650,4980,1399-9-16
70,خكمك,كمك‌فنرايندامين‌,9814,17949016,940093377520,50310,51000,52820,2510,4.99,52380,2070,4.11,50310,52820,1399-9-16
71,كحافظ,كاشي‌ وسراميك‌ حافظ‌,9774,34021439,740811720710,20860,21900,21270,410,1.97,21770,910,4.36,21240,21900,1399-9-16
72,ومعادن,توسعه‌معادن‌وفلزات‌,9685,85542057,1354042456020,15100,15490,15850,750,4.97,15830,730,4.83,15400,15850,1399-9-16
73,دماوند,توليد نيروي برق دماوند,9666,11095571,845517086732,77398,78000,75150,-2248,-2.9,76203,-1195,-1.54,73529,78000,1399-9-16
74,تپمپي,پمپ‌ سازي‌ ايران‌,9285,15569283,526380944720,33630,33400,35100,1470,4.37,33810,180,0.54,32000,35200,1399-9-16
75,چكاپا,گروه صنايع كاغذ پارس,8898,53968404,388920904340,7200,7360,7090,-110,-1.53,7210,10,0.14,7000,7470,1399-9-16
76,فسا,پتروشيمي فسا,8548,131209585,380268759356,2929,2783,2821,-108,-3.69,2898,-31,-1.06,2783,3000,1399-9-16
77,سمگا,گروه سرمايه گذاري ميراث فرهنگي,8497,100202852,2486401763837,23682,24866,24866,1184,5.0,24814,1132,4.78,24100,24866,1399-9-16
78,فاراك,ماشين‌ سازي‌ اراك‌,8436,62437288,511597008700,8220,8480,8090,-130,-1.58,8190,-30,-0.36,7920,8560,1399-9-16
79,قشير,قند شيروان قوچان و بجنورد,8424,14432648,494480796034,34365,35979,33250,-1115,-3.24,34261,-104,-0.3,33000,35979,1399-9-16
80,كرمان,س. توسعه و عمران استان كرمان,8374,15338711,1382113126342,86178,90400,90486,4308,5.0,90106,3928,4.56,87200,90486,1399-9-16
81,فخوز,فولاد  خوزستان,8174,17540948,705788752390,39120,39300,39750,630,1.61,40240,1120,2.86,39300,41000,1399-9-16
82,زقيام,كشت و دام قيام اصفهان,8141,14304033,569868415087,41282,41700,39218,-2064,-5.0,39840,-1442,-3.49,39218,42780,1399-9-16
83,فاذر,صنايع‌ آذرآب‌,8100,12329709,439769817410,36040,37100,35010,-1030,-2.86,35670,-370,-1.03,34500,37370,1399-9-16
84,كچاد,معدني‌وصنعتي‌چادرملو,7743,26366205,586636942100,21540,22510,22290,750,3.48,22250,710,3.3,21700,22610,1399-9-16
85,ثفارس,عمران‌وتوسعه‌فارس‌,7735,63896394,574029892560,8650,8900,9000,350,4.05,8980,330,3.82,8660,9080,1399-9-16
86,قنيشا,قند  نيشابور,7677,7478944,520216195750,70360,71000,69490,-870,-1.24,69560,-800,-1.14,67300,72970,1399-9-16
87,ودي,بيمه  دي,7568,30104347,892124398129,29090,29800,29250,160,0.55,29634,544,1.87,28300,30544,1399-9-16
88,وخارزم,سرمايه گذاري خوارزمي,7299,57669576,669774209960,11090,11640,11640,550,4.96,11610,520,4.69,11410,11640,1399-9-16
89,قثابت,قند ثابت‌ خراسان‌,7293,9607502,878888784000,89610,93180,89620,10,0.01,91480,1870,2.09,86500,94090,1399-9-16
90,وپاسار,بانك  پاسارگاد,7246,75118230,878606598650,11720,11730,11730,10,0.09,11700,-20,-0.17,11280,11800,1399-9-16
91,وصنعت,سرمايه گذاري توسعه صنعت وتجارت,6989,50713462,470181391320,9170,9200,9290,120,1.31,9270,100,1.09,9140,9380,1399-9-16
92,وساخت,سرمايه‌ گذاري‌ ساختمان‌ايران‌,6952,7114820,524276236260,73860,75800,71000,-2860,-3.87,73690,-170,-0.23,70990,76500,1399-9-16
93,ثشاهد,سرمايه‌ گذاري‌ شاهد,6751,24289635,655821197840,25760,27040,27040,1280,4.97,27000,1240,4.81,26200,27040,1399-9-16
94,فرابورس,فرابورس ايران,6742,14179261,836527932248,56232,59043,59043,2811,5.0,58997,2765,4.92,58000,59043,1399-9-16
95,خساپا,سايپا,6687,292268991,941106151020,3070,3220,3220,150,4.89,3220,150,4.89,3220,3220,1399-9-16
96,تملت,تامين سرمايه بانك ملت,6571,24920607,239743678580,9530,9810,9530,0,0.0,9620,90,0.94,9290,9860,1399-9-16
97,غگيلا,شيرپاستوريزه پگاه گيلان,6523,101334,1821681318,17121,17977,17977,856,5.0,17151,30,0.18,17977,17977,1399-9-16
98,وشهر,بانك شهر,6454,57614197,485751261371,8579,8664,8236,-343,-4.0,8431,-148,-1.73,8236,8899,1399-9-16
99,ماديرا,صنايع ماشين هاي اداري ايران,6433,13873465,424974414968,30627,31699,29890,-737,-2.41,30632,5,0.02,29150,31699,1399-9-16
100,حسير,ريل سير كوثر,6415,22711440,423869580186,18214,18539,19124,910,5.0,18663,449,2.47,17900,19124,1399-9-16
101,كاوه,فولاد كاوه جنوب كيش,6378,27814944,635339919280,22080,23180,22750,670,3.03,22840,760,3.44,22230,23180,1399-9-16
102,فسرب,ملي‌ سرب‌وروي‌ ايران‌,6299,2567074,396533637770,152860,160400,149410,-3450,-2.26,154470,1610,1.05,148590,160400,1399-9-16
103,كترام,توليدي‌ كاشي‌ تكسرام‌,6250,15004737,572926335970,37490,35620,39360,1870,4.99,38180,690,1.84,35620,39360,1399-9-16
104,وايران,ليزينگ ايرانيان,6242,40019277,522692430460,12880,13520,12800,-80,-0.62,13060,180,1.4,12300,13520,1399-9-16
105,كگل,معدني و صنعتي گل گهر,6116,19267545,413494053350,20730,21100,21750,1020,4.92,21460,730,3.52,20960,21760,1399-9-16
106,غنوش,نوش‌ مازندران‌,6062,6660573,477341638120,72480,74600,69350,-3130,-4.32,71670,-810,-1.12,69000,75740,1399-9-16
107,ثقزوي,شركت عمران و سازندگي قزوين,6049,14851162,373800693451,25149,25550,25500,351,1.4,25170,21,0.08,24395,25900,1399-9-16
108,زمگسا,كشاورزي‌ ودامپروي‌ مگسال‌,6048,16256682,825175514160,46250,50870,50870,4620,9.99,50760,4510,9.75,48260,50870,1399-9-16
109,وهور,مديريت انرژي اميد  تابان هور,6010,16886339,765694304927,43419,44000,45589,2170,5.0,45344,1925,4.43,43752,45589,1399-9-16
110,غديس,پاكديس,5833,31017381,440159614898,13549,14200,14226,677,5.0,14191,642,4.74,13800,14226,1399-9-16
111,ورازي,بيمه رازي,5767,32521064,389045438310,11989,12170,12020,31,0.26,11963,-26,-0.22,11500,12335,1399-9-16
112,وپست,پست بانك ايران,5747,44151330,866051727440,18710,19500,19640,930,4.97,19620,910,4.86,19000,19640,1399-9-16
113,وبانك,سرمايه گذاري گروه توسعه ملي,5693,41017447,477455581440,11200,11230,11760,560,5.0,11640,440,3.93,11230,11760,1399-9-16
114,وتوس,توسعه‌شهري‌توس‌گستر,5589,13525631,369823328410,27720,26340,27090,-630,-2.27,27340,-380,-1.37,26340,28970,1399-9-16
115,وساپا,سرمايه‌گذاري‌ سايپا,5552,51194924,540902948910,10070,10570,10570,500,4.97,10570,500,4.97,10440,10570,1399-9-16
116,كمند,صندوق س. با درآمد ثابت كمند,5400,231900836,2321420719099,10166,10024,10029,-137,-1.35,10010,-156,-1.53,10005,10029,1399-9-16
117,فنوال,نورد آلومينيوم‌,5356,9805429,307061317570,31060,31500,30700,-360,-1.16,31320,260,0.84,30230,32400,1399-9-16
118,ثمسكن,سرمايه‌گذاري‌ مسكن‌,5000,121037130,844731972210,6650,6980,6980,330,4.96,6980,330,4.96,6880,6980,1399-9-16
119,ومهان,گروه توسعه مالي مهر آيندگان,4858,33068848,608565377870,17567,17900,18445,878,5.0,18403,836,4.76,17785,18445,1399-9-16
120,وبوعلي,سرمايه‌گذاري‌بوعلي‌,4764,45797316,369667621410,7700,8080,8080,380,4.94,8070,370,4.81,7900,8080,1399-9-16
121,وسينا,بانك سينا,4629,37315623,474793591280,13160,13190,12510,-650,-4.94,12720,-440,-3.34,12510,13370,1399-9-16
122,فولاي,صنايع فولاد آلياژي يزد,4563,8255679,326984336870,38029,39930,39930,1901,5.0,39607,1578,4.15,37500,39930,1399-9-16
123,فمراد,آلومراد,4554,2570233,319918159980,129260,129000,122800,-6460,-5.0,124470,-4790,-3.71,122800,132000,1399-9-16
124,پارسان,گسترش نفت و گاز پارسيان,4460,19021004,478057865430,24030,24000,25220,1190,4.95,25130,1100,4.58,24000,25230,1399-9-16
125,حاريا,كشتيراني آريا,4458,16452400,436456614706,26836,26031,27389,553,2.06,26528,-308,-1.15,26031,27390,1399-9-16
126,كيسون,شركت كيسون,4457,33539720,520304599030,15319,15200,15778,459,3.0,15513,194,1.27,15070,15778,1399-9-16
127,تنوينح,ح . تامين سرمايه نوين,4422,19796995,104413957658,5380,5410,5119,-261,-4.85,5274,-106,-1.97,5070,5590,1399-9-16
128,سخواف,سيمان مجد خواف,4400,30396223,400811619369,16038,12900,13287,-2751,-17.15,13186,-2852,-17.78,12513,13287,1399-9-16
129,شمواد,توليد مواداوليه الياف مصنوعي,4360,5411414,318463782182,58689,56929,60449,1760,3.0,58850,161,0.27,56929,60449,1399-9-16
130,بالاس,مهندسي ساختمان تاسيسات راه آهن,4339,5070951,309656864782,62094,65197,59620,-2474,-3.98,61065,-1029,-1.66,58990,65197,1399-9-16
131,شكلر,نيروكلر,4333,6368662,385151172850,61280,58220,61300,20,0.03,60480,-800,-1.31,58220,62660,1399-9-16
132,تنوين,تامين سرمايه نوين,4319,33929271,241756563120,7320,7580,7010,-310,-4.23,7130,-190,-2.6,6960,7580,1399-9-16
133,خرينگ,رينگ‌سازي‌مشهد,4236,5187578,349211797090,64240,64260,67450,3210,5.0,67320,3080,4.79,64260,67450,1399-9-16
134,خاذين,سايپاآذين‌,4184,41336381,281278820550,6500,6820,6820,320,4.92,6800,300,4.62,6670,6820,1399-9-16
135,شفارس,صنايع‌ شيميايي‌ فارس‌,4159,9516076,555297555480,55820,58610,58610,2790,5.0,58350,2530,4.53,56530,58610,1399-9-16
136,رانفور,خدمات‌انفورماتيك‌,4113,8641163,315236205360,37060,37500,35960,-1100,-2.97,36480,-580,-1.57,35700,37600,1399-9-16
137,قرن,پديده شيمي قرن,4112,3602976,221142587180,60990,63020,60800,-190,-0.31,61380,390,0.64,59530,63400,1399-9-16
138,تايرا,تراكتورسازي‌ايران‌,4108,25192330,778813736270,29590,29570,30800,1210,4.09,30910,1320,4.46,29450,31060,1399-9-16
139,فسازان,غلتك سازان سپاهان,4042,13954998,461409745950,32600,33900,33180,580,1.78,33060,460,1.41,31110,34230,1399-9-16
140,پاكشو,گروه صنعتي پاكشو,4039,2449287,224342133150,94630,93400,91070,-3560,-3.76,91590,-3040,-3.21,90280,93900,1399-9-16
141,غدام,خوراك‌  دام‌ پارس‌,3958,1163130,337467660060,278530,292400,292450,13920,5.0,290140,11610,4.17,280100,292450,1399-9-16
142,كوير,توليدي فولاد سپيد فراب كوير,3954,29383496,583267258410,19030,19600,19980,950,4.99,19850,820,4.31,19120,19980,1399-9-16
143,مرقام,ايران‌ارقام‌,3937,9109655,242435095550,26400,27690,26100,-300,-1.14,26610,210,0.8,25740,27690,1399-9-16
144,آگاس,صندوق س.هستي بخش آگاه-س,3901,3761023,290638256046,75272,76201,77345,2073,2.75,77276,2004,2.66,76201,77910,1399-9-16
145,نوين,بيمه نوين,3852,38381432,350426684107,8734,9170,9150,416,4.76,9130,396,4.53,8904,9170,1399-9-16
146,سفارس,سيمان فارس و خوزستان,3789,29995996,583734630600,18570,19490,19490,920,4.95,19460,890,4.79,19000,19490,1399-9-16
147,افق,فروشگاههاي زنجيره اي افق كوروش,3659,2720179,232303198040,83010,84200,84580,1570,1.89,85400,2390,2.88,83680,86490,1399-9-16
148,ساوه,سيمان ساوه,3626,1308834,81371495003,59454,61470,62426,2972,5.0,62171,2717,4.57,60510,62426,1399-9-16
149,واتي,سرمايه‌ گذاري‌ آتيه‌ دماوند,3623,22944906,347875664620,14760,15400,14780,20,0.14,15160,400,2.71,14390,15490,1399-9-16
150,هرمز,فولاد هرمزگان جنوب,3613,17067869,234656376997,13491,13800,13641,150,1.11,13748,257,1.9,13491,14120,1399-9-16
151,مدير,ص.س.مديريت ثروت ص.بازنشستگي-س,3601,19510587,221537849605,10929,11200,11310,381,3.49,11355,426,3.9,11100,11650,1399-9-16
152,لسرما,سرما آفرين‌,3574,6186853,203197743420,32420,33700,32090,-330,-1.02,32840,420,1.3,31710,33980,1399-9-16
153,توريل,توکاريل,3561,10383644,252390062199,23569,24740,23500,-69,-0.29,24307,738,3.13,23350,24747,1399-9-16
154,زفكا,كشت و دامداري فكا,3561,4739182,263572139673,54220,56931,53979,-241,-0.44,55616,1396,2.57,52800,56931,1399-9-16
155,ختوقا,قطعات‌ اتومبيل‌ ايران‌,3467,61997722,271472095860,4180,4380,4380,200,4.78,4380,200,4.78,4250,4380,1399-9-16
156,لپارس,پارس‌ الكتريك‌,3460,1576289,233672549640,142670,143000,149800,7130,5.0,148240,5570,3.9,143000,149800,1399-9-16
157,وبهمن,سرمايه‌گذاري‌بهمن‌,3437,17796655,367434774890,20370,21380,21000,630,3.09,20650,280,1.37,19910,21380,1399-9-16
158,سرو,صندوق س سروسودمند مدبران-سهام,3434,3832051,281788511660,71940,72670,73690,1750,2.43,73530,1590,2.21,72670,74050,1399-9-16
159,تكشا,گسترش‌صنايع‌وخدمات‌كشاورزي‌,3403,4393368,267506303650,59570,59600,60300,730,1.23,60890,1320,2.22,59100,62540,1399-9-16
160,رنيك,جنرال مكانيك,3391,8073056,227395519476,29083,29988,27629,-1454,-5.0,28167,-916,-3.15,27629,29988,1399-9-16
161,سيدكو,سرمايه گذاري توسعه صنايع سيمان,3381,43459266,385603261160,8980,9400,8680,-300,-3.34,8870,-110,-1.22,8540,9420,1399-9-16
162,كگاز,شيشه‌ و گاز,3373,7475586,187213718830,25060,25940,24650,-410,-1.64,25040,-20,-0.08,24650,25950,1399-9-16
163,جم,پتروشيمي جم,3372,14969379,764685672280,48750,51180,51180,2430,4.98,51080,2330,4.78,49810,51180,1399-9-16
164,ارفع,شركت آهن و فولاد ارفع,3311,15469751,240040869573,14930,15675,15280,350,2.34,15517,587,3.93,15000,15676,1399-9-16
165,چكارن,كارتن‌ ايران‌,3267,32605364,139345505080,4080,4280,4280,200,4.9,4270,190,4.66,4200,4280,1399-9-16
166,آپ,آسان پرداخت پرشين,3074,8481008,168577951930,19560,20530,19600,40,0.2,19880,320,1.64,18700,20530,1399-9-16
167,حريل,ريل پردازسير,3037,34834160,155032456407,4275,4488,4475,200,4.68,4451,176,4.12,4351,4488,1399-9-16
168,ثپرديس,سرمايه گذاري مسكن پرديس,3016,11815107,136887543665,11503,11920,11340,-163,-1.42,11586,83,0.72,11200,11920,1399-9-16
169,زنگان,صنعت روي زنگان,2999,1474495,165044287597,115404,118000,109634,-5770,-5.0,111933,-3471,-3.01,109634,118000,1399-9-16
170,ريشمك,توليد و صادرات ريشمك,2994,5641235,282601458976,48439,50860,50780,2341,4.83,50096,1657,3.42,46500,50860,1399-9-16
171,زاگرس,پتروشيمي زاگرس,2993,1758599,346788001097,190418,193010,195000,4582,2.41,197196,6778,3.56,192100,199938,1399-9-16
172,سمايه,بانك سرمايه,2974,13281362,113836727116,8799,8577,8536,-263,-2.99,8571,-228,-2.59,8536,8799,1399-9-16
173,كرازي,كارخانجات‌توليدي‌شيشه‌رازي‌,2957,8701296,209173382760,23000,24150,24150,1150,5.0,24040,1040,4.52,23090,24150,1399-9-16
174,بپاس,بيمه پاسارگاد,2954,5258857,462195909001,87853,87854,88101,248,0.28,87889,36,0.04,87500,88470,1399-9-16
175,ولغدر,ليزينگ‌خودروغدير,2946,15578777,411596217770,25180,26430,26430,1250,4.96,26420,1240,4.92,26000,26430,1399-9-16
176,سكرد,سيمان كردستان,2941,14114256,134161250020,9340,9340,9400,60,0.64,9510,170,1.82,9130,9760,1399-9-16
177,سشرق,سيمان‌ شرق‌,2881,21896201,153818923240,6940,7180,7000,60,0.86,7020,80,1.15,6790,7200,1399-9-16
178,ثنظام,س. ساختماني نظام مهندسي ايران,2854,3676563,153989363213,41639,42888,40650,-989,-2.38,41884,245,0.59,40390,42888,1399-9-16
179,ما,بيمه  ما,2842,20836798,203692961790,9440,9880,9750,310,3.28,9780,340,3.6,9470,9910,1399-9-16
180,وبيمه,سرمايه‌ گذاري‌ صنعت‌ بيمه‌,2830,29036088,100345781290,3470,3570,3450,-20,-0.58,3460,-10,-0.29,3340,3580,1399-9-16
181,همراه,شركت ارتباطات سيار ايران,2828,9392006,357240022480,37850,38380,38110,260,0.69,38040,190,0.5,37000,38800,1399-9-16
182,خگستر,گسترش‌سرمايه‌گذاري‌ايران‌خودرو,2825,53876507,261301058950,4620,4850,4850,230,4.98,4850,230,4.98,4850,4850,1399-9-16
183,وآذر,سرمايه‌گذاري‌توسعه‌آذربايجان‌,2814,2301454,295168777910,131160,133000,125200,-5960,-4.54,128250,-2910,-2.22,124610,135220,1399-9-16
184,غويتا,ويتانا,2748,5571559,259408498936,45286,47400,46430,1144,2.53,46559,1273,2.81,45300,47400,1399-9-16
185,ارزش,صندوق س ارزش آفرين بيدار-سهام,2746,19649025,220890083120,10880,11150,11200,320,2.94,11240,360,3.31,11100,11380,1399-9-16
186,آ س پ,آ.س.پ,2741,11884956,134884547536,11511,11749,11210,-301,-2.61,11349,-162,-1.41,11000,11749,1399-9-16
187,اپرداز,آتيه داده پرداز,2732,8147115,272556260321,32278,33800,33500,1222,3.79,33454,1176,3.64,32280,33891,1399-9-16
188,ميدكو,هلدينگ صنايع  معدني خاورميانه,2729,10254236,273618672990,26707,26840,26820,113,0.42,26683,-24,-0.09,25630,26840,1399-9-16
189,وملت,سرمايه گذاري ملت,2717,20380599,86881786286,4263,4093,4200,-63,-1.48,4263,0,0.0,4093,4420,1399-9-16
190,وصندوق,سرمايه‌گذاري‌صندوق‌بازنشستگي‌,2716,27806191,487967732190,16780,17610,17400,620,3.69,17550,770,4.59,17120,17610,1399-9-16
191,شصدف,صنعتي دوده فام,2685,111682,2825331236,24094,25298,25298,1204,5.0,24159,65,0.27,25298,25298,1399-9-16
192,تاصيكو,سرمايه گذاري صدرتامين,2645,22899451,282032176490,11760,12310,12340,580,4.93,12320,560,4.76,12010,12340,1399-9-16
193,شفن,پتروشيمي فناوران,2636,3041063,951583389080,299260,299000,314220,14960,5.0,312910,13650,4.56,299000,314220,1399-9-16
194,فرآور,فرآوري‌موادمعدني‌ايران‌,2629,6055770,148011407630,24370,25300,24070,-300,-1.23,24440,70,0.29,23410,25580,1399-9-16
195,غاذر,كشت‌وصنعت‌پياذر,2611,3376377,311987623740,88210,92620,92620,4410,5.0,92400,4190,4.75,90010,92620,1399-9-16
196,ميهن,بيمه ميهن,2605,23454780,147860731531,6151,6190,6262,111,1.8,6304,153,2.49,6154,6450,1399-9-16
197,پسهند,صنايع‌ لاستيكي‌  سهند,2604,3700788,172154286850,46160,46160,47500,1340,2.9,46520,360,0.78,43920,48450,1399-9-16
198,والبر,سرمايه‌ گذاري‌ البرز(هلدينگ‌,2588,12607977,266541570120,20150,21150,21150,1000,4.96,21140,990,4.91,20770,21150,1399-9-16
199,رمپنا,گروه مپنا (سهامي عام),2577,29022307,608282231060,19980,20970,20970,990,4.95,20960,980,4.9,20300,20970,1399-9-16
200,غشان,شيرپاستوريزه‌پگاه‌خراسان‌,2527,11755952,100678912060,8670,8610,8510,-160,-1.85,8560,-110,-1.27,8300,8850,1399-9-16
201,درازك,دارويي‌ رازك‌,2526,7036259,328976840440,44910,46070,46530,1620,3.61,46750,1840,4.1,45170,47150,1399-9-16
202,ثرود,سرمايه‌گذاري مسكن زاينده رود,2525,17366091,200805644457,11154,11350,11390,236,2.12,11563,409,3.67,11200,11711,1399-9-16
203,دشيمي,شيمي‌ داروئي‌ داروپخش‌,2472,2926402,178116284450,58330,61000,61190,2860,4.9,60870,2540,4.35,59190,61240,1399-9-16
204,دلقما,دارويي‌ لقمان‌,2472,4612615,151569511410,32530,34140,32500,-30,-0.09,32860,330,1.01,30910,34140,1399-9-16
205,خچرخش,چرخشگر,2470,10687721,204636417910,18410,18930,19330,920,5.0,19150,740,4.02,18500,19330,1399-9-16
206,فجر,فولاد اميركبيركاشان,2440,5159352,337269410410,64600,64570,64900,300,0.46,65370,770,1.19,63500,67600,1399-9-16
207,وتوصا,گروه س توسعه صنعتي ايران,2440,37228271,603155637200,15440,16210,16210,770,4.99,16200,760,4.92,16000,16210,1399-9-16
208,ومعلم,بيمه معلم,2439,19205570,157939286925,7867,8170,8260,393,5.0,8224,357,4.54,7900,8260,1399-9-16
209,بزاگرس,نيروگاه زاگرس كوثر,2435,17369001,240494546714,13200,13799,13860,660,5.0,13846,646,4.89,13620,13860,1399-9-16
210,ملت,بيمه ملت,2418,17002347,301004466530,16970,16440,17810,840,4.95,17700,730,4.3,16440,17810,1399-9-16
211,چافست,افست‌,2416,5842465,134305575500,23140,22550,22900,-240,-1.04,22990,-150,-0.65,22500,23540,1399-9-16
212,شبهرن,نفت‌ بهران‌,2413,4809799,317620654620,63550,64950,65970,2420,3.81,66040,2490,3.92,64000,66720,1399-9-16
213,شپاكسا,پاكسان‌,2402,5690626,192892862170,32290,33900,33900,1610,4.99,33900,1610,4.99,33110,33900,1399-9-16
214,شبريز,پالايش نفت تبريز,2397,16203038,553149874860,32540,33000,34160,1620,4.98,34140,1600,4.92,33000,34160,1399-9-16
215,ثباغ,شهر سازي و خانه سازي باغميشه,2371,5520699,134505434590,24472,24780,23690,-782,-3.2,24364,-108,-0.44,23500,25100,1399-9-16
216,خپارس,پارس‌ خودرو,2366,32596125,270505570630,7910,8300,8300,390,4.93,8300,390,4.93,8200,8300,1399-9-16
217,آريان,سرمايه گذاري پارس آريان,2364,48574620,793654207760,15907,16110,16360,453,2.85,16339,432,2.72,16010,16384,1399-9-16
218,قشرين,قند شيرين خراسان,2363,11706429,268644750993,22367,23038,23038,671,3.0,22948,581,2.6,22000,23038,1399-9-16
219,تابا,تابان نيرو سپاهان,2363,3840563,118670014714,31543,32000,30597,-946,-3.0,30899,-644,-2.04,30597,32364,1399-9-16
220,شغدير,پتروشيمي غدير,2360,6220245,425391323926,65466,67400,68739,3273,5.0,68388,2922,4.46,65800,68739,1399-9-16
221,ونفت,سرمايه‌گذاري‌ صنعت‌ نفت‌,2330,14871942,247609135220,16170,16820,16970,800,4.95,16650,480,2.97,16300,16970,1399-9-16
222,وآوا,سرمايه گذاري آوا نوين,2324,7115663,120543715849,16435,16940,16740,305,1.86,16941,506,3.08,16500,17256,1399-9-16
223,كالا,بورس كالاي ايران,2317,4647534,214182759520,43900,46090,46090,2190,4.99,46090,2190,4.99,45500,46090,1399-9-16
224,فايرا,آلومينيوم‌ايران‌,2313,7144030,197034491760,26390,27700,27700,1310,4.96,27580,1190,4.51,26220,27700,1399-9-16
225,سپح,ح . پرداخت الكترونيك سامان كيش,2296,4587046,73263150570,16420,16850,15810,-610,-3.71,15970,-450,-2.74,15510,16900,1399-9-16
226,شدوص,دوده‌ صنعتي‌ پارس‌,2292,5601330,142749881550,24640,25640,25720,1080,4.38,25480,840,3.41,24070,25870,1399-9-16
227,فلامي,لاميران‌,2291,2451941,97310060810,39830,39200,39870,40,0.1,39690,-140,-0.35,37850,41350,1399-9-16
228,سپاها,سيمان‌سپاهان‌,2283,10233332,98598464130,9630,9900,9590,-40,-0.42,9640,10,0.1,9280,10000,1399-9-16
229,پكوير,كوير تاير,2278,5123960,101888052430,19120,19500,20000,880,4.6,19880,760,3.97,19310,20070,1399-9-16
230,سنير,سيمان‌ سفيد ني‌ريز,2275,1350544,126397038870,89940,88220,94430,4490,4.99,93590,3650,4.06,88220,94430,1399-9-16
231,رتاپح,ح.تجارت الكترونيك پارسيان,2275,16033737,90118251180,5140,5490,5650,510,9.92,5620,480,9.34,5490,5650,1399-9-16
232,وسكاب,س.ص.بازنشستگي كاركنان بانكها,2241,22248603,162444339040,7180,7390,7240,60,0.84,7300,120,1.67,7140,7410,1399-9-16
233,امين يكم,صندوق درآمد ثابت امين يكم فردا,2239,80464475,820061894376,10193,10199,10194,1,0.01,10192,-1,-0.01,10175,10202,1399-9-16
234,سپ,پرداخت الكترونيك سامان كيش,2233,4091643,72420445950,17790,18600,17410,-380,-2.14,17700,-90,-0.51,17110,18600,1399-9-16
235,كلر,كلر پارس,2215,2601647,190632900692,69891,73385,72500,2609,3.73,73274,3383,4.84,72100,73385,1399-9-16
236,غپاك,لبنيات‌ پاك‌,2169,8685605,131654847390,15220,15750,15130,-90,-0.59,15160,-60,-0.39,14700,15750,1399-9-16
237,بخاور,بيمه زندگي خاورميانه,2156,11477597,110131263437,9540,10015,9550,10,0.1,9595,55,0.58,9230,10017,1399-9-16
238,پكرمان,گروه‌ صنعتي‌ بارز,2153,4937096,171765885890,34070,35080,34390,320,0.94,34790,720,2.11,33710,35770,1399-9-16
239,غبشهر,صنعتي‌ بهشهر,2140,7531754,228894236600,29470,30940,29850,380,1.29,30390,920,3.12,29470,30940,1399-9-16
240,قزوين,كارخانجات‌ قند قزوين‌,2096,4877702,212668148330,41620,43700,43700,2080,5.0,43600,1980,4.76,41620,43700,1399-9-16
241,ثعمرا,عمران و توسعه شاهد,2088,10856371,170320903221,14998,15740,15747,749,4.99,15689,691,4.61,15250,15747,1399-9-16
242,ثاباد,توريستي ورفاهي آبادگران ايران,2088,4278809,133167214910,30210,31400,31720,1510,5.0,31120,910,3.01,29310,31720,1399-9-16
243,شكربن,كربن‌ ايران‌,2036,1777842,165036433350,90090,89920,91500,1410,1.57,92830,2740,3.04,88000,94590,1399-9-16
244,اعتماد,صندوق س.اعتماد آفرين پارسيان-د,2024,57263800,1928803738290,33665,33681,33689,24,0.07,33683,18,0.05,33661,33691,1399-9-16
245,بفجر,فجر انرژي خليج فارس,1990,2743365,85885577230,31430,31000,31100,-330,-1.05,31310,-120,-0.38,30950,31790,1399-9-16
246,زشريف,كشت وصنعت شريف آباد,1971,3759709,97892048055,25091,26340,25400,309,1.23,26037,946,3.77,25200,26345,1399-9-16
247,كبافق,معادن‌ بافق‌,1970,2385061,111056969660,44450,46650,46670,2220,4.99,46560,2110,4.75,45010,46670,1399-9-16
248,ستران,سيمان‌ تهران‌,1966,4361683,169292068700,36990,38830,38820,1830,4.95,38810,1820,4.92,38320,38830,1399-9-16
249,كهمداح,ح . شيشه‌ همدان‌,1964,9185835,106025252330,11080,11300,11610,530,4.78,11540,460,4.15,11260,12000,1399-9-16
250,تكنو,تكنوتار,1934,4485674,61998215570,13740,14020,13700,-40,-0.29,13820,80,0.58,13340,14300,1399-9-16
251,شاراك,پتروشيمي شازند,1896,11882626,300482470130,24170,23950,25220,1050,4.34,25290,1120,4.63,23950,25370,1399-9-16
252,وپسا,س. پتروشيمي ساختمان  خليج فارس,1888,22992715,93325372989,3977,4080,4069,92,2.31,4059,82,2.06,3951,4096,1399-9-16
253,خاهن,آهنگري‌ تراكتورسازي‌ ايران‌,1879,6132786,255110454500,39720,41680,41270,1550,3.9,41600,1880,4.73,40680,41700,1399-9-16
254,خشرق,الكتريك‌ خودرو شرق‌,1851,7310057,156427368520,20410,21430,21430,1020,5.0,21400,990,4.85,21000,21430,1399-9-16
255,جم پيلن,پلي پروپيلن جم - جم پيلن,1850,1572143,147275562150,91030,93800,92510,1480,1.63,93680,2650,2.91,91740,95480,1399-9-16
256,فنورد,نوردوقطعات‌ فولادي‌,1847,626252,112694296450,174410,182000,177990,3580,2.05,179950,5540,3.18,172200,183110,1399-9-16
257,بركت,گروه دارويي بركت,1845,14562782,286013038480,18710,19640,19640,930,4.97,19640,930,4.97,19640,19640,1399-9-16
258,كپشيرح,ح . پشم‌شيشه‌ايران‌,1835,5821195,77590746538,13658,13970,12920,-738,-5.4,13329,-329,-2.41,12700,14067,1399-9-16
259,كلوند,كاشي‌ الوند,1819,3671997,100264205030,26590,27910,26540,-50,-0.19,27310,720,2.71,26000,27910,1399-9-16
260,دسانكو,داروسازي سبحان انكولوژي,1809,5151851,98423253507,18298,19212,19212,914,5.0,19104,806,4.4,18400,19212,1399-9-16
261,دانا,بيمه دانا,1777,16611567,129041273590,7400,7770,7770,370,5.0,7770,370,5.0,7690,7770,1399-9-16
262,قجام,فرآوردههاي غذايي وقندتربت‌جام‌,1776,12086252,137087244937,11657,11600,11400,-257,-2.2,11342,-315,-2.7,11308,11600,1399-9-16
263,وآرين,شركت توسعه اقتصادي آرين,1775,10378034,62889302544,6046,5910,6000,-46,-0.76,6060,14,0.23,5910,6210,1399-9-16
264,زگلدشت,كشت و دام گلدشت نمونه اصفهان,1771,2157406,98972307428,43933,46129,46129,2196,5.0,45876,1943,4.42,43988,46129,1399-9-16
265,پلاسك,پلاسكوكار,1757,12431132,113107620290,8680,9110,9110,430,4.95,9100,420,4.84,8900,9110,1399-9-16
266,پخش,پخش البرز,1739,4658434,219144556280,44820,47061,47061,2241,5.0,47043,2223,4.96,46437,47061,1399-9-16
267,پارند,صندوق س. پارند پايدار سپهر,1737,76902038,871356142617,11420,11350,11283,-137,-1.2,11331,-89,-0.78,11250,11368,1399-9-16
268,كمينا,شيشه سازي مينا,1721,3298517,130662747679,38956,40903,38050,-906,-2.33,39613,657,1.69,37220,40903,1399-9-16
269,غگرجي,بيسكويت‌  گرجي‌,1709,3178715,114079214060,35620,36050,35770,150,0.42,35890,270,0.76,35360,37050,1399-9-16
270,تيپيكو,سرمايه گذاري دارويي تامين,1703,2295244,143082799480,60710,63200,61990,1280,2.11,62340,1630,2.68,60000,63200,1399-9-16
271,كسرام,پارس‌ سرام‌,1700,16500440,153578857610,8870,9310,9310,440,4.96,9310,440,4.96,9160,9310,1399-9-16
272,شوينده,مديريت صنعت شوينده ت.ص.بهشهر,1678,2850888,125490673000,42640,44000,43820,1180,2.77,44020,1380,3.24,42100,44770,1399-9-16
273,قلرست,قند لرستان‌,1659,3751313,106492420410,28760,30190,27330,-1430,-4.97,28390,-370,-1.29,27330,30190,1399-9-16
274,رتاپ,تجارت الكترونيك  پارسيان,1656,6091866,45980102770,7280,7640,7550,270,3.71,7510,230,3.16,7420,7640,1399-9-16
275,تسه9908,امتياز تسهيلات مسكن آبان99,1645,35780,22170494584,632738,632738,603335,-29403,-4.65,619634,-13104,-2.07,603123,632738,1399-9-16
276,سفانو,سيمان فارس نو,1643,3427253,125726899020,35450,37220,37100,1650,4.65,36680,1230,3.47,34520,37220,1399-9-16
277,دفارا,داروسازي‌ فارابي‌,1634,1864971,135128055490,71170,74100,71400,230,0.32,72460,1290,1.81,70100,74100,1399-9-16
278,كساوه,صنايع‌ كاشي‌ و سراميك‌ سينا,1633,3072457,269383630450,83580,87400,87750,4170,4.99,87680,4100,4.91,86350,87750,1399-9-16
279,واعتبار,سرمايه گذاري اعتبار ايران,1626,17681388,106372514360,6070,6060,6020,-50,-0.82,6020,-50,-0.82,5770,6170,1399-9-16
280,اتكاي,بيمه اتكايي ايرانيان,1617,7514727,118546334891,15907,15910,15820,-87,-0.55,15775,-132,-0.83,15131,16620,1399-9-16
281,شپديس,پتروشيمي پرديس,1600,1738368,199567169600,113200,116550,114020,820,0.72,114800,1600,1.41,113390,118500,1399-9-16
282,طلا,صندوق س.پشتوانه طلاي لوتوس,1592,861762,74413367127,84927,85000,87400,2473,2.91,86350,1423,1.68,84561,87630,1399-9-16
283,وصنا,گروه‌صنايع‌بهشهرايران‌,1575,8053882,114967219920,14170,14630,14280,110,0.78,14270,100,0.71,13800,14690,1399-9-16
284,آوا,صندوق س.سهام آواي معيار-س,1569,8251958,80509355627,9425,9550,9800,375,3.98,9756,331,3.51,9550,9959,1399-9-16
285,پرديس,سرمايه گذاري پرديس,1566,14729500,116353028490,7540,7760,7910,370,4.91,7900,360,4.77,7700,7910,1399-9-16
286,كنور,توسعه معدني و صنعتي صبانور,1565,4034393,202800546900,48220,50600,50230,2010,4.17,50270,2050,4.25,49000,50630,1399-9-16
287,شسپا,نفت سپاهان,1549,7429625,204220720030,26220,27500,27530,1310,5.0,27490,1270,4.84,27010,27530,1399-9-16
288,دعبيد,لابراتوارداروسازي‌  دكترعبيدي‌,1543,2262732,76506650920,32340,33000,33890,1550,4.79,33810,1470,4.55,32300,33950,1399-9-16
289,وسبحان,سرمايه گذاري سبحان,1530,7247737,68593919307,9144,9400,9370,226,2.47,9464,320,3.5,9160,9600,1399-9-16
290,پارس,پتروشيمي پارس,1528,1674455,279714610690,166990,169000,166000,-990,-0.59,167050,60,0.04,164000,169850,1399-9-16
291,حتوكا,حمل‌ونقل‌توكا,1522,6527533,131683135390,19540,20100,20510,970,4.96,20170,630,3.22,19550,20510,1399-9-16
292,غشصفا,شيرپاستوريزه‌پگاه‌اصفهان‌,1502,2482563,77559955590,32190,32880,30590,-1600,-4.97,31240,-950,-2.95,30590,32880,1399-9-16
293,خفنر,فنرسازي‌خاور,1498,5618173,117401407320,19940,20930,20930,990,4.96,20900,960,4.81,20400,20930,1399-9-16
294,زكشت,كشاورزي مكانيزه اصفهان كشت,1496,2241472,70605890474,31692,33250,31150,-542,-1.71,31500,-192,-0.61,30600,33250,1399-9-16
295,بنو,بيمه تجارت نو,1495,19828582,570907061422,27422,28793,28793,1371,5.0,28792,1370,5.0,28649,28793,1399-9-16
296,ساروم,سيمان‌اروميه‌,1494,3084726,88064518150,27490,28790,28860,1370,4.98,28550,1060,3.86,27700,28860,1399-9-16
297,كرماشا,صنايع پتروشيمي كرمانشاه,1493,2833346,129896817790,45640,46760,45200,-440,-0.96,45850,210,0.46,44810,46760,1399-9-16
298,پارسيان,بيمه پارسيان,1483,5449948,82274632470,15510,15890,15060,-450,-2.9,15100,-410,-2.64,14740,15900,1399-9-16
299,حآسا,آسيا سير ارس,1482,6853044,173470238165,24209,25419,25419,1210,5.0,25313,1104,4.56,24710,25419,1399-9-16
300,اتكام,شركت بيمه اتكايي امين,1479,6698135,46007554547,6888,7010,6800,-88,-1.28,6870,-18,-0.26,6730,7040,1399-9-16
301,خفناور,مهندسي صنعتي روان فن آور,1463,3621982,97351517872,26475,27260,27269,794,3.0,26878,403,1.52,25684,27269,1399-9-16
302,كاذرح,ح . فرآورده‌هاي‌نسوزآذر,1460,3813749,66363276850,16490,16600,17850,1360,8.25,17400,910,5.52,16600,17850,1399-9-16
303,سرچشمه,سرمايه گذاري مس سرچشمه,1456,10570444,96880086068,8734,9170,9170,436,4.99,9165,431,4.93,9010,9170,1399-9-16
304,تماوند,تامين سرمايه دماوند,1453,11946077,167633499929,13979,14377,14060,81,0.58,14033,54,0.39,13610,14380,1399-9-16
305,خمحركه,نيرو محركه‌,1432,10169533,81559654660,7640,8020,8020,380,4.97,8020,380,4.97,8020,8020,1399-9-16
306,وزمين,بانك ايران زمين,1430,6622275,84635334991,12799,13053,12560,-239,-1.87,12780,-19,-0.15,12550,13053,1399-9-16
307,دالبر,البرزدارو,1421,3904163,98586899290,24130,25270,25270,1140,4.72,25250,1120,4.64,24910,25330,1399-9-16
308,غدشت,دشت‌ مرغاب‌,1408,882555,234417197050,257910,265000,270800,12890,5.0,265610,7700,2.99,260000,270800,1399-9-16
309,ختراكح,ح . ريخته‌گري‌ تراكتورسازي‌,1404,5208992,84690029530,14780,16260,16260,1480,10.01,16260,1480,10.01,16000,16260,1399-9-16
310,قشكر,شكرشاهرود,1403,2035041,98725248120,46710,49040,48800,2090,4.47,48510,1800,3.85,45380,49040,1399-9-16
311,خوساز,محورسازان‌ايران‌خودرو,1395,11451426,92397484430,7690,8070,8070,380,4.94,8070,380,4.94,8000,8070,1399-9-16
312,افرا,افرانت,1387,1441503,73801323109,49085,51500,51180,2095,4.27,51197,2112,4.3,49350,51539,1399-9-16
313,كاذر,فرآورده‌هاي‌نسوزآذر,1380,4248728,85640750480,19320,19740,20280,960,4.97,20160,840,4.35,19400,20280,1399-9-16
314,اميد,تامين سرمايه اميد,1377,9976730,138623773820,13240,13900,13900,660,4.98,13890,650,4.91,13400,13900,1399-9-16
315,چفيبر,فيبر ايران‌,1356,15181994,108999771040,6900,6900,7240,340,4.93,7180,280,4.06,6810,7240,1399-9-16
316,فولاژ,فولاد آلياژي ايران,1347,2730806,77678870070,27270,28260,28600,1330,4.88,28450,1180,4.33,27810,28630,1399-9-16
317,انرژي3,سايراشخاص بورس انرژي,1337,343474,114091758580,316360,332170,332170,15810,5.0,332170,15810,5.0,332170,332170,1399-9-16
318,وخاور,بانك خاورميانه,1334,10274228,111364754370,10810,11200,10770,-40,-0.37,10840,30,0.28,10560,11200,1399-9-16
319,فخاس,فولاد خراسان,1334,4743618,160413430780,32350,33000,33960,1610,4.98,33820,1470,4.54,32350,33960,1399-9-16
320,كاردان,صندوق س تجارت شاخصي كاردان,1312,528315,101872983580,186370,190110,192650,6280,3.37,192830,6460,3.47,189800,195900,1399-9-16
321,رتكو,كنترل‌خوردگي‌تكين‌كو,1306,4792921,92546422610,18490,19400,18810,320,1.73,19310,820,4.43,18670,19410,1399-9-16
322,كهمدا,شيشه‌ همدان‌,1290,5017258,64698361610,12410,13000,13030,620,5.0,12900,490,3.95,12650,13030,1399-9-16
323,فباهنر,مس‌ شهيدباهنر,1290,2029439,115028259310,55450,57600,56370,920,1.66,56680,1230,2.22,55600,57900,1399-9-16
324,چكاوه,صنايع‌كاغذسازي‌كاوه‌,1287,3073807,88566991510,27630,28170,29010,1380,4.99,28810,1180,4.27,27760,29010,1399-9-16
325,فيروزه,صندوق شاخص30 شركت فيروزه- سهام,1256,475394,89655612130,183070,186100,188800,5730,3.13,188590,5520,3.02,186030,190970,1399-9-16
326,غشاذر,پگاه‌آذربايجان‌غربي‌,1251,2985350,66539468340,21250,22300,22200,950,4.47,22290,1040,4.89,21920,22310,1399-9-16
327,كشرق,صنعتي و معدني شمال شرق شاهرود,1249,2104880,171081277488,81621,80031,83900,2279,2.79,81278,-343,-0.42,79000,83990,1399-9-16
328,كمنگنز,معادن‌منگنزايران‌,1238,711877,77008987990,105880,110000,107700,1820,1.72,108180,2300,2.17,103090,111170,1399-9-16
329,فافزا,فولاد افزا سپاهان,1236,4395435,181844127341,42630,41352,41352,-1278,-3.0,41371,-1259,-2.95,41352,42275,1399-9-16
330,كپرور,فرآوري زغال سنگ پروده طبس,1236,1829817,82852930739,46849,46900,44870,-1979,-4.22,45279,-1570,-3.35,44507,47810,1399-9-16
331,لخزر,پارس‌ خزر,1229,555258,103701373020,180150,175010,189150,9000,5.0,186760,6610,3.67,175010,189150,1399-9-16
332,وسديد,گروه ‌صنعتي‌سديد,1226,7517161,158288859177,20444,21057,21057,613,3.0,21057,613,3.0,21057,21057,1399-9-16
333,بسويچ,پارس‌سويچ‌,1185,1418730,60190459520,43310,43290,41460,-1850,-4.27,42430,-880,-2.03,41150,43750,1399-9-16
334,شخارك,پتروشيمي‌ خارك‌,1180,2130331,102460043290,47370,48900,48350,980,2.07,48080,710,1.5,47000,49100,1399-9-16
335,تبرك,گروه كارخانجات صنعتي تبرك,1173,3323073,89683094124,25703,26988,26988,1285,5.0,26988,1285,5.0,26988,26988,1399-9-16
336,ضخود1044,اختيارخ خودرو-4000-1399/10/07,1164,42149,21647635000,492,515,516,24,4.88,514,22,4.47,485,550,1399-9-16
337,وسين,بيمه سينا,1161,11117001,296286412994,25458,25700,26730,1272,5.0,26652,1194,4.69,25587,26730,1399-9-16
338,حپارسا,توسعه حمل و نقل ريلي پارسيان,1160,3536894,128574612394,34655,36000,36387,1732,5.0,36352,1697,4.9,35300,36387,1399-9-16
339,سغرب,سيمان‌غرب‌,1137,2527571,51706307560,19850,20840,20700,850,4.28,20440,590,2.97,19510,20840,1399-9-16
340,اوان,مبين وان كيش,1130,1652345,105860789523,66521,64561,63230,-3291,-4.95,64067,-2454,-3.69,63195,65900,1399-9-16
341,غسالم,سالمين‌,1123,11073325,58577889250,5040,5290,5290,250,4.96,5290,250,4.96,5290,5290,1399-9-16
342,وبشهر,توسعه‌ صنايع‌ بهشهر(هلدينگ,1118,5901230,111281825140,18070,18970,18790,720,3.98,18860,790,4.37,18300,18970,1399-9-16
343,سمازن,سيمان‌مازندران‌,1116,10243879,115599391720,10760,11290,11290,530,4.93,11280,520,4.83,11010,11290,1399-9-16
344,آساس,صندوق س.آسمان آرماني سهام-س,1115,868404,152720664026,173735,174003,174021,286,0.16,175864,2129,1.23,173511,178500,1399-9-16
345,وسپه,سرمايه‌گذاري‌ سپه‌,1111,9191015,142159459510,14740,15460,15470,730,4.95,15470,730,4.95,15170,15470,1399-9-16
346,شاوان,پالايش نفت لاوان,1109,2367003,282556790669,113970,117000,119668,5698,5.0,119373,5403,4.74,116200,119668,1399-9-16
347,شتوكا,توكا رنگ فولاد سپاهان,1108,1923551,81809442105,40856,42300,42898,2042,5.0,42530,1674,4.1,41200,42898,1399-9-16
348,فپنتا,سپنتا,1105,201881,66569449780,327650,332100,328000,350,0.11,329750,2100,0.64,327000,338610,1399-9-16
349,شراز,پالايش نفت شيراز,1102,1553760,175629418868,107920,110000,113316,5396,5.0,113035,5115,4.74,110000,113316,1399-9-16
350,بميلا,توسعه بازرگاني آهن وفولادميلاد,1098,3720289,82487502966,21278,21700,22341,1063,5.0,22172,894,4.2,21570,22341,1399-9-16
351,كساپا,سايپاشيشه‌,1087,3329428,90657809970,26550,27000,27660,1110,4.18,27230,680,2.56,26500,27780,1399-9-16
352,غالبر,لبنيات‌ كالبر,1082,7432143,97547685710,12510,13130,13130,620,4.96,13130,620,4.96,12510,13130,1399-9-16
353,غفارس,شير پاستوريزه پگاه فارس,1077,3641050,35128034459,9317,9569,9530,213,2.29,9541,224,2.4,9400,9750,1399-9-16
354,ومعادنح,ح . توسعه‌معادن‌وفلزات‌,1074,50298334,733142289190,13570,14930,14500,930,6.85,14580,1010,7.44,14500,14930,1399-9-16
355,ولشرق,ليزينگ ايران و شرق,1070,9131309,63212574535,6651,6983,6850,199,2.99,6923,272,4.09,6720,6983,1399-9-16
356,فالوم,آلومتك‌,1068,2355040,52698437851,22952,23480,22264,-688,-3.0,22377,-575,-2.51,22264,23480,1399-9-16
357,گشان,توسعه بين المللي پديده شانديز,1064,451552,32871179392,75829,72796,72796,-3033,-4.0,73524,-2305,-3.04,72796,72796,1399-9-16
358,غپآذر,شير پگاه آذربايجان شرقي,1055,1862874,110829442673,56905,57000,59730,2825,4.96,59494,2589,4.55,57000,59750,1399-9-16
359,سبهان,سيمان‌ بهبهان‌,1044,782051,48770690600,59540,62280,62510,2970,4.99,62060,2520,4.23,60680,62510,1399-9-16
360,ولانا,شركت ليزينگ آريا دانا,1043,2507222,47642919990,19250,19700,18673,-577,-3.0,19002,-248,-1.29,18673,19700,1399-9-16
361,ثاژن,سخت آژند,1039,6889436,54177408986,7747,7820,7901,154,1.99,7864,117,1.51,7612,7901,1399-9-16
362,ثاخت,بين‌المللي‌توسعه‌ساختمان,1034,15677249,69293440580,4210,4420,4420,210,4.99,4420,210,4.99,4420,4420,1399-9-16
363,كيان,صندوق س. با درآمد ثابت كيان,1034,31293085,819715856125,26180,26195,26200,20,0.08,26195,15,0.06,26192,26200,1399-9-16
364,شنفت,نفت‌ پارس‌,1032,1125160,71873967720,63690,62260,63140,-550,-0.86,63880,190,0.3,62260,65980,1399-9-16
365,كپارس,كاشي‌ پارس‌,1023,1038775,170536167260,156380,164190,164190,7810,4.99,164170,7790,4.98,161000,164190,1399-9-16
366,شفارا,پتروشيمي فارابي,1021,12224324,59583607857,4744,4860,4886,142,2.99,4874,130,2.74,4795,4886,1399-9-16
367,غشهد,شهد ايران ‌,1021,4940042,35395855720,6830,7140,7170,340,4.98,7050,220,3.22,7100,7170,1399-9-16
368,خمحور,توليدمحورخودرو,1008,1162285,81939218630,68040,71420,71270,3230,4.75,70500,2460,3.62,68040,71430,1399-9-16
369,وسلرستا,شركت س استان لرستان,991,41061333,37181736490,940,910,920,-20,-2.13,910,-30,-3.19,900,930,1399-9-16
370,مبين,مبين انرژي خليج فارس,987,2588256,63050324030,24350,23400,24020,-330,-1.36,24360,10,0.04,23400,24800,1399-9-16
371,بساما,بيمه سامان,973,19910360,670701177827,32083,33687,33686,1603,5.0,33686,1603,5.0,32300,33687,1399-9-16
372,اطلس,صندوق س.توسعه اندوخته آينده-س,968,216310,46963046029,210702,214990,216510,5808,2.76,217110,6408,3.04,214499,218997,1399-9-16
373,ساربيل,سيمان آرتا اردبيل,965,1339797,69063486380,49300,50290,51760,2460,4.99,51550,2250,4.56,50000,51760,1399-9-16
374,دپارس,پارس‌ دارو,963,542297,57372169310,105010,108000,105010,0,0.0,105790,780,0.74,103010,108000,1399-9-16
375,فلات,گروه صنايع معادن فلات ايرانيان,960,5632393,86430342916,15283,14825,15480,197,1.29,15345,62,0.41,14825,15741,1399-9-16
376,بكاب,صنايع‌جوشكاب‌يزد,950,334114,98971220660,282330,296400,296440,14110,5.0,296220,13890,4.92,290000,296440,1399-9-16
377,واميد,گروه مديريت سرمايه گذاري اميد,945,2677904,106502593950,39060,40960,39110,50,0.13,39660,600,1.54,39080,40960,1399-9-16
378,عيار,صندوق س. پشتوانه طلاي مفيد,943,1259457,36974782504,28841,28960,29621,780,2.7,29358,517,1.79,28639,29729,1399-9-16
379,كسرا,سراميك‌هاي‌صنعتي‌اردكان‌,934,2948878,92430655110,29990,31420,31480,1490,4.97,31340,1350,4.5,30310,31480,1399-9-16
380,ثنور,سرمايه گذاري كوه نور,933,10956636,77566946761,6874,7070,7080,206,3.0,7079,205,2.98,7020,7080,1399-9-16
381,پارتا,مجتمع‌صنعتي‌آرتاويل‌تاير,932,1562014,87684701054,55005,55900,56655,1650,3.0,56136,1131,2.06,54600,56655,1399-9-16
382,حبندر,دريايي و کشتيراني خط دريابندر,922,2153175,68041637007,30684,31600,31604,920,3.0,31601,917,2.99,31500,31604,1399-9-16
383,كي بي سي,شركت كي بي سي,919,2457973,83064293163,32359,33976,33950,1591,4.92,33794,1435,4.43,32976,33976,1399-9-16
384,غچين,كشت‌ و صنعت‌ چين‌ چين,908,1564222,84322287990,53090,54300,53340,250,0.47,53910,820,1.54,51700,54990,1399-9-16
385,پاسا,ايران‌ياساتايرورابر,902,7073355,205033028810,27610,28990,28990,1380,5.0,28990,1380,5.0,27900,28990,1399-9-16
386,سخوز,سيمان خوزستان,896,3308978,87608951330,25220,26480,26480,1260,5.0,26480,1260,5.0,26400,26480,1399-9-16
387,كفرا,فراورده‌ هاي‌ نسوزايران‌,883,1078593,58875759510,52760,54540,55390,2630,4.98,54590,1830,3.47,53550,55390,1399-9-16
388,دروز,داروسازي‌ روزدارو,881,1882195,33771890870,17890,18600,18240,350,1.96,17930,40,0.22,17000,18770,1399-9-16
389,لوتوس,تامين سرمايه لوتوس پارسيان,870,3450894,53215937300,15080,15080,15300,220,1.46,15410,330,2.19,15080,15600,1399-9-16
390,زپارس,ملي كشت و صنعت و دامپروري پارس,868,1631453,129192121750,76280,77000,80090,3810,4.99,79190,2910,3.81,74020,80090,1399-9-16
391,شفا,سرمايه گذاري شفادارو,867,1722710,105493713060,58410,61000,61330,2920,5.0,61240,2830,4.85,60000,61330,1399-9-16
392,دتماد,توليدمواداوليه‌داروپخش‌,858,962001,54342509360,55010,57200,56300,1290,2.35,56490,1480,2.69,55060,57600,1399-9-16
393,خديزل,بهمن  ديزل,857,2529042,134799755069,52044,53999,52500,456,0.88,53301,1257,2.42,52044,54373,1399-9-16
394,افق ملت,صندوق س در سهام افق ملت,857,253063,37942150230,141770,146000,149900,8130,5.73,149930,8160,5.76,145000,151940,1399-9-16
395,گوهران,سرمايه گذاري توسعه گوهران اميد,846,6109216,56965438396,8891,9177,9334,443,4.98,9325,434,4.88,9177,9335,1399-9-16
396,بالبر,كابل‌ البرز,841,1637390,39676435390,23970,25000,24010,40,0.17,24170,200,0.83,23000,25000,1399-9-16
397,وگستر,گسترش سرمايه گذاري ايرانيان,837,5827881,153474746888,25091,26000,26345,1254,5.0,26335,1244,4.96,25900,26345,1399-9-16
398,دتوليد,داروسازي توليد دارو,808,5556362,193061354052,33092,34746,34746,1654,5.0,34746,1654,5.0,34746,34746,1399-9-16
399,سشمال,سيمان‌ شمال‌,808,4142405,38925468590,9010,9460,9460,450,4.99,9290,280,3.11,9110,9460,1399-9-16
400,كاريس,صندوق س.سپهر كاريزما-س,805,463935,101234709101,213138,215500,217400,4262,2.0,218209,5071,2.38,213001,220578,1399-9-16
401,شگل,گلتاش‌,804,1784359,50184073120,27590,28900,28100,510,1.85,28110,520,1.88,27800,28910,1399-9-16
402,خراسان,پتروشيمي خراسان,802,806131,64245503620,78350,78960,78900,550,0.7,79700,1350,1.72,78340,81950,1399-9-16
403,خموتور,موتورسازان‌تراكتورسازي‌ايران‌,795,4504147,49967286340,10590,10960,11110,520,4.91,11050,460,4.34,10910,11110,1399-9-16
404,كپشير,پشم‌شيشه‌ايران‌,793,1436138,27240851680,19180,20000,18460,-720,-3.75,19060,-120,-0.63,18310,20000,1399-9-16
405,ونيرو,سرمايه‌گذاري‌نيرو,790,14863199,72532411120,4650,4880,4880,230,4.95,4880,230,4.95,4880,4880,1399-9-16
406,وپخش,داروپخش‌ (هلدينگ‌,783,433494,62327851610,140510,147000,146950,6440,4.58,143780,3270,2.33,140000,147000,1399-9-16
407,غمارگ,مارگارين‌,762,2755713,110487098020,38210,40120,40120,1910,5.0,40090,1880,4.92,38210,40120,1399-9-16
408,مارون,پتروشيمي مارون,762,667387,100412551061,143430,150601,150601,7171,5.0,149899,6469,4.51,146101,150601,1399-9-16
409,شيراز,پتروشيمي‌شيراز,759,1472777,87582368280,58490,59200,59400,910,1.56,59330,840,1.44,57890,60480,1399-9-16
410,فنرژي,گسترش صنايع انرژي آذرآب,747,3059449,30030663723,9992,9793,9850,-142,-1.42,9816,-176,-1.76,9793,9992,1399-9-16
411,سباقر,سيمان باقران,733,2125306,30683417039,14508,14508,14305,-203,-1.4,14437,-71,-0.49,14200,14800,1399-9-16
412,هجرت,پخش هجرت,731,449701,30559241008,67194,70550,66000,-1194,-1.78,67641,447,0.67,65280,70550,1399-9-16
413,فسپا,گروه‌صنعتي‌سپاهان‌,716,1395677,66929857050,46100,47880,48400,2300,4.99,47960,1860,4.03,46700,48400,1399-9-16
414,كمرجان,بازرگاني و توليدي مرجان كار,711,743047,54106453399,69350,72817,72817,3467,5.0,72817,3467,5.0,72817,72817,1399-9-16
415,ركيش,كارت اعتباري ايران كيش,710,3228013,54445143200,16740,16730,16760,20,0.12,16870,130,0.78,15960,17270,1399-9-16
416,غشهداب,كشت و صنعت شهداب ناب خراسان,697,6689125,32127867375,4575,4803,4803,228,4.98,4711,136,2.97,4803,4803,1399-9-16
417,غمينو,شركت صنايع غذايي مينو شرق,689,3621041,49459799019,13009,13659,13659,650,5.0,13602,593,4.56,13659,13659,1399-9-16
418,دارو,كارخانجات‌داروپخش‌,678,557416,32888087210,56660,59490,58830,2170,3.83,58100,1440,2.54,58200,59490,1399-9-16
419,وتوسم,سرمايه‌گذاري‌توسعه‌ملي‌,677,6062542,82735440300,13020,13250,13670,650,4.99,13650,630,4.84,13250,13670,1399-9-16
420,حخزر,كشتيراني درياي خزر,670,1115616,28937267547,26677,27300,25800,-877,-3.29,26232,-445,-1.67,25500,27300,1399-9-16
421,تملتح,ح . تامين سرمايه بانك ملت,669,21823589,174588712000,8000,8000,8000,0,0.0,8000,0,0.0,8000,8000,1399-9-16
422,دجابر,داروسازي‌ جابرابن‌حيان‌,669,1529327,66529211900,41570,42740,43640,2070,4.98,43500,1930,4.64,42370,43640,1399-9-16
423,زر,صندوق س.پشتوانه سكه طلاي زر,668,571460,28875765220,49956,49890,50950,994,1.99,50530,574,1.15,49890,50985,1399-9-16
424,داسوه,داروسازي‌ اسوه‌,662,1538285,47634178760,29510,30970,30980,1470,4.98,30800,1290,4.37,30470,30980,1399-9-16
425,غگلستا,شير پاستوريزه پگاه گلستان,660,3892280,71052027400,17392,18261,18261,869,5.0,18255,863,4.96,17750,18261,1399-9-16
426,دسبحا,گروه دارويي سبحان,659,3022415,65630404360,20700,21730,21730,1030,4.98,21710,1010,4.88,21500,21730,1399-9-16
427,ثنام,س ساختماني ب نام آوران مهندسي,646,2416937,51468673415,20675,21295,21295,620,3.0,21295,620,3.0,21295,21295,1399-9-16
428,وتوشه,سرمايه‌ گذاري‌ پارس‌ توشه‌,632,2470091,61678851880,24110,24500,25310,1200,4.98,24970,860,3.57,24110,25310,1399-9-16
429,ختور,رادياتور ايران‌,625,960362,40536880020,40200,42210,42210,2010,5.0,41690,1490,3.71,42210,42210,1399-9-16
430,سكرما,سيمان‌ كرمان‌,625,2085303,32930803990,15360,16000,15910,550,3.58,15630,270,1.76,15360,16120,1399-9-16
431,بورس,بورس اوراق بهادار تهران,621,2365645,144682848200,58250,61160,61160,2910,5.0,61160,2910,5.0,61160,61160,1399-9-16
432,ثعتما,س. ساختماني اعتماد گستر,609,1193069,50795224467,41369,42610,42610,1241,3.0,42575,1206,2.92,41369,42610,1399-9-16
433,وثوق,سرمايه گذاري وثوق امين,608,2148506,26666250907,11868,12461,12300,432,3.64,12412,544,4.58,12000,12461,1399-9-16
434,شپلي,پلي اكريل ايران,608,8812168,77071221328,8492,8746,8746,254,2.99,8746,254,2.99,8746,8746,1399-9-16
435,سفار,سيمان‌فارس‌,590,625936,54307555300,83910,88080,88100,4190,4.99,86760,2850,3.4,79720,88100,1399-9-16
436,دسبحان,سبحان دارو,580,2945242,71226158590,23040,24190,24190,1150,4.99,24180,1140,4.95,23860,24190,1399-9-16
437,چدن,توليدي چدن سازان,570,1704031,63406791150,36180,37000,37400,1220,3.37,37210,1030,2.85,36220,37780,1399-9-16
438,قهكمت,قندهكمتان‌,555,767224,42133195650,53460,56130,53470,10,0.02,54620,1160,2.17,53460,56130,1399-9-16
439,دامين,داروسازي‌ امين‌,554,2541377,39476942730,14800,15540,15540,740,5.0,15330,530,3.58,15300,15540,1399-9-16
440,غپينو,پارس‌ مينو,550,7696414,65111662440,8060,8460,8460,400,4.96,8460,400,4.96,8460,8460,1399-9-16
441,مفاخر,توسعه فناوري اطلاعات خوارزمي,550,805994,38106434613,45045,47297,47297,2252,5.0,46625,1580,3.51,46110,47297,1399-9-16
442,خكاوه,سايپا ديزل,545,15852402,79372976814,4862,5007,5007,145,2.98,5007,145,2.98,5007,5007,1399-9-16
443,آتيمس,صندوق س.آرمان آتيه درخشان مس-س,544,166828,37943152941,223171,222500,227200,4029,1.81,227439,4268,1.91,222500,228996,1399-9-16
444,غگلپا,شير پاستوريزه پگاه گلپايگان,543,449354,32047531797,70620,73800,70010,-610,-0.86,71067,447,0.63,69550,73800,1399-9-16
445,حتايد,تايدواترخاورميانه,539,2314147,49439074670,20450,21180,21470,1020,4.99,21310,860,4.21,21000,21470,1399-9-16
446,وساغربي,شركت س استان آذربايجان غربي,530,19936641,17128943230,890,860,860,-30,-3.37,880,-10,-1.12,850,880,1399-9-16
447,ساينا,صنايع بهداشتي ساينا,522,161293,31537934353,188695,184000,196900,8205,4.35,192846,4151,2.2,184000,198129,1399-9-16
448,سخاش,سيمان‌خاش‌,519,252342,24225632250,91440,96010,96010,4570,5.0,93500,2060,2.25,95720,96010,1399-9-16
449,خودكفا,اقتصادي و خودكفايي آزادگان,517,2739867,88763471199,31454,32397,32397,943,3.0,32397,943,3.0,32397,32397,1399-9-16
450,فلوله,لوله‌وماشين‌سازي‌ايران‌,515,3465745,89624165700,24630,25860,25860,1230,4.99,25860,1230,4.99,25860,25860,1399-9-16
451,ولراز,ليزينگ رازي,511,900965,34152840317,36302,38117,38117,1815,5.0,37907,1605,4.42,36901,38117,1399-9-16
452,سكه0012پ01,سكه تمام بهارتحويلي 1روزه رفاه,504,179000,212698457900,1172521,1172111,1212002,39481,3.37,1188259,15738,1.34,1172111,1214955,1399-9-16
453,سدبير,س. تدبيرگران فارس وخوزستان,503,816940,35516316995,41408,43478,43478,2070,5.0,42761,1353,3.27,42059,43478,1399-9-16
454,دلر,داروسازي‌ اكسير,501,684112,81084733670,113170,116990,118820,5650,4.99,118530,5360,4.74,116000,118820,1399-9-16
455,پارند2,صندوق س. پارند پايدار سپهر,500,50000000,50000000,11420,1,1,-11419,-99.99,1,-11419,-99.99,1,1,1399-9-16
456,دكيمي,كيميدارو,499,1967610,55567310970,26950,28290,28290,1340,4.97,28240,1290,4.79,27800,28290,1399-9-16
457,دزهراوي,داروسازي‌زهراوي‌,496,2531617,33645189930,12660,13290,13290,630,4.98,13050,390,3.08,13290,13290,1399-9-16
458,ولتجار,واسپاري تجارت وسرمايه ايرانيان,494,3292415,21992190242,6490,6684,6684,194,2.99,6680,190,2.93,6584,6684,1399-9-16
459,سجام,مجتمع سيمان غرب آسيا,490,1865794,28302830194,14901,14976,14991,90,0.6,15169,268,1.8,14976,15300,1399-9-16
460,فاما,صنعتي‌ آما,483,1460019,42130048790,27660,29000,29040,1380,4.99,28590,930,3.36,28000,29040,1399-9-16
461,كيميا,معدني كيمياي زنجان گستران,481,965670,32200883939,31768,33356,33356,1588,5.0,32717,949,2.99,33022,33356,1399-9-16
462,حفارس,حمل و نقل بين المللي خليج فارس,477,8240668,37907072800,4390,4600,4600,210,4.78,4540,150,3.42,4600,4600,1399-9-16
463,وايرا,سرمايه گذاري صنايع ايران,477,4044246,33438100755,8063,8250,8304,241,2.99,8268,205,2.54,8071,8304,1399-9-16
464,قشهد,شهد,469,788638,25501533390,30840,32380,32380,1540,4.99,31550,710,2.3,31550,32380,1399-9-16
465,ثاختح,ح . بين‌المللي‌توسعه‌ساختمان,465,7466088,26086768520,2870,3500,3480,610,21.25,3490,620,21.6,3480,3500,1399-9-16
466,خلنت,لنت‌ ترمزايران‌,462,356716,29654860210,79270,83230,83230,3960,5.0,81420,2150,2.71,80020,83230,1399-9-16
467,خاور,ايران خودرو ديزل,460,5086055,31416561735,5998,6177,6177,179,2.98,6177,179,2.98,6177,6177,1399-9-16
468,ثتران,سرمايه گذاري مسكن تهران,459,10081563,58977143550,5132,5850,5850,718,13.99,5850,718,13.99,5850,5850,1399-9-16
469,وسنا,سرمايه گذاري نيروگاهي ايران,458,2475893,39745710577,15295,16059,16053,758,4.96,16053,758,4.96,15732,16059,1399-9-16
470,فزرين,زرين معدن آسيا,446,2092026,60762895170,27662,29045,29045,1383,5.0,29045,1383,5.0,29045,29045,1399-9-16
471,ثامان,سامان‌ گستراصفهان‌,444,2966521,65530448890,21040,22090,22090,1050,4.99,22090,1050,4.99,22090,22090,1399-9-16
472,غبهنوش,بهنوش‌ ايران‌,437,945536,94137564160,90510,99560,99560,9050,10.0,99560,9050,10.0,99560,99560,1399-9-16
473,قپيرا,فرآورده‌هاي‌غدايي‌وقندپيرانشهر,431,567164,51190093210,87840,92230,91000,3160,3.6,90230,2390,2.72,88100,92230,1399-9-16
474,وكار,بانك‌ كارآفرين‌,428,18989956,85075002880,4270,4480,4480,210,4.92,4480,210,4.92,4480,4480,1399-9-16
475,دقاضي,داروسازي شهيد قاضي,427,452955,42310114506,90698,93418,93418,2720,3.0,93409,2711,2.99,90705,93418,1399-9-16
476,دفرا,فرآورده‌هاي‌ تزريقي‌ ايران‌,427,634998,17845838530,27300,28660,27800,500,1.83,27570,270,0.99,27400,28660,1399-9-16
477,ثشرق,سرمايه گذاري مسكن شمال شرق,420,5280320,31033960580,5600,5880,5880,280,5.0,5760,160,2.86,5700,5880,1399-9-16
478,ولملت,واسپاري ملت,417,3908402,45639927260,11140,11510,11690,550,4.94,11610,470,4.22,11510,11690,1399-9-16
479,وليز,ليزينگ‌ايران‌,412,4792673,48645630950,9670,10150,10150,480,4.96,10100,430,4.45,10150,10150,1399-9-16
480,خپويش,سازه‌ پويش‌,409,1145244,43115937310,36020,36900,37820,1800,5.0,37380,1360,3.78,36010,37820,1399-9-16
481,شرانل,نفت ايرانول,408,2871323,111088615547,36847,38689,38689,1842,5.0,38689,1842,5.0,38689,38689,1399-9-16
482,غمهراح,ح . توليدي‌مهرام‌,406,289412,16036152600,56310,54600,53500,-2810,-4.99,55410,-900,-1.6,52920,57500,1399-9-16
483,وتعاون,بيمه  تعاون,405,1660587,11801143568,7059,7170,7131,72,1.02,7087,28,0.4,7059,7199,1399-9-16
484,ورنا,سرمايه‌گذاري‌ رنا(هلدينگ‌,405,4745429,48830464410,9800,10290,10290,490,5.0,10260,460,4.69,10290,10290,1399-9-16
485,سيستم,همكاران سيستم,402,541577,18219477800,33870,34990,33500,-370,-1.09,33790,-80,-0.24,33010,34990,1399-9-16
486,قچار,فراوردههاي غذايي وقند چهارمحال,400,1382776,84549838520,58234,61145,61145,2911,5.0,61145,2911,5.0,61145,61145,1399-9-16
487,تسه9907,امتياز تسهيلات مسكن مهر99,400,10323,6419677633,637436,610001,607000,-30436,-4.77,621881,-15555,-2.44,605565,629999,1399-9-16
488,سهرمز,سيمان‌هرمزگان‌,396,673440,13593591270,19530,20500,19990,460,2.36,19700,170,0.87,19880,20500,1399-9-16
489,وسفارس,شركت س استان فارس,387,7807678,7725514550,1030,1000,1000,-30,-2.91,1030,0,0.0,980,1030,1399-9-16
490,زعف0008پ10,زعفران0008نگين طلاي سرخ(پ),385,130314,16722907961,131133,129000,127890,-3243,-2.47,128328,-2805,-2.14,126100,130000,1399-9-16
491,سفاسي,شركت فارسيت اهواز,382,1387069,19002845300,13301,13700,13700,399,3.0,13653,352,2.65,13700,13700,1399-9-16
492,وسگيلا,شركت س استان گيلان,379,17452156,15144958110,900,870,880,-20,-2.22,890,-10,-1.11,860,890,1399-9-16
493,قاسم,قاسم ايران,377,5227763,70161807223,12782,13421,13421,639,5.0,13421,639,5.0,13421,13421,1399-9-16
494,نتوس,پشم‌ بافي‌ توس,375,1275110,13188687671,10052,10353,10353,301,2.99,10236,184,1.83,10210,10353,1399-9-16
495,ثالوند,سرمايه گذاري مسكن الوند,375,2329301,38917961108,15913,16708,16708,795,5.0,16475,562,3.53,16708,16708,1399-9-16
496,ولصنم,ليزينگ‌صنعت‌ومعدن‌,369,2951609,32497215090,10490,11010,11010,520,4.96,10800,310,2.96,11010,11010,1399-9-16
497,خمهر,مهركام‌پارس‌,365,4561500,36263925000,7580,7950,7950,370,4.88,7830,250,3.3,7950,7950,1399-9-16
498,فسديد,لوله‌وتجهيزات‌ سديد - ورشكسته,359,355755,38363987544,108921,106750,109900,979,0.9,107838,-1083,-0.99,106743,111099,1399-9-16
499,ددام,داروسازي زاگرس فارمد پارس,357,3766425,59697836250,15100,15850,15850,750,4.97,15850,750,4.97,15850,15850,1399-9-16
500,زعف0008پ11,زعفران0008نگين سحرخيز(پ),355,105492,13118010420,125052,123010,125000,-52,-0.04,124351,-701,-0.56,123000,125500,1399-9-16
501,شاملا,معدني‌ املاح‌  ايران‌,349,363157,23437950180,63670,63030,63970,300,0.47,64070,400,0.63,63020,65500,1399-9-16
502,خكرمان,گروه اقتصادي كرمان خودرو,346,3757670,22095099600,5600,5880,5880,280,5.0,5880,280,5.0,5880,5880,1399-9-16
503,دكوثر,داروسازي‌ كوثر,346,1527978,36977067600,23050,24200,24200,1150,4.99,23840,790,3.43,24200,24200,1399-9-16
504,وارس,سرمايه گذاري ارس صبا,342,192150,18091010053,96139,96500,93255,-2884,-3.0,94300,-1839,-1.91,93255,99000,1399-9-16
505,لبوتان,گروه‌صنعتي‌بوتان‌,340,541554,42365769420,74510,78230,78230,3720,4.99,77390,2880,3.87,78230,78230,1399-9-16
506,بمپنا,توليد برق عسلويه  مپنا,340,166787,16730036853,99501,103900,99970,469,0.47,99758,257,0.26,98500,103900,1399-9-16
507,دارا,صندوق س. دارا الگوريتم-د,339,9953631,100050661038,10030,10050,10060,30,0.3,10052,22,0.22,10038,10060,1399-9-16
508,ضصاد1104,اختيارخ وبصادر-4500-1399/11/12,333,17146,4292084000,238,251,249,11,4.62,250,12,5.04,231,267,1399-9-16
509,سدور,سيمان‌ دورود,333,5475788,56729163680,9870,10360,10360,490,4.96,10360,490,4.96,10360,10360,1399-9-16
510,وسكرمان,س.سهام عدالت استان كرمان,332,13337417,13563736480,990,1030,1030,40,4.04,1000,10,1.01,1000,1030,1399-9-16
511,فاسمين,كالسيمين‌,331,2618973,51174732420,18610,19540,19540,930,5.0,19490,880,4.73,19540,19540,1399-9-16
512,سكه9912پ04,سكه تمام بهارتحويل1روزه صادرات,331,180200,213950586900,1173142,1175000,1212999,39857,3.4,1187295,14153,1.21,1175000,1216842,1399-9-16
513,ساراب,سيمان‌ داراب‌,329,1623368,21850533280,12820,13460,13460,640,4.99,13080,260,2.03,13460,13460,1399-9-16
514,دشيري,شيرين دارو,328,116399,18659276060,160675,161990,159000,-1675,-1.04,160333,-342,-0.21,157480,164490,1399-9-16
515,معيار,سرمايه گذاري معيار صنعت پارس,321,629131,17177937602,27421,26883,27280,-141,-0.51,27304,-117,-0.43,26875,27900,1399-9-16
516,وجامي,سرمايه گذاري جامي,320,2500653,24224149015,9407,9689,9689,282,3.0,9687,280,2.98,9407,9689,1399-9-16
517,تشتاد,صنايع توليدي اشتاد ايران‌,320,886723,14539573626,15965,16443,16443,478,2.99,16265,300,1.88,16146,16443,1399-9-16
518,ثجوان,تامين مسكن جوانان,320,4595523,41549590237,8634,9000,9065,431,4.99,9041,407,4.71,8516,9065,1399-9-16
519,وآتوس,س.آرين توسكا قيمت اسمي 350ريال,319,715062,24224588740,34652,34100,33613,-1039,-3.0,33878,-774,-2.23,33613,35000,1399-9-16
520,شلرد,كود شيميايي اوره لردگان,319,4334634,47165152554,10363,10881,10881,518,5.0,10881,518,5.0,10881,10881,1399-9-16
521,اميدح,ح . تامين سرمايه اميد,318,4730956,52178026220,10500,11000,11000,500,4.76,11030,530,5.05,11000,11550,1399-9-16
522,دابور,داروسازي‌ ابوريحان‌,313,390861,20316954780,49510,51980,51980,2470,4.99,50420,910,1.84,51980,51980,1399-9-16
523,زنجان,صنايع كشاورزي وكود زنجان,312,2200984,21241696584,9370,9651,9651,281,3.0,9651,281,3.0,9651,9651,1399-9-16
524,قمرو,قند مرودشت‌,310,1090874,31687434100,27670,29050,29000,1330,4.81,28480,810,2.93,28500,29050,1399-9-16
525,كخاك,صنايع‌خاك‌چيني‌ايران‌,308,1555824,76146496350,46660,48990,48990,2330,4.99,48940,2280,4.89,48120,48990,1399-9-16
526,بشهاب,لامپ‌  پارس‌ شهاب‌,308,257908,17827138700,65860,69140,69150,3290,5.0,66950,1090,1.66,68000,69150,1399-9-16
527,كوثر,بيمه كوثر,307,2874609,52737576714,17473,18346,18346,873,5.0,18346,873,5.0,18346,18346,1399-9-16
528,ياقوت,صندوق س ياقوت آگاه-ثابت,302,7277005,83936689343,11516,11501,11535,19,0.16,11535,19,0.16,11501,11540,1399-9-16
529,ضجار1016,اختيارخ وتجارت-4000-1399/10/21,291,11527,5124300000,432,455,416,-16,-3.7,445,13,3.01,412,476,1399-9-16
530,ديران,ايران‌دارو,288,1140205,30853947300,25780,27060,27060,1280,4.97,26530,750,2.91,27060,27060,1399-9-16
531,دسينا,داروسازي‌ سينا,284,1191240,35972486050,28770,30200,30200,1430,4.97,29720,950,3.3,29900,30200,1399-9-16
532,شلعاب,لعابيران‌,284,2857490,24869820300,8320,8350,8730,410,4.93,8500,180,2.16,8350,8730,1399-9-16
533,كفرآور,فرآورده هاي سيمان شرق,283,1106722,20591238449,18082,18520,18624,542,3.0,18606,524,2.9,18330,18624,1399-9-16
534,ثشرقح,ح. سرمايه گذاري مسكن شمال شرق,281,4000000,18018747420,4100,4510,4510,410,10.0,4500,400,9.76,4500,4510,1399-9-16
535,گوهر,صندوق سكه طلاي كيان,281,192531,11381583022,57975,59000,60299,2324,4.01,59116,1141,1.97,58020,60299,1399-9-16
536,لپيام,گسترش صنايع پيام,277,654653,18768177914,27834,28669,28669,835,3.0,28580,746,2.68,28200,28669,1399-9-16
537,فنفت,صنايع تجهيزات نفت,276,3494453,51644325187,14571,14743,14930,359,2.46,14779,208,1.43,14200,15007,1399-9-16
538,نيرو,نيرو سرمايه,272,272347,13180441547,47152,49000,48000,848,1.8,47929,777,1.65,46000,49500,1399-9-16
539,كدما,معدني‌ دماوند,270,126292,36177606320,272820,286460,286460,13640,5.0,281990,9170,3.36,286460,286460,1399-9-16
540,وثنو,سرمايه گذاري ساختماني نوين,268,2893247,50189155709,16521,17347,17347,826,5.0,17347,826,5.0,17347,17347,1399-9-16
541,گپارس,امور رفاهي كارگزاران پارس,262,139343,17997278582,132959,129000,129900,-3059,-2.3,129408,-3551,-2.67,128971,134000,1399-9-16
542,ضخود1042,اختيارخ خودرو-3000-1399/10/07,260,7180,9268458000,1190,1433,1340,150,12.61,1291,101,8.49,1230,1433,1399-9-16
543,آكورد,صندوق س. آرمان آتي كوثر-د,258,6346189,187856797972,29585,29602,29609,24,0.08,29602,17,0.06,29590,29610,1399-9-16
544,دبالك,مواد اوليه دارويي البرز بالك,255,1356575,26234803925,18419,19339,19339,920,4.99,18864,445,2.42,19339,19339,1399-9-16
545,ضملت1128,اختيارخ وبملت-6000-1399/11/28,253,11269,9327451000,930,850,800,-130,-13.98,828,-102,-10.97,781,949,1399-9-16
546,بهپاك,صنعتي بهپاك,243,1032945,47546458350,43839,46030,46030,2191,5.0,45731,1892,4.32,46030,46030,1399-9-16
547,سصوفي,سيمان‌ صوفيان‌,243,701776,11579304000,15720,16500,16500,780,4.96,15890,170,1.08,16500,16500,1399-9-16
548,ضخود1048,اختيارخ خودرو-7000-1399/10/07,242,13912,240614000,25,38,17,-8,-32.0,17,-8,-32.0,12,38,1399-9-16
549,ونيكي,سرمايه‌گذاري‌ ملي‌ايران‌,241,2566275,43421373000,16120,16920,16920,800,4.96,16450,330,2.05,16920,16920,1399-9-16
550,وسيستا,شركت س استان سيستان وبلوچستان,240,10966374,9438943770,890,860,860,-30,-3.37,880,-10,-1.12,850,880,1399-9-16
551,دعبيدح,ح . داروسازي‌ دكترعبيدي‌,236,3653339,115720736090,30300,33330,31700,1400,4.62,31680,1380,4.55,31500,33330,1399-9-16
552,ضپاس1005,اختيارخ وپارس-4500-1399/10/30,233,10384,5281897000,524,590,490,-34,-6.49,509,-15,-2.86,461,590,1399-9-16
553,بنيرو,نيروترانس‌,232,609323,34658292240,54180,56880,56880,2700,4.98,55940,1760,3.25,56880,56880,1399-9-16
554,سپاس,صندوق س. پاداش سهامداري توسعه1,232,4187014,41920250307,10166,10013,10015,-151,-1.49,10012,-154,-1.51,10009,10015,1399-9-16
555,سكه0112پ03,سكه تمام بهارتحويلي1روزه سامان,231,76700,90985008500,1175431,1194889,1210980,35549,3.02,1186245,10814,0.92,1178209,1210980,1399-9-16
556,سيمرغ,سيمرغ,228,1058617,19425621950,17480,18350,18350,870,4.98,17800,320,1.83,18350,18350,1399-9-16
557,ثنوسا,نوسازي‌وساختمان‌تهران‌,224,2851431,36184659390,12090,12690,12690,600,4.96,12490,400,3.31,12690,12690,1399-9-16
558,شكف,كف,221,318530,21308379340,65585,66896,66896,1311,2.0,66896,1311,2.0,66890,66896,1399-9-16
559,لابسا,آبسال‌,220,498619,19620657650,37480,39350,39350,1870,4.99,38170,690,1.84,39350,39350,1399-9-16
560,شپترو,پتروشيمي آبادان,220,2134097,10676887291,4765,5003,5003,238,4.99,4885,120,2.52,5003,5003,1399-9-16
561,تسه9902,امتياز تسهيلات مسكن ارديبهشت99,218,3522,2165014649,632002,615010,600402,-31600,-5.0,614712,-17290,-2.74,600402,663602,1399-9-16
562,نمرينو,ايران‌ مرينوس‌,213,125147,6892679520,56480,56350,54300,-2180,-3.86,56280,-200,-0.35,54000,57630,1399-9-16
563,سمتاز,سيمان ممتازان كرمان,213,549425,12261823470,21690,22340,22340,650,3.0,22054,364,1.68,21890,22340,1399-9-16
564,حپترو,حمل و نقل پتروشيمي( سهامي عام,211,872708,24603686920,26870,28210,28210,1340,4.99,27480,610,2.27,27110,28210,1399-9-16
565,زماهان,مجتمع توليد گوشت مرغ ماهان,211,328883,8975874836,25993,27292,27292,1299,5.0,26212,219,0.84,27292,27292,1399-9-16
566,ضخود1043,اختيارخ خودرو-3500-1399/10/07,208,5466,4651098000,817,900,860,43,5.26,851,34,4.16,811,904,1399-9-16
567,وكادو,تكادو,207,1073513,22239968821,20114,20717,20717,603,3.0,20717,603,3.0,20717,20717,1399-9-16
568,غمهرا,توليدي‌مهرام‌,205,215289,12897759810,57060,59910,59910,2850,4.99,57750,690,1.21,59500,59910,1399-9-16
569,تسه9904,امتياز تسهيلات مسكن تير99,203,3052,1865533885,630790,600500,605202,-25588,-4.06,611250,-19540,-3.1,599251,633998,1399-9-16
570,تسه9906,امتياز تسهيلات مسكن شهريور99,201,2120,1369127771,647282,615850,679646,32364,5.0,645815,-1467,-0.23,615000,679646,1399-9-16
571,صايند,صندوق س. گنجينه آينده روشن-د,198,2665300,26593561870,9977,9968,9980,3,0.03,9978,1,0.01,9955,9996,1399-9-16
572,كيان2,صندوق س. با درآمد ثابت كيان,197,19700000,19700000,26180,1,1,-26179,-100.0,1,-26179,-100.0,1,1,1399-9-16
573,ثاصفا,شركت‌ ساختمان‌ اصفهان‌,196,385282,14767473778,37213,38329,38329,1116,3.0,37990,777,2.09,38329,38329,1399-9-16
574,سفارود,كارخانه فارسيت درود,195,1226918,12182068822,9735,9929,9929,194,1.99,9929,194,1.99,9929,9929,1399-9-16
575,تسه9810,امتياز تسهيلات مسكن دي98,194,4241,2584772670,627975,597005,605003,-22972,-3.66,609472,-18503,-2.95,596577,627000,1399-9-16
576,بايكا,كارخانجات كابلسازي ‌ايران‌,193,193415,10828532190,54356,55986,55986,1630,3.0,55192,836,1.54,55986,55986,1399-9-16
577,ساروج,بين المللي ساروج بوشهر,190,6602723,125937905594,18526,18008,19081,555,3.0,19074,548,2.96,18008,19081,1399-9-16
578,ولبهمن,شركت بهمن ليزينگ,186,4765479,52286835588,10450,10972,10972,522,5.0,10945,495,4.74,10972,10972,1399-9-16
579,شپارس,بين‌ المللي‌ محصولات‌  پارس‌,186,1273727,20175835680,15090,15840,15840,750,4.97,15370,280,1.86,15840,15840,1399-9-16
580,سامان,بانك سامان,181,5283906,62778087186,11535,11881,11881,346,3.0,11881,346,3.0,11881,11881,1399-9-16
581,آساميد,صندوق س.مشترك آسمان اميد -د,180,6641283,74083377036,11140,11150,11154,14,0.13,11155,15,0.13,11147,11158,1399-9-16
582,دمعيار,صندوق س. توازن معيار-د,180,8994981,90739342422,10074,10085,10085,11,0.11,10088,14,0.14,10083,10094,1399-9-16
583,غبهار,كشت وصنعت بهاران گلبهار خراسان,172,564963,23290034712,40024,41224,41224,1200,3.0,41224,1200,3.0,41224,41224,1399-9-16
584,آبين,كشت و صنعت آبشيرين,169,2797098,12164579202,4223,4349,4349,126,2.98,4294,71,1.68,4349,4349,1399-9-16
585,وحافظ,بيمه حافظ,168,347473,21744860340,60758,62580,62580,1822,3.0,62580,1822,3.0,62580,62580,1399-9-16
586,صنوين,صندوق سرمايه‌گذاري صنوين-مختلط,168,61460,6399780490,103360,104980,104030,670,0.65,104130,770,0.74,103460,105000,1399-9-16
587,فيروزا,صندوق بادرآمد ثابت فيروزه آسيا,165,2722298,58985939548,21696,21699,21609,-87,-0.4,21668,-28,-0.13,21520,21699,1399-9-16
588,وسهمدا,شركت س استان همدان,164,3558456,3100215330,900,870,880,-20,-2.22,900,0,0.0,860,890,1399-9-16
589,ضپاس1003,اختيارخ وپارس-3500-1399/10/30,163,3120,3535836000,1157,1247,1045,-112,-9.68,1133,-24,-2.07,1022,1340,1399-9-16
590,ضخود1045,اختيارخ خودرو-4500-1399/10/07,163,7213,2236407000,303,307,317,14,4.62,310,7,2.31,298,320,1399-9-16
591,وهنر,گروه توسعه هنر ايران,162,8786410,41902389290,4631,4769,4769,138,2.98,4769,138,2.98,4769,4769,1399-9-16
592,شسينا,صنايع‌شيميايي‌سينا,161,79356,11006677200,132100,138700,138700,6600,5.0,133480,1380,1.04,138700,138700,1399-9-16
593,تسه9903,امتياز تسهيلات مسكن خرداد99,160,2512,1539055930,632166,605010,600567,-31599,-5.0,612681,-19485,-3.08,600558,630000,1399-9-16
594,درهآور,دارويي ره آورد تامين,159,224501,9493698288,40275,42288,42288,2013,5.0,40631,356,0.88,42288,42288,1399-9-16
595,داوه,داروسازي آوه سينا,157,544174,9504543084,16635,17466,17466,831,5.0,16785,150,0.9,17466,17466,1399-9-16
596,كاسپين,داروسازي كاسپين تامين,155,1230990,35933784518,27801,29191,29191,1390,5.0,28737,936,3.37,29189,29191,1399-9-16
597,تكنار,مجتمع معادن مس تكنار,155,230148,24741830592,104373,107504,107504,3131,3.0,107504,3131,3.0,107504,107504,1399-9-16
598,شبصير,توليدات پتروشيمي قائد بصير,153,468407,55555880642,112959,118606,118606,5647,5.0,118606,5647,5.0,118606,118606,1399-9-16
599,ضصاد1102,اختيارخ وبصادر-3500-1399/11/12,153,4609,2865621000,617,639,610,-7,-1.13,622,5,0.81,601,642,1399-9-16
600,سصفها,سيمان‌اصفهان‌,153,227179,53825520470,225650,236930,236930,11280,5.0,236800,11150,4.94,236930,236930,1399-9-16
601,دكپسول,توليد ژلاتين كپسول ايران,151,305590,12714071950,39624,41605,41605,1981,5.0,40087,463,1.17,41605,41605,1399-9-16
602,آرمان,بيمه آرمان,148,2106914,22217408130,10043,10545,10545,502,5.0,10545,502,5.0,10545,10545,1399-9-16
603,الماس,صندوق س.امين تدبيرگران فردا-س,148,31988,4171061423,126876,129995,131000,4124,3.25,130395,3519,2.77,125500,132000,1399-9-16
604,سدشت,صنايع سيمان دشتستان,147,74056,2789763900,38180,37920,37000,-1180,-3.09,38150,-30,-0.08,36900,39000,1399-9-16
605,وثخوز,سرمايه گذاري و توسعه خوزستان,145,306378,13388283863,41707,43690,43792,2085,5.0,42930,1223,2.93,42100,43792,1399-9-16
606,شتولي,تولي‌پرس‌,145,379888,9814786368,24843,25836,25836,993,4.0,25768,925,3.72,25836,25836,1399-9-16
607,كقزوي,شيشه‌ قزوين‌,140,1531028,12781021744,8105,8348,8348,243,3.0,8254,149,1.84,8348,8348,1399-9-16
608,واحصا,احياء صنايع خراسان,138,381436,10064188860,25617,26385,26385,768,3.0,25987,370,1.44,26385,26385,1399-9-16
609,تسه9905,امتياز تسهيلات مسكن مرداد99,135,1302,804955600,632472,608832,618166,-14306,-2.26,618245,-14227,-2.25,600888,620002,1399-9-16
610,كطبس,ذغال‌سنگ‌ نگين‌ ط‌بس‌,134,272270,19442455030,69090,71600,70100,1010,1.46,69930,840,1.22,70020,72400,1399-9-16
611,سبجنو,سيمان‌ بجنورد,132,162252,5873522400,34480,36200,36200,1720,4.99,34670,190,0.55,36200,36200,1399-9-16
612,ثتوسا,س.توسعه و عمران استان اردبيل,130,269214,16332136524,63858,60666,60666,-3192,-5.0,61114,-2744,-4.3,60666,60666,1399-9-16
613,سخزر,سيمان‌ خزر,128,243253,7290292410,28550,29970,29970,1420,4.97,28740,190,0.67,29970,29970,1399-9-16
614,ارمغان,ص سرمايه گذاري ارمغان ايرانيان,128,1846526,18498399624,10154,10020,10035,-119,-1.17,10018,-136,-1.34,10000,10079,1399-9-16
615,تسه9803,امتياز تسهيلات مسكن خرداد98,124,1013,621920958,639260,607297,628000,-11260,-1.76,613940,-25320,-3.96,607297,640000,1399-9-16
616,ختراك,ريخته‌گري‌ تراكتورسازي‌ ايران‌,124,1223363,14533552440,11320,11880,11880,560,4.95,11470,150,1.33,11880,11880,1399-9-16
617,ضسپا1104,اختيارخ خساپا-3000-1399/11/26,124,4326,3228319000,599,750,785,186,31.05,746,147,24.54,672,785,1399-9-16
618,وتوكا,سرمايه‌گذاري‌توكافولاد(هلدينگ,123,1006883,11871150570,11230,11790,11790,560,4.99,11350,120,1.07,11790,11790,1399-9-16
619,هترول911,اختيارف ت پترول-14730-99/11/15,123,500000,319500000,431,639,639,208,48.26,639,208,48.26,639,639,1399-9-16
620,ساذريح,ح . آذريت‌,123,499557,2681835671,5418,5560,5361,-57,-1.05,5368,-50,-0.92,5256,5560,1399-9-16
621,تسه9711,امتياز تسهيلات مسكن بهمن 97,121,1252,819548427,682470,648374,648347,-34123,-5.0,654591,-27879,-4.09,648347,676958,1399-9-16
622,سرود,سيمان‌شاهرود,118,520950,8210172000,15010,15760,15760,750,5.0,15130,120,0.8,15760,15760,1399-9-16
623,سپر,صندوق س سپر سرمايه بيدار- ثابت,116,646657,7086743591,10786,10983,10960,174,1.61,10959,173,1.6,10900,11000,1399-9-16
624,تسه9802,امتياز تسهيلات مسكن ارديبهشت98,113,903,553613130,627700,597222,619000,-8700,-1.39,613082,-14618,-2.33,597222,620000,1399-9-16
625,تصميم,صندوق س با درآمد ثابت تصميم,108,2331491,35115053730,15000,15050,15140,140,0.93,15061,61,0.41,15040,15160,1399-9-16
626,ضپاس1002,اختيارخ وپارس-3000-1399/10/30,105,2758,4428660000,1647,1630,1473,-174,-10.56,1606,-41,-2.49,1460,1799,1399-9-16
627,خفولا,خدمات فني فولاد يزد,104,314141,11395464775,35219,36275,36275,1056,3.0,35795,576,1.64,36275,36275,1399-9-16
628,اعتلا,شركت سرمايه گذاري اعتلاء البرز,104,1233668,12025795664,9284,9748,9748,464,5.0,9388,104,1.12,9748,9748,1399-9-16
629,وسرمد,بيمه  سرمد,104,1590483,11090437959,6641,6973,6973,332,5.0,6816,175,2.64,6973,6973,1399-9-16
630,ضجار1015,اختيارخ وتجارت-3500-1399/10/21,103,2527,1803522000,748,799,688,-60,-8.02,714,-34,-4.55,651,799,1399-9-16
631,وشمال,س. چشم انداز توسعه شمال,103,62759,6014697042,98802,95838,95838,-2964,-3.0,97847,-955,-0.97,95838,95838,1399-9-16
632,تسه9710,امتياز تسهيلات مسكن دي 97,102,1388,878904137,661979,628882,628881,-33098,-5.0,633216,-28763,-4.35,628881,640030,1399-9-16
633,شجم,صنايع پتروشيمي تخت جمشيد,102,1041751,9768499127,9104,9377,9377,273,3.0,9213,109,1.2,9377,9377,1399-9-16
634,سنوين,سرمايه گذاري اقتصاد نوين,101,604122,6106304580,9985,10083,10170,185,1.85,10059,74,0.74,10083,10184,1399-9-16
635,سكه0011پ02,سكه تمام بهارتحويلي 1روزه ملت,100,26500,31463834000,1174502,1174500,1208697,34195,2.91,1187314,12812,1.09,1171000,1210000,1399-9-16
636,ضجار1014,اختيارخ وتجارت-3000-1399/10/21,99,1628,1657514000,1077,1070,1006,-71,-6.59,1018,-59,-5.48,990,1122,1399-9-16
637,تسه9801,امتياز تسهيلات مسكن فروردين98,99,750,478426636,670424,637000,636903,-33521,-5.0,637902,-32522,-4.85,636903,640000,1399-9-16
638,شپاس,نفت پاسارگاد,98,634743,14346461286,21526,22602,22602,1076,5.0,21806,280,1.3,22602,22602,1399-9-16
639,غپونه,نوش پونه مشهد,98,1282372,22877516480,17321,17840,17840,519,3.0,17840,519,3.0,17840,17840,1399-9-16
640,زعف0008پ05,زعفران0008نگين زرين(پ),97,92781,11501420570,125268,122222,125000,-268,-0.21,123963,-1305,-1.04,122000,125000,1399-9-16
641,ضفلا1156,اختيارخ فولاد-16000-1399/11/28,97,2421,3932699000,1646,1750,1622,-24,-1.46,1624,-22,-1.34,1400,1801,1399-9-16
642,ثروتم,صندوق س. ثروت آفرين پارسيان-س,97,21730,2178808700,101126,101000,100010,-1116,-1.1,100267,-859,-0.85,100000,101000,1399-9-16
643,تسه9712,امتياز تسهيلات مسكن اسفند97,96,855,571373259,684761,650531,650523,-34238,-5.0,668273,-16488,-2.41,650523,699987,1399-9-16
644,سقاين,سيمان‌ قائن‌,93,330896,15548803040,44760,46990,46990,2230,4.98,45400,640,1.43,46990,46990,1399-9-16
645,كتوكا,توليدي و خدمات صنايع نسوز توكا,92,343269,7934319666,22014,23114,23114,1100,5.0,22180,166,0.75,23114,23114,1399-9-16
646,شرنگي,شيميايي رنگين,92,134272,16134526336,116664,120163,120163,3499,3.0,119366,2702,2.32,120163,120163,1399-9-16
647,شساخت,مهندسي و ساختمان صنايع نفت,91,583019,24571918774,40919,42146,42146,1227,3.0,41629,710,1.74,42146,42146,1399-9-16
648,شصفها,پتروشيمي‌ اصفهان‌,90,81870,8532409530,100211,104219,104219,4008,4.0,102945,2734,2.73,104219,104219,1399-9-16
649,تسه9812,امتياز تسهيلات مسكن اسفند98,90,741,453412359,632011,600555,604999,-27012,-4.27,611892,-20119,-3.18,600411,630000,1399-9-16
650,كگهر,سنگ آهن گهرزمين,90,1146923,51863858060,43067,45220,45220,2153,5.0,43948,881,2.05,45220,45220,1399-9-16
651,اخزا810,اسنادخزانه-م10بودجه98-001006,90,26369,22119637275,836192,839000,839441,3249,0.39,838850,2658,0.32,838000,840000,1399-9-16
652,سخند,صندوق س.سپهرخبرگان نفت-د,89,1485260,14853636360,10127,10019,10000,-127,-1.25,10001,-126,-1.24,10000,10019,1399-9-16
653,تسه9901,امتياز تسهيلات مسكن فروردين99,89,804,502590152,630097,661601,625000,-5097,-0.81,625112,-4985,-0.79,605000,661601,1399-9-16
654,وبرق,س.کارکنان صنعت برق زنجان وقزوي,86,60722,12021923726,188556,197983,197983,9427,5.0,193885,5329,2.83,197983,197983,1399-9-16
655,مداران,داده‌پردازي‌ايران‌,86,551239,13687264370,23650,24830,24830,1180,4.99,23960,310,1.31,24830,24830,1399-9-16
656,ضفلا1155,اختيارخ فولاد-14000-1399/11/28,86,2143,5231688000,2456,2900,2500,44,1.79,2441,-15,-0.61,2200,2900,1399-9-16
657,بموتو,موتوژن‌,84,196113,9307522980,45200,47460,47460,2260,5.0,45600,400,0.88,47460,47460,1399-9-16
658,غصينو,صنعتي مينو,83,466824,36953787840,75391,79160,79160,3769,5.0,76659,1268,1.68,79160,79160,1399-9-16
659,سلار,شركت سيمان لارستان,79,438172,15757979636,34251,35963,35963,1712,5.0,35504,1253,3.66,35963,35963,1399-9-16
660,پدرخش,درخشان‌ تهران‌,78,20374,4201730020,217080,206230,206230,-10850,-5.0,216120,-960,-0.44,206230,206230,1399-9-16
661,اخزا903,اسنادخزانه-م3بودجه99-011110,76,98191,65857869936,671115,675000,670000,-1115,-0.17,670712,-403,-0.06,666222,680000,1399-9-16
662,اخزا902,اسنادخزانه-م2بودجه99-011019,75,129876,87715529727,674816,680000,674050,-766,-0.11,675379,563,0.08,670010,685000,1399-9-16
663,خعمرا,توسعه و عمران شهرستان نائين,74,267544,4706634048,16755,17592,17592,837,5.0,16942,187,1.12,17592,17592,1399-9-16
664,افران,صندوق س افرا نماد پايدار-ثابت,72,750740,9197549088,12240,12260,12250,10,0.08,12251,11,0.09,12242,12270,1399-9-16
665,گكيش,توريستي ورفاهي آبادگران كيش,72,133215,8626337325,62869,64755,64755,1886,3.0,63646,777,1.24,64755,64755,1399-9-16
666,ضسپا1106,اختيارخ خساپا-4000-1399/11/26,71,2488,857641000,232,550,390,158,68.1,345,113,48.71,290,550,1399-9-16
667,اخزا904,اسنادخزانه-م4بودجه99-011215,70,80127,52714338789,655783,659998,657999,2216,0.34,657885,2102,0.32,654274,660000,1399-9-16
668,ضخود1046,اختيارخ خودرو-5000-1399/10/07,70,2275,396894000,170,200,172,2,1.18,174,4,2.35,160,200,1399-9-16
669,ضصاد1103,اختيارخ وبصادر-4000-1399/11/12,70,3116,1291128000,400,401,385,-15,-3.75,414,14,3.5,385,420,1399-9-16
670,تسه9811,امتياز تسهيلات مسكن بهمن98,69,433,273285527,630519,600000,600000,-30519,-4.84,631144,625,0.1,598999,662044,1399-9-16
671,ثزاگرس,سرمايه گذاري توسعه عمران زاگرس,67,235493,9767543161,39502,41477,41477,1975,5.0,40379,877,2.22,41477,41477,1399-9-16
672,وسرضوي,س.سهام عدالت استان خراسان رضوي,67,751151,736127980,1030,980,980,-50,-4.85,1030,0,0.0,980,980,1399-9-16
673,لخانه,لوازم‌ خانگي‌ پارس‌,67,57066,3154494348,58187,55278,55278,-2909,-5.0,57704,-483,-0.83,55278,55278,1399-9-16
674,فاهواز,نورد و لوله اهواز,65,95591,1825501327,19486,19097,19097,-389,-2.0,19470,-16,-0.08,19097,19097,1399-9-16
675,بذر,صندوق س بذر اميد آفرين-سهام,62,26100,3020311700,114280,117000,115190,910,0.8,115720,1440,1.26,114080,117000,1399-9-16
676,شزنگ,تجهيزنيروي‌زنگان‌,62,55191,9681274074,170305,175414,175414,5109,3.0,172679,2374,1.39,175414,175414,1399-9-16
677,اخزا815,اسنادخزانه-م15بودجه98-010406,60,55830,42322729296,756931,757001,758000,1069,0.14,758064,1133,0.15,757001,759300,1399-9-16
678,اوصتا2,صندوق انديشه ورزان صباتامين -د,58,5800000,5800000,17232,1,1,-17231,-99.99,1,-17231,-99.99,1,1,1399-9-16
679,ضشنا1035,اختيارخ شپنا-14000-1399/10/23,58,311,1963034000,5623,6500,6200,577,10.26,6312,689,12.25,5710,6800,1399-9-16
680,ضخود1041,اختيارخ خودرو-2500-1399/10/07,58,1268,2250666000,1689,1799,1800,111,6.57,1775,86,5.09,1702,1854,1399-9-16
681,زعف0008پ16,زعفران0008نگين بيرجند(پ),56,25747,3161786640,122548,121100,125989,3441,2.81,122802,254,0.21,120000,125989,1399-9-16
682,ضپاس1001,اختيارخ وپارس-2500-1399/10/30,55,1027,2105946000,2105,2296,1960,-145,-6.89,2051,-54,-2.57,1960,2296,1399-9-16
683,ضغدر1119,اختيارخ وغدير-10000-1399/11/26,55,886,4466081000,5055,5020,5190,135,2.67,5041,-14,-0.28,4950,5190,1399-9-16
684,ضشنا1036,اختيارخ شپنا-16000-1399/10/23,55,328,1545397000,3989,5000,4550,561,14.06,4712,723,18.12,4200,5000,1399-9-16
685,شكبير,پتروشيمي اميركبير,55,307554,17774775876,56111,57794,57794,1683,3.0,56470,359,0.64,57794,57794,1399-9-16
686,ضسپا1105,اختيارخ خساپا-3500-1399/11/26,54,1635,780923000,387,477,525,138,35.66,478,91,23.51,450,532,1399-9-16
687,داريك,صندوق س.اعتماد داريك-د,54,1036174,10580250874,10189,10211,10220,31,0.3,10211,22,0.22,10195,10230,1399-9-16
688,وسخوز,شركت س استان خوزستان,53,1231644,1145428920,970,930,930,-40,-4.12,970,0,0.0,930,930,1399-9-16
689,جوين,كشت و صنعت جوين,52,260875,6167345875,22953,23641,23641,688,3.0,23157,204,0.89,23641,23641,1399-9-16
690,غگز,گز سكه,51,1675669,46918732000,29000,28000,28000,-1000,-3.45,28000,-1000,-3.45,28000,28000,1399-9-16
691,آكورد2,صندوق س. آرمان آتي كوثر-د,50,5000000,5000000,29585,1,1,-29584,-100.0,1,-29584,-100.0,1,1,1399-9-16
692,اخزا820,اسنادخزانه-م20بودجه98-020806,49,25755,15107448903,581164,589000,581000,-164,-0.03,586583,5419,0.93,581000,590000,1399-9-16
693,آسام,صندوق س.آرمان سپهر آشنا-م,47,42130,4569467130,107794,107100,109500,1706,1.58,108461,667,0.62,107020,109750,1399-9-16
694,ضسپا1103,اختيارخ خساپا-2500-1399/11/26,46,1477,1623166000,922,1200,1100,178,19.31,1099,177,19.2,1000,1200,1399-9-16
695,غشوكوح,ح . شوكو پارس,46,73245,2287451792,33129,33900,31142,-1987,-6.0,31230,-1899,-5.73,31142,33900,1399-9-16
696,تسه9809,امتياز تسهيلات مسكن آذر98,45,405,249270207,640837,608988,608796,-32041,-5.0,615482,-25355,-3.96,608796,650000,1399-9-16
697,غشوكو,شوكو پارس,44,29366,1242592924,43622,42314,42314,-1308,-3.0,43538,-84,-0.19,42314,42314,1399-9-16
698,اخزا813,اسنادخزانه-م13بودجه98-010219,44,180341,140864109518,780740,790000,783000,2260,0.29,781099,359,0.05,776250,790000,1399-9-16
699,ضپنا1022,اختيارخ رمپنا-18806-1399/10/09,43,438,2079470619,3079,3589,3200,121,3.93,3206,127,4.12,3051,3589,1399-9-16
700,ضچاد1015,اختيارخ كچاد-16000-1399/10/02,41,247,1510318000,5747,6300,6300,553,9.62,6115,368,6.4,5301,6300,1399-9-16
701,اوصتا,صندوق انديشه ورزان صباتامين -د,40,1594991,27482613884,17232,17233,17101,-131,-0.76,17231,-1,-0.01,17101,17254,1399-9-16
702,اخزا808,اسنادخزانه-م8بودجه98-000817,40,22234,19182577857,862684,860002,861011,-1673,-0.19,862759,75,0.01,860002,864900,1399-9-16
703,ضجار1017,اختيارخ وتجارت-4500-1399/10/21,40,1422,397004000,270,298,260,-10,-3.7,279,9,3.33,258,300,1399-9-16
704,هفارس912,اختيارف ت فارس-14576-99/12/13,39,1000000,1000000,1,1,1,0,0.0,1,0,0.0,1,1,1399-9-16
705,اخزا809,اسنادخزانه-م9بودجه98-000923,38,40512,34208103553,845492,845492,845001,-491,-0.06,844394,-1098,-0.13,842073,845492,1399-9-16
706,آينده,بازرگاني آينده سازان بهشت پارس,38,52208,1107958176,21878,21222,21222,-656,-3.0,21840,-38,-0.17,21222,21222,1399-9-16
707,تسه9808,امتياز تسهيلات مسكن آبان98,37,421,262672520,637926,606031,632000,-5926,-0.93,623925,-14001,-2.19,606030,638900,1399-9-16
708,كيا,كيا الكترود شرق,37,890155,5000000635,5617,5617,5617,0,0.0,5617,0,0.0,5617,5617,1399-9-16
709,ضمخا7070,اختيارخ اخابر-20000-1400/07/28,35,382,1694994000,4321,5000,4450,129,2.99,4437,116,2.68,4100,5000,1399-9-16
710,اخزا817,اسنادخزانه-م17بودجه98-010512,34,18324,13617970804,744053,743003,743300,-753,-0.1,743177,-876,-0.12,743003,744989,1399-9-16
711,ضفار1125,اختيارخ فارس-17826-1399/11/07,33,750,1058880000,791,690,701,-90,-11.38,706,-85,-10.75,620,795,1399-9-16
712,هبركت912,اختيارف ت بركت-22100-99/12/17,33,113956,233040020,2791,2045,2045,-746,-26.73,2045,-746,-26.73,2045,2045,1399-9-16
713,فوكا,فولاد كاويان,32,23083,456558657,20390,19779,19779,-611,-3.0,20384,-6,-0.03,19779,19779,1399-9-16
714,ضترا1118,اختيارخ شتران-12000-1399/11/14,31,225,913233000,3338,4100,4000,662,19.83,4059,721,21.6,3999,4490,1399-9-16
715,ضخود1040,اختيارخ خودرو-2000-1399/10/07,31,383,884371000,2157,2500,2340,183,8.48,2309,152,7.05,2252,2500,1399-9-16
716,اخزا806,اسنادخزانه-م6بودجه98-000519,29,27998,25115850534,895121,894121,895000,-121,-0.01,897059,1938,0.22,894000,899800,1399-9-16
717,اخزا816,اسنادخزانه-م16بودجه98-010503,28,21520,16108905312,748096,745121,747552,-544,-0.07,748555,459,0.06,745121,755000,1399-9-16
718,ضفلا1157,اختيارخ فولاد-18000-1399/11/28,28,339,363839000,949,1148,1100,151,15.91,1073,124,13.07,1000,1148,1399-9-16
719,اخزا812,اسنادخزانه-م12بودجه98-001111,28,40313,33375319880,826247,826220,826543,296,0.04,827905,1658,0.2,825258,831990,1399-9-16
720,اخزا814,اسنادخزانه-م14بودجه98-010318,27,35452,27151896917,765583,767082,764926,-657,-0.09,765878,295,0.04,764911,769989,1399-9-16
721,ضچاد1014,اختيارخ كچاد-14000-1399/10/02,26,445,3455086000,7372,8000,8000,628,8.52,7764,392,5.32,7273,8390,1399-9-16
722,تسه9804,امتياز تسهيلات مسكن تير98,26,252,166654656,629837,661328,661328,31491,5.0,661328,31491,5.0,661328,661328,1399-9-16
723,شستا991,اجاره تامين اجتماعي-امين991226,26,6222,6223090598,1003864,1006999,1000000,-3864,-0.38,1000175,-3689,-0.37,1000000,1006999,1399-9-16
724,اخزا818,اسنادخزانه-م18بودجه98-010614,25,73782,53794297217,727028,729000,730000,2972,0.41,729098,2070,0.28,729000,730999,1399-9-16
725,اخزا811,اسنادخزانه-م11بودجه98-001013,24,22906,19216461077,837146,836805,838001,855,0.1,838927,1781,0.21,836805,841000,1399-9-16
726,سايرا,ايرانيت‌,24,66914,2329404866,35429,35233,34722,-707,-2.0,35283,-146,-0.41,34721,35537,1399-9-16
727,ضپيك1019,اختيارخ تاپيكو-12000-99/10/16,24,123,725845000,5441,6000,5601,160,2.94,5901,460,8.45,5600,6200,1399-9-16
728,وآفري,بيمه كارآفرين,24,169556,2761728128,15814,16288,16288,474,3.0,15877,63,0.4,16288,16288,1399-9-16
729,ضچاد1017,اختيارخ كچاد-20000-1399/10/02,24,172,472968000,2738,3049,2700,-38,-1.39,2750,12,0.44,2600,3049,1399-9-16
730,ضغدر1121,اختيارخ وغدير-14000-1399/11/26,23,853,2646600000,3052,3100,3000,-52,-1.7,3103,51,1.67,2850,3200,1399-9-16
731,كصدف,كاشي صدف سرام استقلال آباده,23,208529,4533420460,20705,21740,21740,1035,5.0,20924,219,1.06,21740,21740,1399-9-16
732,ضپيك1020,اختيارخ تاپيكو-14000-99/10/16,23,208,855411000,3900,4099,4090,190,4.87,4113,213,5.46,4000,4400,1399-9-16
733,زعف0008پ09,زعفران0008نگين نوين(پ),23,26943,3353925000,132594,128000,124500,-8094,-6.1,124482,-8112,-6.12,124000,125000,1399-9-16
734,پست0008پ08,پسته فندقي32-30مه ولات0008(پ),22,2200,3902919600,1762257,1780000,1768000,5743,0.33,1774054,11797,0.67,1760000,1800000,1399-9-16
735,تسه9807,امتياز تسهيلات مسكن مهر98,22,84,53286000,653161,630000,628000,-25161,-3.85,634357,-18804,-2.88,627000,660000,1399-9-16
736,هصيكو402,اختيارف ت تاصيكو13500-00/02/20,22,205215,233534670,1604,1138,1138,-466,-29.05,1138,-466,-29.05,1138,1138,1399-9-16
737,ضپاس1000,اختيارخ وپارس-2000-1399/10/30,22,234,609461000,2616,2616,2518,-98,-3.75,2605,-11,-0.42,2518,2800,1399-9-16
738,عيار2,صندوق س. پشتوانه طلاي مفيد,21,210000,210000,28841,1,1,-28840,-100.0,1,-28840,-100.0,1,1,1399-9-16
739,اخزا804,اسنادخزانه-م4بودجه98-000421,21,23146,20954116710,904985,904985,905801,816,0.09,905302,317,0.04,899002,909989,1399-9-16
740,اخزا821,اسنادخزانه-م21بودجه98-020906,21,11420,6568033841,573553,576983,573511,-42,-0.01,575134,1581,0.28,573156,576983,1399-9-16
741,گوهر2,صندوق سكه طلاي كيان,20,200000,200000,57975,1,1,-57974,-100.0,1,-57974,-100.0,1,1,1399-9-16
742,زعف0008پ08,زعفران0008نگين روستا(پ),20,10751,1325181091,124247,122500,124499,252,0.2,123261,-986,-0.79,122252,124499,1399-9-16
743,صمعاد412,صكوك اجاره معادن412-6ماهه21%,19,176020,172517202000,980100,980100,980100,0,0.0,980100,0,0.0,980100,980100,1399-9-16
744,وسزنجان,شركت س استان زنجان,18,276428,373177800,1420,1350,1350,-70,-4.93,1420,0,0.0,1350,1350,1399-9-16
745,حرهشا,رهشاد سپاهان (سهامي عام,18,38842,2320809500,61597,59750,59750,-1847,-3.0,61375,-222,-0.36,59750,59750,1399-9-16
746,وسگلستا,شركت س استان گلستان,18,354414,418208520,1240,1180,1180,-60,-4.84,1240,0,0.0,1180,1180,1399-9-16
747,پلاست,كارخانجات توليدي پلاستيران,18,8552,354608680,42747,41465,41465,-1282,-3.0,42724,-23,-0.05,41465,41465,1399-9-16
748,ضفار1122,اختيارخ فارس-11826-1399/11/07,17,64,515006000,3615,4300,3850,235,6.5,4023,408,11.29,3850,4500,1399-9-16
749,هاباد912,اختيارف ت آبادا-30100-99/12/12,17,13978,108511214,8683,7763,7763,-920,-10.6,7763,-920,-10.6,7763,7763,1399-9-16
750,ضملت1127,اختيارخ وبملت-5000-1399/11/28,17,224,293450000,1306,1282,1300,-6,-0.46,1310,4,0.31,1280,1400,1399-9-16
751,نگين,ص.س. زمين و ساختمان نگين شهرري,16,3504,170188620,49160,49400,48520,-640,-1.3,48570,-590,-1.2,48510,49400,1399-9-16
752,اخزا704,اسنادخزانه-م4بودجه97-991022,16,5011,4936088003,987299,987000,985000,-2299,-0.23,985050,-2249,-0.23,984001,987000,1399-9-16
753,ضشنا1038,اختيارخ شپنا-20000-1399/10/23,14,48,133504000,2871,2900,2400,-471,-16.41,2781,-90,-3.13,2400,2900,1399-9-16
754,وساربيل,شركت س استان اردبيل,14,127661,155746420,1280,1220,1220,-60,-4.69,1280,0,0.0,1220,1220,1399-9-16
755,ضملت1126,اختيارخ وبملت-4500-1399/11/28,13,131,219985000,1999,1800,1671,-328,-16.41,1679,-320,-16.01,1500,1800,1399-9-16
756,ضچاد1016,اختيارخ كچاد-18000-1399/10/02,13,98,402318000,3987,4500,4150,163,4.09,4105,118,2.96,4003,4500,1399-9-16
757,وسبوشهر,شركت س استان بوشهر,13,104543,125451600,1260,1200,1200,-60,-4.76,1260,0,0.0,1200,1200,1399-9-16
758,اخزا721,اسنادخزانه-م21بودجه97-000728,13,5983,5172277386,866856,860000,867990,1134,0.13,864496,-2360,-0.27,856006,868990,1399-9-16
759,ضجار1018,اختيارخ وتجارت-5000-1399/10/21,13,574,94885000,174,180,170,-4,-2.3,165,-9,-5.17,151,180,1399-9-16
760,فن آوا,گروه فن آوا,12,13778,193346674,14467,14033,14033,-434,-3.0,14463,-4,-0.03,14033,14033,1399-9-16
761,گنجين,صندوق س. گنجينه يكم آويد-د,12,310982,3655270824,11747,11752,11755,8,0.07,11754,7,0.06,11752,11760,1399-9-16
762,ضپار1117,اختيارخ خپارس-7000-1399/11/19,12,57,139039000,2114,2450,2451,337,15.94,2439,325,15.37,2400,2500,1399-9-16
763,وسمازن,س.سهام عدالت استان مازندران,12,98651,92731940,980,940,940,-40,-4.08,980,0,0.0,940,940,1399-9-16
764,كشم0001پ01,كشمش سبز0001خليل آباد(پ),11,122,45845110,362829,380000,380970,18141,5.0,375780,12951,3.57,355005,380970,1399-9-16
765,پست0008پ04,پسته فندقي32-30سبزدانه0008(پ),11,774,1380652998,1799999,1760000,1761001,-38998,-2.17,1783789,-16210,-0.9,1760000,1785000,1399-9-16
766,پلوله,گازلوله‌,11,196702,3557749074,18269,18087,18087,-182,-1.0,18138,-131,-0.72,18087,18087,1399-9-16
767,ضشنا1037,اختيارخ شپنا-18000-1399/10/23,11,51,173038000,3096,3500,3500,404,13.05,3393,297,9.59,3199,3500,1399-9-16
768,وسيلام,شركت س استان ايلام,11,155805,183849900,1240,1180,1180,-60,-4.84,1240,0,0.0,1180,1180,1399-9-16
769,ضفار1126,اختيارخ فارس-19826-1399/11/07,11,157,141000000,450,360,400,-50,-11.11,449,-1,-0.22,360,480,1399-9-16
770,وسمركز,شركت س استان مركزي,10,92620,123184600,1400,1330,1330,-70,-5.0,1400,0,0.0,1330,1330,1399-9-16
771,ضپاس1004,اختيارخ وپارس-4000-1399/10/30,9,212,163941000,808,801,701,-107,-13.24,773,-35,-4.33,701,900,1399-9-16
772,تملي804,تسهيلات مسكن ب. ملي-تير98,9,52,54161302,1040666,1040666,1050000,9334,0.9,1041563,897,0.09,1040666,1050000,1399-9-16
773,ضخود1047,اختيارخ خودرو-6000-1399/10/07,9,221,15027000,97,71,70,-27,-27.84,68,-29,-29.9,67,71,1399-9-16
774,اطلس2,صندوق س.توسعه اندوخته آينده-س,8,80000,80000,210702,1,1,-210701,-100.0,1,-210701,-100.0,1,1,1399-9-16
775,ضمخا7066,اختيارخ اخابر-12000-1400/07/28,8,26,265928000,7502,9990,10999,3497,46.61,10228,2726,36.34,9990,10999,1399-9-16
776,وسيزد,شركت س استان يزد,8,39503,48193660,1280,1220,1220,-60,-4.69,1280,0,0.0,1220,1220,1399-9-16
777,ساذري,آذريت‌,8,6587,39403434,5808,5982,5982,174,3.0,5808,0,0.0,5982,5982,1399-9-16
778,پست0008پ09,پسته بادامي30-28مه ولات0008(پ),8,210,341410812,1604154,1610000,1550001,-54153,-3.38,1625766,21612,1.35,1550001,1629999,1399-9-16
779,زير0003پ01,زيره سبز0003كيميابذر(پ),8,131,79398981,606790,637000,576451,-30339,-5.0,606099,-691,-0.11,576451,637000,1399-9-16
780,سپرمي,پرميت‌,8,66628,559342060,8312,8395,8395,83,1.0,8321,9,0.11,8395,8395,1399-9-16
781,پست0008پ02,پسته فندقي32-30طلاسبززرند0008,8,67,123361287,1835896,1839999,1858980,23084,1.26,1841213,5317,0.29,1800100,1860000,1399-9-16
782,ضسپا1102,اختيارخ خساپا-2000-1399/11/26,7,165,245111000,1295,1401,1550,255,19.69,1486,191,14.75,1400,1550,1399-9-16
783,وسالت,بانك قرض الحسنه رسالت,7,20000,90260000,4299,4513,4513,214,4.98,4300,1,0.02,4513,4513,1399-9-16
784,ضمخا1025,اختيارخ اخابر-16000-1399/10/30,7,78,181660000,2406,2300,2300,-106,-4.41,2329,-77,-3.2,2300,2500,1399-9-16
785,سرو2,صندوق س سروسودمند مدبران-سهام,7,700000,700000,71940,1,1,-71939,-100.0,1,-71939,-100.0,1,1,1399-9-16
786,كرونا2,تامين مالي جمعي صرفا اهداي سود,7,795,7950000,10000,10000,10000,0,0.0,10000,0,0.0,10000,10000,1399-9-16
787,ضصاد1100,اختيارخ وبصادر-2500-1399/11/12,7,12,15337000,1295,1320,1251,-44,-3.4,1278,-17,-1.31,1251,1320,1399-9-16
788,وسكهبو,س.عدالت ا. كهگيلويه وبويراحمد,7,82282,88864560,1130,1080,1080,-50,-4.42,1130,0,0.0,1080,1080,1399-9-16
789,اراد50,مرابحه عام دولت5-ش.خ0302,6,130000,130000000000,1000000,1000000,1000000,0,0.0,1000000,0,0.0,1000000,1000000,1399-9-16
790,اخزا722,اسنادخزانه-م22بودجه97-000428,6,5650,5106250000,900244,902500,906500,6256,0.69,903761,3517,0.39,902500,906500,1399-9-16
791,اخزا906,اسنادخزانه-م6بودجه99-020321,6,97,60951592,626000,630658,625621,-379,-0.06,628367,2367,0.38,625555,630658,1399-9-16
792,اخزا716,اسنادخزانه-م16بودجه97-000407,5,70566,63880479511,911000,901550,905286,-5714,-0.63,905259,-5741,-0.63,901550,905286,1399-9-16
793,ضمخا1023,اختيارخ اخابر-12000-1399/10/30,5,13,56701000,5339,4100,5500,161,3.02,4362,-977,-18.3,4078,5899,1399-9-16
794,شستا992,اجاره تامين اجتماعي-سپهر991226,5,1360,1347765856,995310,991002,991004,-4306,-0.43,991004,-4306,-0.43,991002,991006,1399-9-16
795,اخزا901,اسنادخزانه-م1بودجه99-010621,5,4910,3566395610,728526,725001,727801,-725,-0.1,726353,-2173,-0.3,725001,727801,1399-9-16
796,ضجار1010,اختيارخ وتجارت-1600-1399/10/21,5,15,41212000,2469,2750,2745,276,11.18,2747,278,11.26,2745,2750,1399-9-16
797,ضملت1130,اختيارخ وبملت-8000-1399/11/28,5,137,32897000,309,220,230,-79,-25.57,240,-69,-22.33,220,300,1399-9-16
798,هغدير912,اختيارف ت غدير-17380-99/12/16,4,22630,49174990,3979,2173,2173,-1806,-45.39,2173,-1806,-45.39,2173,2173,1399-9-16
799,صخود412,ص مرابحه خودرو412- 3ماهه 18%,4,1350,1326403350,982521,982521,982521,0,0.0,982521,0,0.0,982521,982521,1399-9-16
800,ضپنا1021,اختيارخ رمپنا-16106-1399/10/09,4,50,423121700,5221,5600,5750,529,10.13,5714,493,9.44,5600,5760,1399-9-16
801,ضگل1142,اختيارخ كگل-16000-1399/11/21,4,38,233150000,6500,5450,6500,0,0.0,6136,-364,-5.6,5450,6500,1399-9-16
802,وسكرشا,س.سهام عدالت استان كرمانشاه,4,40366,48439200,1260,1200,1200,-60,-4.76,1260,0,0.0,1200,1200,1399-9-16
803,شلرد02,كود شيميايي اوره لردگان,4,25,25000000,994689,990000,990000,-4689,-0.47,1000000,5311,0.53,990000,1040000,1399-9-16
804,ياقوت2,صندوق س ياقوت آگاه-ثابت,4,5125000,5125000,11516,1,1,-11515,-99.99,1,-11515,-99.99,1,1,1399-9-16
805,شتهران,داروسازي تهران شيمي,4,26647,212829589,7680,7987,7987,307,4.0,7686,6,0.08,7987,7987,1399-9-16
806,ضبدر1158,اختيارخ شبندر-24000-1399/11/19,4,53,632185000,10000,10000,12000,2000,20.0,11928,1928,19.28,10000,12084,1399-9-16
807,ومشان,س. فني و مهندسي مشانير,4,378,21686238,59145,57371,57371,-1774,-3.0,59143,-2,0.0,57371,57371,1399-9-16
808,تبريز112,مشاركت شهرداري تبريز-3ماهه18%,4,210,205339700,953538,994997,960000,6462,0.68,977808,24270,2.55,960000,994997,1399-9-16
809,اخزا807,اسنادخزانه-م7بودجه98-000719,4,570,495362622,869667,876191,870000,333,0.04,869057,-610,-0.07,867246,876191,1399-9-16
810,زعف0008پ15,زعفران0008پوشالمعمول طلاسرخ(پ),4,198,19818274,106535,100101,100083,-6452,-6.06,100092,-6443,-6.05,100083,100101,1399-9-16
811,تسه9806,امتياز تسهيلات مسكن شهريور98,4,30,18615900,653189,620530,620530,-32659,-5.0,620530,-32659,-5.0,620530,620530,1399-9-16
812,ضسپا1100,اختيارخ خساپا-1600-1399/11/26,4,31,57312000,1700,1751,1950,250,14.71,1849,149,8.76,1751,1950,1399-9-16
813,ضچاد1013,اختيارخ كچاد-12000-1399/10/02,3,42,425000000,9443,10000,10500,1057,11.19,10119,676,7.16,10000,10500,1399-9-16
814,ضبدر1150,اختيارخ شبندر-32000-1399/11/19,3,10,49996000,3871,6000,5000,1129,29.17,5000,1129,29.17,4999,5000,1399-9-16
815,ضغدر1118,اختيارخ وغدير-9000-1399/11/26,3,4,25500000,5754,6500,6000,246,4.28,6375,621,10.79,6000,6500,1399-9-16
816,ضپيك1022,اختيارخ تاپيكو-18000-99/10/16,3,14,27650000,1783,2000,1960,177,9.93,1975,192,10.77,1950,2000,1399-9-16
817,ضصاد1106,اختيارخ وبصادر-6000-1399/11/12,3,50,3450000,110,53,65,-45,-40.91,69,-41,-37.27,53,109,1399-9-16
818,كابگن,توليدي و صنعتي آبگينه‌,3,21707,108817191,4915,5013,5013,98,1.99,4917,2,0.04,5013,5013,1399-9-16
819,ضپار1115,اختيارخ خپارس-5000-1399/11/19,3,16,65100000,4111,4100,4000,-111,-2.7,4069,-42,-1.02,4000,4200,1399-9-16
820,ضفار1123,اختيارخ فارس-13826-1399/11/07,3,7,36700000,2000,2600,2750,750,37.5,2621,621,31.05,2600,2750,1399-9-16
821,افران2,صندوق س افرا نماد پايدار-ثابت,3,300000,300000,12240,1,1,-12239,-99.99,1,-12239,-99.99,1,1,1399-9-16
822,بتك,كارخانجات كابل سازي‌ تك‌,3,6785,238485965,33798,35149,35149,1351,4.0,33829,31,0.09,35149,35149,1399-9-16
823,كباده,توليد خاك نسوزاستقلال آباده,3,50000,1167950000,22247,23359,23359,1112,5.0,22309,62,0.28,23359,23359,1399-9-16
824,دومينو4,اجاره دومينو14040208,3,3550,3267469950,897060,933299,915002,17942,2.0,920414,23354,2.6,915002,933300,1399-9-16
825,ضغدر1120,اختيارخ وغدير-12000-1399/11/26,3,58,223160000,3877,3520,3900,23,0.59,3848,-29,-0.75,3520,3900,1399-9-16
826,اخزا718,اسنادخزانه-م18بودجه97-000525,3,1300,1156882133,893889,889102,891201,-2688,-0.3,889909,-3980,-0.45,889102,891202,1399-9-16
827,صايپا308,صكوك مرابحه سايپا308-3ماهه 18%,2,18,17937000,967200,990000,999000,31800,3.29,996500,29300,3.03,990000,999000,1399-9-16
828,صخود0012,ص مرابحه خودرو0012- 3ماهه 18%,2,16,16160000,1010000,1010000,1010000,0,0.0,1010000,0,0.0,1010000,1010000,1399-9-16
829,تملي701,تسهيلات مسكن ب. ملي-فروردين97,2,35,38628870,1161770,1103682,1103682,-58088,-5.0,1103682,-58088,-5.0,1103682,1103682,1399-9-16
830,كايتا,ايتالران‌,2,1998,19090890,9277,9555,9555,278,3.0,9277,0,0.0,9555,9555,1399-9-16
831,ضصاد1101,اختيارخ وبصادر-3000-1399/11/12,2,30,27990000,945,999,900,-45,-4.76,933,-12,-1.27,900,999,1399-9-16
832,شسم,توليد سموم‌ علف‌ كش,2,239,20763842,85175,86878,86878,1703,2.0,85178,3,0.0,86878,86878,1399-9-16
833,ضپيك1021,اختيارخ تاپيكو-16000-99/10/16,2,5,14601000,2197,3001,2900,703,32.0,2920,723,32.91,2900,3001,1399-9-16
834,تصميم2,صندوق س با درآمد ثابت تصميم,2,2000000,2000000,15000,1,1,-14999,-99.99,1,-14999,-99.99,1,1,1399-9-16
835,ضفار1120,اختيارخ فارس-8826-1399/11/07,2,20,270000000,6500,6750,6750,250,3.85,6750,250,3.85,6750,6750,1399-9-16
836,فبستم,صنايع ‌بسته‌بندي‌ مشهد,2,6210,5067360,793,816,816,23,2.9,793,0,0.0,816,816,1399-9-16
837,تملي612,تسهيلات مسكن بانك ملي-اسفند96,2,6,5570871,977337,928480,928471,-48866,-5.0,928478,-48859,-5.0,928471,928480,1399-9-16
838,تملي803,تسهيلات مسكن ب. ملي-خرداد98,2,25,13991600,533014,559664,559664,26650,5.0,559664,26650,5.0,559664,559664,1399-9-16
839,ضصاد1105,اختيارخ وبصادر-5000-1399/11/12,2,120,23300000,200,201,160,-40,-20.0,194,-6,-3.0,160,201,1399-9-16
840,پارتين,ص.ج.پارتيان15%تاديه,1,3000,510000000,170000,170000,170000,0,0.0,170000,0,0.0,170000,170000,1399-9-16
841,اخزا8054,اسنادخزانه-م5بودجه98-000422,1,168200,151853146600,905000,902813,902813,-2187,-0.24,902813,-2187,-0.24,902813,902813,1399-9-16
842,اراد22,مرابحه عام دولت2-ش.خ لوتوس0212,1,2000,1724000000,868000,862000,862000,-6000,-0.69,862000,-6000,-0.69,862000,862000,1399-9-16
843,پارسان2,گسترش نفت و گاز پارسيان,1,5000000,123750000000,24030,24750,24750,720,3.0,24750,720,3.0,24750,24750,1399-9-16
844,ضمخا1026,اختيارخ اخابر-18000-1399/10/30,1,100,165000000,1792,1650,1650,-142,-7.92,1650,-142,-7.92,1650,1650,1399-9-16
845,گدنا4,تهيه توزيع غذاي دنا آفرين فدك,1,4000000,114904000000,27359,28726,28726,1367,5.0,28726,1367,5.0,28726,28726,1399-9-16
846,ضبدر1157,اختيارخ شبندر-20000-1399/11/19,1,1,13000000,12500,13000,13000,500,4.0,13000,500,4.0,13000,13000,1399-9-16
847,رايان911,مشاركت رايان سايپا-3ماهه18%,1,10,9770000,999000,977000,977000,-22000,-2.2,977000,-22000,-2.2,977000,977000,1399-9-16
848,خگستر4,گسترش‌سرمايه‌گذاري‌ايران‌خودرو,1,100000000,485000000000,4620,4850,4850,230,4.98,4850,230,4.98,4850,4850,1399-9-16
849,افاد73,منفعت دولت7-ش.خاص نوين0204,1,1500,1425000000,979999,950000,950000,-29999,-3.06,950000,-29999,-3.06,950000,950000,1399-9-16
850,ضفلا1151,اختيارخ فولاد-8000-1399/11/28,1,1,7002000,7000,7002,7002,2,0.03,7002,2,0.03,7002,7002,1399-9-16
851,اجاد21,اجاره دولتي آپرورش-تمدن991118,1,500,506566500,1032133,1013133,1013133,-19000,-1.84,1013133,-19000,-1.84,1013133,1013133,1399-9-16
852,خودرو4,ايران‌ خودرو,1,100000000,430000000000,4110,4300,4300,190,4.62,4300,190,4.62,4300,4300,1399-9-16
853,زير0003پ02,زيره سبز0003 دانش(پ),1,86,49574786,549002,576451,576451,27449,5.0,576451,27449,5.0,576451,576451,1399-9-16
854,ضفلا1154,اختيارخ فولاد-12000-1399/11/28,1,5,20000000,3943,4000,4000,57,1.45,4000,57,1.45,4000,4000,1399-9-16
855,اخزا8092,اسنادخزانه-م9بودجه98-000923,1,132661,111674029800,845492,841800,841800,-3692,-0.44,841800,-3692,-0.44,841800,841800,1399-9-16
856,كسرام4,پارس‌ سرام‌,1,22000000,204820000000,8870,9310,9310,440,4.96,9310,440,4.96,9310,9310,1399-9-16
857,ضترا1117,اختيارخ شتران-10000-1399/11/14,1,1,5300000,5191,5300,5300,109,2.1,5300,109,2.1,5300,5300,1399-9-16
858,آبين2,كشت و صنعت آبشيرين,1,1800000,7828200000,4223,4349,4349,126,2.98,4349,126,2.98,4349,4349,1399-9-16
859,اخزا9062,اسنادخزانه-م6بودجه99-020321,1,1000000,622000000000,626000,622000,622000,-4000,-0.64,622000,-4000,-0.64,622000,622000,1399-9-16
860,فسرب4,ملي‌ سرب‌وروي‌ ايران‌,1,750000,115852500000,152860,154470,154470,1610,1.05,154470,1610,1.05,154470,154470,1399-9-16
861,ختوقا4,قطعات‌ اتومبيل‌ ايران‌,1,50000000,219000000000,4180,4380,4380,200,4.78,4380,200,4.78,4380,4380,1399-9-16
862,شكلر2,نيروكلر,1,6000000,362160000000,61280,60360,60360,-920,-1.5,60360,-920,-1.5,60360,60360,1399-9-16
863,كرازي4,كارخانجات‌توليدي‌شيشه‌رازي‌,1,16600000,399064000000,23000,24040,24040,1040,4.52,24040,1040,4.52,24040,24040,1399-9-16
864,اخابر2,مخابرات ايران,1,12500000,207875000000,16500,16630,16630,130,0.79,16630,130,0.79,16630,16630,1399-9-16
865,اخزا7234,اسنادخزانه-م23بودجه97-000824,1,208149,179027081559,857000,860091,860091,3091,0.36,860091,3091,0.36,860091,860091,1399-9-16
866,ضپاس1006,اختيارخ وپارس-5000-1399/10/30,1,1,389000,385,389,389,4,1.04,389,4,1.04,389,389,1399-9-16
867,ضترا1128,اختيارخ شتران-9000-1399/11/14,1,1,7000000,5832,7000,7000,1168,20.03,7000,1168,20.03,7000,7000,1399-9-16
868,صگل411,ص اجاره گل گهر 411- 3 ماهه 17%,1,98,96040000,980000,980000,980000,0,0.0,980000,0,0.0,980000,980000,1399-9-16
869,مبين012,اجاره اعتماد مبين تمدن010710,1,500,458500000,907000,917000,917000,10000,1.1,917000,10000,1.1,917000,917000,1399-9-16
870,فماك,ماداكتو استيل كرد,1,50000,1349500000,26990,26990,26990,0,0.0,26990,0,0.0,26990,26990,1399-9-16
871,اخزا805,اسنادخزانه-م5بودجه98-000422,1,300,271500300,905000,905001,905001,1,0.0,905001,1,0.0,905001,905001,1399-9-16
872,اخزا9042,اسنادخزانه-م4بودجه99-011215,1,120000,78720000000,655783,656000,656000,217,0.03,656000,217,0.03,656000,656000,1399-9-16
873,اخزا8064,اسنادخزانه-م6بودجه98-000519,1,155543,138520840709,895121,890563,890563,-4558,-0.51,890563,-4558,-0.51,890563,890563,1399-9-16
874,كچاد2,معدني‌وصنعتي‌چادرملو,1,9200000,202400000000,21540,22000,22000,460,2.14,22000,460,2.14,22000,22000,1399-9-16
875,تكنار4,مجتمع معادن مس تكنار,1,1400000,150505600000,104373,107504,107504,3131,3.0,107504,3131,3.0,107504,107504,1399-9-16
876,ديران4,ايران‌دارو,1,1300000,34489000000,25780,26530,26530,750,2.91,26530,750,2.91,26530,26530,1399-9-16
877,رايان106,مشاركت رايان سايپا-3ماهه16%,1,500,473185000,945461,946370,946370,909,0.1,946370,909,0.1,946370,946370,1399-9-16
878,ضبدر1149,اختيارخ شبندر-28000-1399/11/19,1,5,34500000,6222,6900,6900,678,10.9,6900,678,10.9,6900,6900,1399-9-16
879,ضچاد1012,اختيارخ كچاد-10000-1399/10/02,1,10,120000000,8922,12000,12000,3078,34.5,12000,3078,34.5,12000,12000,1399-9-16
880,ضپنا1023,اختيارخ رمپنا-21506-1399/10/09,1,50,125885000,1683,1700,1700,17,1.01,1700,17,1.01,1700,1700,1399-9-16
881,ضفار1121,اختيارخ فارس-9826-1399/11/07,1,1,11200000,5600,5600,5600,0,0.0,5600,0,0.0,5600,5600,1399-9-16
882,صيدك1404,صكوك اجاره سايپا يدك-3ماهه18%,1,6,5790000,1000000,965000,965000,-35000,-3.5,965000,-35000,-3.5,965000,965000,1399-9-16
883,ضجار1013,اختيارخ وتجارت-2500-1399/10/21,1,2,2532000,1696,1266,1266,-430,-25.35,1266,-430,-25.35,1266,1266,1399-9-16
884,صفارس307,صكوك اجاره فارس307- 3ماهه18%,1,1000,915500000,931500,915500,915500,-16000,-1.72,915500,-16000,-1.72,915500,915500,1399-9-16
885,اجاد22,اجاره دولتي آپرورش-لوتوس991118,1,50,49500150,1000000,990003,990003,-9997,-1.0,990003,-9997,-1.0,990003,990003,1399-9-16
886,صمسكن912,ص دين مسكن جنوب-ماهانه16درصد,1,50,3055400,61108,61108,61108,0,0.0,61108,0,0.0,61108,61108,1399-9-16
887,سپر2,صندوق س سپر سرمايه بيدار- ثابت,1,1000000,1000000,10786,1,1,-10785,-99.99,1,-10785,-99.99,1,1,1399-9-16
888,ضخوز1014,اختيارخ فخوز-12191-1399/10/16,1,4,39996000,9999,9999,9999,0,0.0,9999,0,0.0,9999,9999,1399-9-16
889,اراد38,مرابحه عام دولت3-ش.خ 0105,1,500,478837500,971675,957675,957675,-14000,-1.44,957675,-14000,-1.44,957675,957675,1399-9-16
890,اراد56,مرابحه عام دولت5-ش.خ 0308,1,1000,952500000,945000,952500,952500,7500,0.79,952500,7500,0.79,952500,952500,1399-9-16
891,ضپنا1020,اختيارخ رمپنا-13406-1399/10/09,1,1,11848000,7899,8000,8000,101,1.28,8000,101,1.28,8000,8000,1399-9-16
892,وپسا2,س. پتروشيمي ساختمان  خليج فارس,1,5653266,22483038882,3977,3977,3977,0,0.0,3977,0,0.0,3977,3977,1399-9-16
