,نماد,نام,تعداد,حجم,ارزش,دیروز,اولین,آخرین معامله - مقدار,آخرین معامله - تغییر,آخرین معامله - درصد,قیمت پایانی - مقدار,قیمت پایانی - تغییر,قیمت پایانی - درصد,کمترین,بیشترین,تاریخ
0,كزغال,زغال سنگ پروده طبس,3726219,199999449,4095411385105,1000,19500,20500,19500,1950.0,20477,19477,1947.7,19500,20500,1399-11-15
1,پالايش,صندوق پالايشي يکم-سهام,67385,76949176,6128713986700,82860,82720,77010,-5850,-7.06,79650,-3210,-3.87,75620,86990,1399-11-15
2,سپيدار,سپيدار سيستم آسيا,61973,503605,28651095660,54183,56892,56892,2709,5.0,55588,1405,2.59,56892,56892,1399-11-15
3,دارا يكم,صندوق واسطه گري مالي يكم-سهام,48122,38836480,5403020114460,145190,145200,134310,-10880,-7.49,139120,-6070,-4.18,131900,151500,1399-11-15
4,وكبهمن,مديريت سرمايه گذاري كوثربهمن,38842,14073241,198661462219,14654,14760,13922,-732,-5.0,14116,-538,-3.67,13922,15000,1399-11-15
5,بركت,گروه دارويي بركت,37756,153814430,3368892543720,21490,22560,22060,570,2.65,21900,410,1.91,20600,22560,1399-11-15
6,خگستر,گسترش‌سرمايه‌گذاري‌ايران‌خودرو,33082,1105692360,3384451063450,2970,3110,3010,40,1.35,3060,90,3.03,2950,3110,1399-11-15
7,خساپا,سايپا,28883,1189266332,2580164838830,2230,2300,2130,-100,-4.48,2170,-60,-2.69,2120,2330,1399-11-15
8,چخزر,صنايع چوب خزر كاسپين,28613,3702069,248444257259,64267,67480,67480,3213,5.0,67110,2843,4.42,63250,67480,1399-11-15
9,وسپهر,سرمايه گذاري مالي سپهرصادرات,24252,76445509,777582155693,10292,9965,9963,-329,-3.2,10172,-120,-1.17,9900,10501,1399-11-15
10,غزر,صنعتي زر ماكارون,23163,10385163,313744633130,29820,30000,30100,280,0.94,30210,390,1.31,28400,31000,1399-11-15
11,شاروم,پتروشيمي اروميه,22781,11834213,225751144241,19434,19000,18550,-884,-4.55,19076,-358,-1.84,18463,20300,1399-11-15
12,كلوند,كاشي‌ الوند,22397,52343061,2422442696520,45760,48040,47600,1840,4.02,46280,520,1.14,43480,48040,1399-11-15
13,بوعلي,پتروشيمي بوعلي سينا,21434,6003775,256897286720,43880,43450,43040,-840,-1.91,42790,-1090,-2.48,42000,45700,1399-11-15
14,خودرو,ايران‌ خودرو,20524,626893156,1613835598070,2650,2700,2520,-130,-4.91,2570,-80,-3.02,2520,2730,1399-11-15
15,ولپارس,ليزينگ پارسيان,19090,25180568,146623714740,6070,5980,5770,-300,-4.94,5820,-250,-4.12,5770,6160,1399-11-15
16,شستا,سرمايه گذاري تامين اجتماعي,18945,83781296,1828789518890,22740,22400,21610,-1130,-4.97,21830,-910,-4.0,21610,23250,1399-11-15
17,ثبهساز,بهساز كاشانه تهران,18133,157837393,393985651680,2570,2550,2480,-90,-3.5,2500,-70,-2.72,2450,2670,1399-11-15
18,كرمان,س. توسعه و عمران استان كرمان,17688,35935215,2068944813082,56409,53589,59229,2820,5.0,57574,1165,2.07,53589,59229,1399-11-15
19,سنير,سيمان‌ سفيد ني‌ريز,16475,6354917,1697389491480,267000,280350,253650,-13350,-5.0,267100,100,0.04,253650,280350,1399-11-15
20,ثاميد,توسعه و عمران اميد,16353,95580060,167314505210,1790,1790,1750,-40,-2.23,1750,-40,-2.23,1720,1820,1399-11-15
21,فملي,ملي‌ صنايع‌ مس‌ ايران‌,15516,103935749,1033124810020,10300,10140,9800,-500,-4.85,9940,-360,-3.5,9790,10480,1399-11-15
22,شپنا,پالايش نفت اصفهان,14207,153963772,1734067316540,11690,11590,11110,-580,-4.96,11260,-430,-3.68,11110,11890,1399-11-15
23,سمگا,گروه سرمايه گذاري ميراث فرهنگي,12848,66939829,1975073044916,28614,30044,28990,376,1.31,29505,891,3.11,27200,30044,1399-11-15
24,سيتا,سرمايه گذاري سيمان تامين,12543,38645633,579838682500,15040,15010,15010,-30,-0.2,15000,-40,-0.27,15000,15050,1399-11-15
25,بپيوند,برق و انرژي پيوندگستر پارس,12181,8452403,131430236441,15935,16200,15250,-685,-4.3,15549,-386,-2.42,15150,16490,1399-11-15
26,آبادا,توليد نيروي برق آبادان,12146,6903793,105331480590,15740,15550,15050,-690,-4.38,15260,-480,-3.05,14960,16280,1399-11-15
27,رافزا,رايان هم افزا,11350,66164,2843000916,40923,42969,42969,2046,5.0,41033,110,0.27,42969,42969,1399-11-15
28,بگيلان,توسعه مسير برق گيلان,11217,3365333,72741447564,22154,22428,21411,-743,-3.35,21615,-539,-2.43,21100,22428,1399-11-15
29,وپويا,سرمايه گذاري پويا,11210,44186228,254813478930,5525,5801,5801,276,5.0,5767,242,4.38,5400,5801,1399-11-15
30,پيزد,مجتمع صنايع لاستيك يزد,11065,1547095,104998162546,65984,68980,69283,3299,5.0,67868,1884,2.86,64101,69283,1399-11-15
31,امين,تامين سرمايه امين,10910,10936280,113777675430,10400,10560,10410,10,0.1,10400,0,0.0,10400,10560,1399-11-15
32,وتجارت,بانك تجارت,10488,293208449,828389147920,2930,2930,2790,-140,-4.78,2830,-100,-3.41,2790,2980,1399-11-15
33,غگرجي,بيسكويت‌  گرجي‌,10451,37137414,786712424420,21240,22300,20180,-1060,-4.99,21180,-60,-0.28,20180,22300,1399-11-15
34,اپرداز,آتيه داده پرداز,10258,5022089,116601773369,22247,23357,23359,1112,5.0,23218,971,4.36,22272,23359,1399-11-15
35,خزاميا,زامياد,9941,99954728,814696668070,7900,8290,8040,140,1.77,8150,250,3.16,7820,8290,1399-11-15
36,آريا,پليمر آريا ساسول,9352,3276947,246140684334,77295,76805,74900,-2395,-3.1,75113,-2182,-2.82,73700,79520,1399-11-15
37,كاما,باما,9241,42260554,638650421410,15590,15500,14820,-770,-4.94,15110,-480,-3.08,14820,16200,1399-11-15
38,ذوب,سهامي ذوب آهن  اصفهان,9163,140899185,570803432111,4225,4210,4014,-211,-4.99,4051,-174,-4.12,4014,4300,1399-11-15
39,چفيبر,فيبر ايران‌,8747,46993444,722364686220,15210,15970,14560,-650,-4.27,15370,160,1.05,14450,15970,1399-11-15
40,سبهان,سيمان‌ بهبهان‌,8608,4890386,690054953250,142980,142000,135840,-7140,-4.99,141100,-1880,-1.31,135840,149000,1399-11-15
41,فولاد,فولاد مباركه اصفهان,8201,75189910,810371684980,11230,10750,10670,-560,-4.99,10780,-450,-4.01,10670,11490,1399-11-15
42,شتران,پالايش نفت تهران,8147,73336106,642231699460,9120,8890,8670,-450,-4.93,8760,-360,-3.95,8670,9250,1399-11-15
43,زنگان,صنعت روي زنگان,7693,3839357,500152887947,130100,136605,123595,-6505,-5.0,130270,170,0.13,123595,136605,1399-11-15
44,تليسه,دامداري تليسه نمونه,7678,85004063,393640201707,4585,4814,4469,-116,-2.53,4631,46,1.0,4361,4814,1399-11-15
45,پترول,گروه پتروشيمي س. ايرانيان,7668,58600873,546171815180,9710,9700,9230,-480,-4.94,9320,-390,-4.02,9230,9950,1399-11-15
46,آينده,بازرگاني آينده سازان بهشت پارس,7122,23508759,610703787174,25143,25141,26400,1257,5.0,25978,835,3.32,24310,26400,1399-11-15
47,وخارزم,سرمايه گذاري خوارزمي,6909,57493463,487175370030,8730,8740,8300,-430,-4.93,8470,-260,-2.98,8300,9040,1399-11-15
48,شگويا,پتروشيمي تندگويان,6880,32741502,269168498035,8499,8633,8094,-405,-4.77,8221,-278,-3.27,8080,8760,1399-11-15
49,كفپارس,فرآورده‌هاي‌ نسوز پارس‌,6811,109842530,446817737050,4090,3890,4290,200,4.89,4070,-20,-0.49,3890,4290,1399-11-15
50,آوا,صندوق س.سهام آواي معيار-س,6798,54649445,437860199733,8064,8064,7849,-215,-2.67,8012,-52,-0.64,7710,8440,1399-11-15
51,فزرين,زرين معدن آسيا,6782,29810010,695108685128,22390,23509,22840,450,2.01,23318,928,4.14,22525,23509,1399-11-15
52,دماوند,توليد نيروي برق دماوند,6704,9970643,537527183055,52712,55300,51560,-1152,-2.19,53911,1199,2.27,50520,55347,1399-11-15
53,فروي,ذوب روي اصفهان,6622,4955590,319202388189,63911,66199,62900,-1011,-1.58,64413,502,0.79,61000,67106,1399-11-15
54,خپارس,پارس‌ خودرو,6460,93892780,531796084860,5790,5910,5510,-280,-4.84,5660,-130,-2.25,5510,6030,1399-11-15
55,غبهار,كشت وصنعت بهاران گلبهار خراسان,6378,13940101,515446122675,38416,36496,36496,-1920,-5.0,36976,-1440,-3.75,36496,37950,1399-11-15
56,حكشتي,كشتيراني جمهوري اسلامي ايران,6275,29134441,618695738180,21960,22280,20870,-1090,-4.96,21240,-720,-3.28,20870,22460,1399-11-15
57,تملت,تامين سرمايه بانك ملت,6245,36542699,231889467020,6190,6490,6200,10,0.16,6350,160,2.58,6100,6490,1399-11-15
58,وپارس,بانك‌پارسيان‌,6134,205582660,599762509910,2990,2950,2860,-130,-4.35,2920,-70,-2.34,2850,3120,1399-11-15
59,وملي,گروه‌ صنعتي‌ ملي‌ (هلدينگ‌,6068,2792055,513043964860,182920,190000,177690,-5230,-2.86,183750,830,0.45,174010,192060,1399-11-15
60,زماهان,مجتمع توليد گوشت مرغ ماهان,6044,9427996,445432866762,49145,47100,46700,-2445,-4.98,47246,-1899,-3.86,46688,50602,1399-11-15
61,ديران,ايران‌دارو,6007,14790607,460415272690,31230,32790,29700,-1530,-4.9,31130,-100,-0.32,29670,32790,1399-11-15
62,فنوال,نورد آلومينيوم‌,5928,23652278,677071919780,27450,28820,28820,1370,4.99,28630,1180,4.3,27500,28820,1399-11-15
63,وبصادر,بانك صادرات ايران,5740,145987130,368714223250,2620,2550,2490,-130,-4.96,2530,-90,-3.44,2490,2670,1399-11-15
64,فولاي,صنايع فولاد آلياژي يزد,5563,10850642,530895438872,47555,48650,47200,-355,-0.75,48928,1373,2.89,46300,49932,1399-11-15
65,وبملت,بانك ملت,5505,123083194,466850755920,3960,3850,3770,-190,-4.8,3790,-170,-4.29,3770,4020,1399-11-15
66,فرابورس,فرابورس ايران,5444,15023906,522177439454,34922,35960,33868,-1054,-3.02,34756,-166,-0.48,33300,36600,1399-11-15
67,كماسه,تامين‌ ماسه‌ ريخته‌گري‌,5396,8999150,430538211820,48230,50640,46030,-2200,-4.56,47840,-390,-0.81,45820,50640,1399-11-15
68,سبزوا,سيمان لار سبزوار,5284,58338939,232524697855,4113,3920,3981,-132,-3.21,3986,-127,-3.09,3908,4170,1399-11-15
69,سفارس,سيمان فارس و خوزستان,5264,25956784,497314572630,19330,19900,18550,-780,-4.04,19160,-170,-0.88,18370,20280,1399-11-15
70,فمراد,آلومراد,5246,2752537,493267129780,181140,190190,172090,-9050,-5.0,179200,-1940,-1.07,172090,190190,1399-11-15
71,وساپا,سرمايه‌گذاري‌ سايپا,5237,52058807,309938072740,5910,6080,5990,80,1.35,5950,40,0.68,5700,6200,1399-11-15
72,ثنام,س ساختماني ب نام آوران مهندسي,5172,32042819,552931527310,16984,16135,17833,849,5.0,17256,272,1.6,16135,17833,1399-11-15
73,كلر,كلر پارس,5168,7676274,1033617750664,138532,141340,135770,-2762,-1.99,134651,-3881,-2.8,131606,145457,1399-11-15
74,لابسا,آبسال‌,5134,6844896,372955095270,55370,52610,52610,-2760,-4.98,54490,-880,-1.59,52610,57700,1399-11-15
75,حپارسا,توسعه حمل و نقل ريلي پارسيان,5071,8571587,314603241222,36924,37000,36010,-914,-2.48,36703,-221,-0.6,35078,38399,1399-11-15
76,تكشا,گسترش‌صنايع‌وخدمات‌كشاورزي‌,4932,9038986,473432024770,54240,51530,52790,-1450,-2.67,52380,-1860,-3.43,51530,54000,1399-11-15
77,درهآور,دارويي ره آورد تامين,4887,11002177,512733367895,45017,47267,47267,2250,5.0,46603,1586,3.52,42767,47267,1399-11-15
78,انرژي3,سايراشخاص بورس انرژي,4873,1396181,422500130280,313540,310000,297870,-15670,-5.0,302610,-10930,-3.49,297870,326140,1399-11-15
79,حآسا,آسيا سير ارس,4729,9858731,465619999396,48128,48600,45722,-2406,-5.0,47229,-899,-1.87,45722,50520,1399-11-15
80,غگيلا,شيرپاستوريزه پگاه گيلان,4675,67215,1540836660,21833,22924,22924,1091,5.0,21865,32,0.15,22924,22924,1399-11-15
81,زمگسا,كشاورزي‌ ودامپروي‌ مگسال‌,4595,12119795,396498123540,31640,33220,32430,790,2.5,32710,1070,3.38,30370,33220,1399-11-15
82,وغدير,سرمايه‌گذاري‌غدير(هلدينگ‌,4594,40619325,446531888200,11490,11440,10920,-570,-4.96,10990,-500,-4.35,10920,11790,1399-11-15
83,فارس,صنايع پتروشيمي خليج فارس,4512,36476527,318921884230,9150,8920,8700,-450,-4.92,8740,-410,-4.48,8700,9350,1399-11-15
84,ددام,داروسازي زاگرس فارمد پارس,4476,16193025,373600481870,23500,22800,22590,-910,-3.87,23070,-430,-1.83,22330,24500,1399-11-15
85,گكوثر,هتل پارسيان كوثر اصفهان,4430,75942685,221487168810,2992,3110,2843,-149,-4.98,2917,-75,-2.51,2843,3110,1399-11-15
86,ثامان,سامان‌ گستراصفهان‌,4391,13976141,361966636410,26620,27950,25290,-1330,-5.0,25900,-720,-2.7,25290,27950,1399-11-15
87,تكنو,تكنوتار,4297,15667673,419773436470,25710,25500,26990,1280,4.98,26790,1080,4.2,25500,26990,1399-11-15
88,دانا,بيمه دانا,4282,46260893,304175419480,6750,6900,6440,-310,-4.59,6580,-170,-2.52,6420,7070,1399-11-15
89,دبالك,مواد اوليه دارويي البرز بالك,4246,15040375,319469047107,20751,21788,20920,169,0.81,21241,490,2.36,20070,21788,1399-11-15
90,كترام,توليدي‌ كاشي‌ تكسرام‌,4233,9763322,448218103470,43950,46140,46140,2190,4.98,45910,1960,4.46,44620,46140,1399-11-15
91,خبهمن,گروه‌بهمن‌,4192,21873244,439490133420,20780,21000,19750,-1030,-4.96,20090,-690,-3.32,19750,21400,1399-11-15
92,نوري,پتروشيمي نوري,4138,5249727,274624997940,54390,55470,51680,-2710,-4.98,52310,-2080,-3.82,51680,56000,1399-11-15
93,قصفها,قنداصفهان‌,4104,3144530,545710285030,168370,176780,167000,-1370,-0.81,173540,5170,3.07,161310,176780,1399-11-15
94,كپارس,كاشي‌ پارس‌,4059,1704561,267311312310,157420,164000,155900,-1520,-0.97,156820,-600,-0.38,149550,164990,1399-11-15
95,فاذر,صنايع‌ آذرآب‌,4028,16414932,375883910510,21930,22670,23020,1090,4.97,22900,970,4.42,22100,23020,1399-11-15
96,قشكر,شكرشاهرود,4021,77230546,314523567400,4270,4120,4060,-210,-4.92,4070,-200,-4.68,4060,4260,1399-11-15
97,شبندر,پالايش نفت بندرعباس,3965,22290085,452574205060,21220,20600,20160,-1060,-5.0,20300,-920,-4.34,20160,21510,1399-11-15
98,سشرق,سيمان‌ شرق‌,3927,37307295,274720449820,7450,7650,7360,-90,-1.21,7360,-90,-1.21,7100,7790,1399-11-15
99,خموتور,موتورسازان‌تراكتورسازي‌ايران‌,3905,15286994,279457893550,18550,19000,17630,-920,-4.96,18280,-270,-1.46,17630,19410,1399-11-15
100,ولراز,ليزينگ رازي,3890,5166325,316949475351,60524,57498,63550,3026,5.0,61349,825,1.36,57498,63550,1399-11-15
101,زكوثر,سرمايه گذاري كشاورزي كوثر,3881,9497927,211236096410,22500,23350,21770,-730,-3.24,22240,-260,-1.16,21380,23350,1399-11-15
102,ختوقا,قطعات‌ اتومبيل‌ ايران‌,3858,68372017,180146411350,2640,2700,2570,-70,-2.65,2630,-10,-0.38,2530,2770,1399-11-15
103,ثالوند,سرمايه گذاري مسكن الوند,3837,34429714,992182236220,27556,28933,28933,1377,5.0,28818,1262,4.58,27556,28933,1399-11-15
104,سيلام,سيمان‌ ايلام‌,3803,32776923,318301202710,9330,9790,9790,460,4.93,9710,380,4.07,8870,9790,1399-11-15
105,غسالم,سالمين‌,3800,34162171,145039754100,4390,4440,4180,-210,-4.78,4250,-140,-3.19,4180,4490,1399-11-15
106,وسپهح,ح . سرمايه‌گذاري‌ سپه‌,3772,16465724,77317276480,160,4520,4720,4560,2850.0,4700,4540,2837.5,4520,4900,1399-11-15
107,كالا,بورس كالاي ايران,3763,7412312,247792148560,34120,35000,32420,-1700,-4.98,33430,-690,-2.02,32420,35400,1399-11-15
108,ثاخت,بين‌المللي‌توسعه‌ساختمان,3683,61526437,190835418230,3200,3220,3040,-160,-5.0,3100,-100,-3.13,3040,3280,1399-11-15
109,غگل,گلوكوزان‌,3668,57507382,220593026250,4010,3900,3810,-200,-4.99,3840,-170,-4.24,3710,3940,1399-11-15
110,بترانس,ايران‌ ترانسفو,3654,63321485,163503969290,2700,2630,2570,-130,-4.81,2580,-120,-4.44,2570,2680,1399-11-15
111,دعبيد,لابراتوارداروسازي‌  دكترعبيدي‌,3645,7056311,179403730630,24770,24660,26000,1230,4.97,25420,650,2.62,24040,26000,1399-11-15
112,خاذين,سايپاآذين‌,3620,54045940,247180521000,4400,4620,4620,220,5.0,4570,170,3.86,4300,4620,1399-11-15
113,خكمك,كمك‌فنرايندامين‌,3612,9635978,260234241210,27030,27400,28380,1350,4.99,27010,-20,-0.07,25680,28380,1399-11-15
114,زقيام,كشت و دام قيام اصفهان,3610,11424315,333331765620,28492,29916,29290,798,2.8,29177,685,2.4,27600,29916,1399-11-15
115,حفارس,حمل و نقل بين المللي خليج فارس,3598,61370613,337487302090,5720,5440,5440,-280,-4.9,5500,-220,-3.85,5440,5870,1399-11-15
116,سرو,صندوق س سروسودمند مدبران-سهام,3563,3620547,242266043250,68120,69000,65700,-2420,-3.55,66910,-1210,-1.78,65100,70440,1399-11-15
117,والبر,سرمايه‌ گذاري‌ البرز(هلدينگ‌,3540,16049300,264748868700,16470,17150,16300,-170,-1.03,16500,30,0.18,15650,17290,1399-11-15
118,خودكفا,اقتصادي و خودكفايي آزادگان,3514,13926614,391681927518,29111,28100,27656,-1455,-5.0,28125,-986,-3.39,27656,29980,1399-11-15
119,خنصير,مهندسي‌نصيرماشين‌,3473,3275110,308310321180,91080,93200,94800,3720,4.08,94140,3060,3.36,91750,95630,1399-11-15
120,ونيكي,سرمايه‌گذاري‌ ملي‌ايران‌,3445,15181500,161890007210,11060,11140,10510,-550,-4.97,10660,-400,-3.62,10510,11480,1399-11-15
121,فاراك,ماشين‌ سازي‌ اراك‌,3357,48987974,247748361850,5260,5300,5000,-260,-4.94,5060,-200,-3.8,5000,5380,1399-11-15
122,ثعمرا,عمران و توسعه شاهد,3356,20906808,257356842342,11917,12498,12380,463,3.89,12310,393,3.3,11440,12512,1399-11-15
123,بكام,كارخانجات توليدي شهيد قندي,3327,51968610,168594401590,3200,3300,3280,80,2.5,3240,40,1.25,3160,3320,1399-11-15
124,قثابت,قند ثابت‌ خراسان‌,3319,8179265,555862069110,67640,71000,64260,-3380,-5.0,67960,320,0.47,64260,71000,1399-11-15
125,صبا,سرمايه گذاري صبا تامين,3295,23206021,177059872921,7945,7800,7548,-397,-5.0,7630,-315,-3.96,7548,8069,1399-11-15
126,ماديرا,صنايع ماشين هاي اداري ايران,3260,22065555,221260009150,10472,10000,9949,-523,-4.99,10027,-445,-4.25,9949,10470,1399-11-15
127,حفاري,حفاري شمال,3230,23889713,257448582170,11120,11250,10630,-490,-4.41,10780,-340,-3.06,10570,11550,1399-11-15
128,غديس,پاكديس,3220,21964894,287103929446,12528,13154,13154,626,5.0,13071,543,4.33,12680,13154,1399-11-15
129,زدشت,كشت و صنعت دشت خرم دره,3218,6828143,243077258729,36804,37600,34964,-1840,-5.0,35599,-1205,-3.27,34964,37600,1399-11-15
130,ودي,بيمه  دي,3167,13915135,343298302310,24096,25300,23800,-296,-1.23,24671,575,2.39,23500,25300,1399-11-15
131,خاور,ايران خودرو ديزل,3140,28212110,189973664622,6630,6710,6513,-117,-1.76,6734,104,1.57,6370,6961,1399-11-15
132,بزاگرس,نيروگاه زاگرس كوثر,3107,25334594,169694087687,6609,6600,6933,324,4.9,6698,89,1.35,6279,6939,1399-11-15
133,وصنا,گروه‌صنايع‌بهشهرايران‌,3104,26654884,174512304930,6340,6650,6380,40,0.63,6550,210,3.31,6040,6650,1399-11-15
134,ومعادن,توسعه‌معادن‌وفلزات‌,3090,33296096,348317370080,10890,10730,10350,-540,-4.96,10460,-430,-3.95,10350,11100,1399-11-15
135,ونوين,بانك‌اقتصادنوين‌,3061,55947205,212032558090,3940,3940,3750,-190,-4.82,3790,-150,-3.81,3750,4030,1399-11-15
136,تاصيكو,سرمايه گذاري صدرتامين,3011,29592698,325252487130,11320,11310,10760,-560,-4.95,10990,-330,-2.92,10760,11460,1399-11-15
137,كسرا,سراميك‌هاي‌صنعتي‌اردكان‌,3007,15428555,356566364350,23090,23090,22650,-440,-1.91,23110,20,0.09,21940,24240,1399-11-15
138,فافزا,فولاد افزا سپاهان,3007,4170619,252866831594,60786,58963,58963,-1823,-3.0,60631,-155,-0.25,58963,62609,1399-11-15
139,خفناور,مهندسي صنعتي روان فن آور,3004,7688547,361128673096,44911,47156,47156,2245,5.0,46970,2059,4.58,46000,47156,1399-11-15
140,ثغرب,شركت سرمايه گذاري مسكن شمالغرب,2992,17704318,123701405034,6953,7190,6750,-203,-2.92,6987,34,0.49,6660,7250,1399-11-15
141,البرز,بيمه البرز,2991,38364533,148750319710,3960,3980,3770,-190,-4.8,3880,-80,-2.02,3770,4150,1399-11-15
142,غمارگ,مارگارين‌,2932,7749029,263469935610,32700,33000,34330,1630,4.98,34000,1300,3.98,31510,34330,1399-11-15
143,كمند,صندوق س. با درآمد ثابت كمند,2928,124581175,1266571303535,10159,10165,10167,8,0.08,10167,8,0.08,10164,10170,1399-11-15
144,خمحركه,نيرو محركه‌,2925,33519993,167337945290,5160,5160,4910,-250,-4.84,4990,-170,-3.29,4910,5310,1399-11-15
145,دتوزيعح,ح . توزيع دارو پخش,2806,5164984,170739647812,32914,33100,32500,-414,-1.26,33057,143,0.43,32191,34400,1399-11-15
146,سخاش,سيمان‌خاش‌,2802,1061421,148978985930,136810,131100,141910,5100,3.73,140360,3550,2.59,131100,143300,1399-11-15
147,ثباغ,شهر سازي و خانه سازي باغميشه,2790,20753298,351812086833,16160,16968,16968,808,5.0,16952,792,4.9,16350,16968,1399-11-15
148,ونيرو,سرمايه‌گذاري‌نيرو,2724,51474571,137157159390,2770,2770,2640,-130,-4.69,2660,-110,-3.97,2640,2860,1399-11-15
149,غشهداب,كشت و صنعت شهداب ناب خراسان,2692,30851479,109069968299,3648,3739,3500,-148,-4.06,3535,-113,-3.1,3466,3750,1399-11-15
150,نطرين,عطرين نخ قم,2676,10405540,116395890378,10934,10799,11480,546,4.99,11186,252,2.3,10450,11480,1399-11-15
151,وصنعت,سرمايه گذاري توسعه صنعت وتجارت,2671,37230375,237612691840,6580,6600,6420,-160,-2.43,6380,-200,-3.04,6260,6730,1399-11-15
152,پاكشو,گروه صنعتي پاكشو,2658,2999526,244023192520,82990,83750,81890,-1100,-1.33,81350,-1640,-1.98,78850,84500,1399-11-15
153,زشگزا,شير و گوشت زاگرس شهركرد,2658,16208782,163811301184,10449,10780,9927,-522,-5.0,10106,-343,-3.28,9927,10780,1399-11-15
154,ملت,بيمه ملت,2648,14289753,202152555560,13690,14000,14370,680,4.97,14150,460,3.36,13230,14370,1399-11-15
155,آ س پ,آ.س.پ,2646,12180769,181740949680,15419,15470,14655,-764,-4.95,14920,-499,-3.24,14649,15730,1399-11-15
156,بكهنوج,توليد برق ماهتاب كهنوج,2608,54220592,98146731890,1873,1949,1783,-90,-4.81,1810,-63,-3.36,1780,1949,1399-11-15
157,چكاپا,گروه صنايع كاغذ پارس,2593,31371591,168123473810,5580,5500,5310,-270,-4.84,5360,-220,-3.94,5310,5600,1399-11-15
158,حريل,ريل پردازسير,2578,34153485,163258831984,4969,4984,4721,-248,-4.99,4780,-189,-3.8,4721,5100,1399-11-15
159,غنوش,نوش‌ مازندران‌,2573,7314088,393168209930,51270,53700,53830,2560,4.99,53750,2480,4.84,52500,53830,1399-11-15
160,چدن,توليدي چدن سازان,2538,6630252,175729737990,26720,27780,25830,-890,-3.33,26500,-220,-0.82,25560,27780,1399-11-15
161,قشير,قند شيروان قوچان و بجنورد,2497,7730592,202488771728,25042,26294,26294,1252,5.0,26193,1151,4.6,25051,26294,1399-11-15
162,ولساپا,ليزينگ رايان‌ سايپا,2495,44522204,165219048130,3720,3730,3610,-110,-2.96,3710,-10,-0.27,3560,3890,1399-11-15
163,كوثر,بيمه كوثر,2483,19602028,326876852902,15959,16756,16756,797,4.99,16676,717,4.49,16000,16756,1399-11-15
164,بالبر,كابل‌ البرز,2481,7847489,363367795160,46430,48750,44110,-2320,-5.0,46300,-130,-0.28,44110,48750,1399-11-15
165,آگاس,صندوق س.هستي بخش آگاه-س,2477,2150450,140600243456,65960,66900,64001,-1959,-2.97,65382,-578,-0.88,63500,67850,1399-11-15
166,امين يكم,صندوق درآمد ثابت امين يكم فردا,2451,80647620,820380856558,10169,10172,10174,5,0.05,10172,3,0.03,10169,10175,1399-11-15
167,بايكا,كارخانجات كابلسازي ‌ايران‌,2447,5022799,225893331746,43778,43028,45091,1313,3.0,44974,1196,2.73,43028,45091,1399-11-15
168,آسيا,بيمه آسيا,2443,44217071,117285688790,2730,2750,2600,-130,-4.76,2650,-80,-2.93,2600,2790,1399-11-15
169,وكارح,ح . بانك‌ كارآفرين‌,2382,102455279,149317194770,1590,1510,1430,-160,-10.06,1460,-130,-8.18,1430,1630,1399-11-15
170,غگلپا,شير پاستوريزه پگاه گلپايگان,2355,2777570,191451493172,66146,69199,69453,3307,5.0,68928,2782,4.21,65497,69453,1399-11-15
171,بجهرم,توسعه مولد نيروگاهي جهرم,2350,31473600,91140353096,3036,2980,2895,-141,-4.64,2896,-140,-4.61,2885,2990,1399-11-15
172,فروس,فروسيليس‌ ايران‌,2345,25083481,123809394010,4750,4980,4980,230,4.84,4940,190,4.0,4570,4980,1399-11-15
173,سيمرغ,سيمرغ,2328,10757525,181238718470,17060,17700,16540,-520,-3.05,16850,-210,-1.23,16210,17910,1399-11-15
174,كحافظ,كاشي‌ وسراميك‌ حافظ‌,2327,7663976,101532244570,13040,13100,13170,130,1.0,13250,210,1.61,12900,13590,1399-11-15
175,ميهن,بيمه ميهن,2309,20170369,97043806528,4831,5070,4621,-210,-4.35,4811,-20,-0.41,4595,5070,1399-11-15
176,تابا,تابان نيرو سپاهان,2294,6203858,357760275182,57986,59725,56247,-1739,-3.0,57667,-319,-0.55,56247,59725,1399-11-15
177,قچار,فراوردههاي غذايي وقند چهارمحال,2232,2762216,241285351985,84642,85999,87950,3308,3.91,87352,2710,3.2,82946,88874,1399-11-15
178,وحكمت,بيمه حكمت صبا,2216,24102924,102447284502,4402,4182,4230,-172,-3.91,4250,-152,-3.45,4182,4500,1399-11-15
179,مدير,ص.س.مديريت ثروت ص.بازنشستگي-س,2206,13025520,119864910658,9404,9410,9030,-374,-3.98,9202,-202,-2.15,8941,9670,1399-11-15
180,بكاب,صنايع‌جوشكاب‌يزد,2180,520344,216614066980,433710,412030,412030,-21680,-5.0,416290,-17420,-4.02,412030,430500,1399-11-15
181,غبهنوش,بهنوش‌ ايران‌,2176,2187242,160190263440,76720,73500,72890,-3830,-4.99,73240,-3480,-4.54,72890,76720,1399-11-15
182,ثرود,سرمايه‌گذاري مسكن زاينده رود,2148,11448023,165858983618,13960,14020,14658,698,5.0,14488,528,3.78,13502,14658,1399-11-15
183,اعتماد,صندوق س.اعتماد آفرين پارسيان-د,2064,48518650,1683205915840,34655,34668,34696,41,0.12,34692,37,0.11,34668,34699,1399-11-15
184,لسرما,سرما آفرين‌,2057,5129868,135363053910,25400,25910,26670,1270,5.0,26390,990,3.9,25000,26670,1399-11-15
185,غاذر,كشت‌وصنعت‌پياذر,2054,1720495,100793347080,57440,58200,58650,1210,2.11,58580,1140,1.98,55900,60310,1399-11-15
186,پكوير,كوير تاير,2050,10336137,148307185360,14470,14700,14000,-470,-3.25,14350,-120,-0.83,13750,15040,1399-11-15
187,ثاباد,توريستي ورفاهي آبادگران ايران,2040,3528277,169598678160,46630,46500,48960,2330,5.0,48070,1440,3.09,44440,48960,1399-11-15
188,افرا,افرانت,2038,2968400,98844343189,33531,35190,32250,-1281,-3.82,33299,-232,-0.69,31856,35190,1399-11-15
189,حتايد,تايدواترخاورميانه,2033,7190529,172364888730,24000,24960,23920,-80,-0.33,23970,-30,-0.13,22840,25100,1399-11-15
190,كفرآور,فرآورده هاي سيمان شرق,2030,7448371,179758182963,23623,24331,24331,708,3.0,24134,511,2.16,22915,24331,1399-11-15
191,فاسمين,كالسيمين‌,2027,12660323,177342749880,14610,14990,13880,-730,-5.0,14010,-600,-4.11,13880,15000,1399-11-15
192,غپينو,پارس‌ مينو,2013,20547409,136394440220,6940,6900,6600,-340,-4.9,6640,-300,-4.32,6600,6960,1399-11-15
193,شصدف,صنعتي دوده فام,2011,54301,1563488693,27422,28793,28793,1371,5.0,27463,41,0.15,28793,28793,1399-11-15
194,فالوم,آلومتك‌,2007,6397909,246585405604,39616,39616,39450,-166,-0.42,38542,-1074,-2.71,38428,40000,1399-11-15
195,زپارس,ملي كشت و صنعت و دامپروري پارس,1997,3871824,580693535530,144510,151730,151730,7220,5.0,149980,5470,3.79,141860,151730,1399-11-15
196,ركيش,كارت اعتباري ايران كيش,1963,6351075,151254970870,22840,23730,23720,880,3.85,23820,980,4.29,23300,23980,1399-11-15
197,فخوز,فولاد  خوزستان,1948,10451694,127087324130,12620,12500,11990,-630,-4.99,12160,-460,-3.65,11990,12750,1399-11-15
198,غالبر,لبنيات‌ كالبر,1920,8066747,125199231750,14930,15580,15670,740,4.96,15520,590,3.95,14500,15670,1399-11-15
199,تاپيكو,س. نفت و گاز و پتروشيمي تأمين,1832,18233480,206462464590,11820,11820,11230,-590,-4.99,11320,-500,-4.23,11230,12090,1399-11-15
200,سمازن,سيمان‌مازندران‌,1826,8371473,88037260900,10160,10630,10560,400,3.94,10520,360,3.54,10160,10660,1399-11-15
201,زاگرس,پتروشيمي زاگرس,1820,790816,141714941657,185819,189760,176560,-9259,-4.98,179201,-6618,-3.56,176529,189760,1399-11-15
202,كچاد,معدني‌وصنعتي‌چادرملو,1818,10018656,192739214200,20060,19730,19060,-1000,-4.99,19240,-820,-4.09,19060,20100,1399-11-15
203,ساراب,سيمان‌ داراب‌,1816,14837651,235515165910,15160,15910,15910,750,4.95,15870,710,4.68,15230,15910,1399-11-15
204,ستران,سيمان‌ تهران‌,1816,4805193,130527290940,28150,28800,26750,-1400,-4.97,27160,-990,-3.52,26750,28900,1399-11-15
205,غفارس,شير پاستوريزه پگاه فارس,1802,11623238,133777491234,11637,11101,11730,93,0.8,11509,-128,-1.1,11056,12065,1399-11-15
206,شسينا,صنايع‌شيميايي‌سينا,1797,695622,93068467240,137670,140000,130790,-6880,-5.0,133790,-3880,-2.82,130790,141600,1399-11-15
207,نوين,بيمه نوين,1790,18360402,113764545383,6456,6457,6134,-322,-4.99,6196,-260,-4.03,6134,6680,1399-11-15
208,اخابر,مخابرات ايران,1779,15772697,161649353610,10700,10660,10170,-530,-4.95,10250,-450,-4.21,10170,10800,1399-11-15
209,كاوه,فولاد كاوه جنوب كيش,1778,26740994,455541530230,17850,17700,16960,-890,-4.99,17040,-810,-4.54,16960,18170,1399-11-15
210,مداران,داده‌پردازي‌ايران‌,1777,5911912,142846951140,24920,24110,24770,-150,-0.6,24160,-760,-3.05,23680,25270,1399-11-15
211,ختور,رادياتور ايران‌,1757,3801234,88288197270,23990,23990,22800,-1190,-4.96,23230,-760,-3.17,22800,24600,1399-11-15
212,كسعديح,ح . كاشي‌ سعدي‌,1755,9231158,138005927740,16360,15520,14720,-1640,-10.02,14950,-1410,-8.62,14720,16350,1399-11-15
213,فاما,صنعتي‌ آما,1751,8448797,184493477600,20820,21200,21860,1040,5.0,21840,1020,4.9,21200,21860,1399-11-15
214,لخزر,پارس‌ خزر,1745,511759,92973571230,174760,182970,183490,8730,5.0,181670,6910,3.95,175000,183490,1399-11-15
215,بنو,بيمه تجارت نو,1739,5738154,177604838640,31077,32200,31199,122,0.39,30952,-125,-0.4,29600,32200,1399-11-15
216,چكارن,كارتن‌ ايران‌,1708,19151078,60896669160,3290,3320,3130,-160,-4.86,3180,-110,-3.34,3130,3370,1399-11-15
217,خريخت,صنايع‌ريخته‌گري‌ايران‌,1705,23896720,89874953290,3840,3990,3690,-150,-3.91,3760,-80,-2.08,3650,3990,1399-11-15
218,كبافق,معادن‌ بافق‌,1703,2147149,111873711540,53900,52300,51210,-2690,-4.99,52100,-1800,-3.34,51210,55500,1399-11-15
219,كروي,توسعه‌ معادن‌ روي‌ ايران‌,1699,4407123,116600590450,27630,27630,26260,-1370,-4.96,26460,-1170,-4.23,26250,28300,1399-11-15
220,ختراك,ريخته‌گري‌ تراكتورسازي‌ ايران‌,1682,11238443,151632082540,14160,13460,13600,-560,-3.95,13490,-670,-4.73,13460,13800,1399-11-15
221,سپاها,سيمان‌سپاهان‌,1672,14427084,130091164720,9000,9410,8860,-140,-1.56,9020,20,0.22,8690,9410,1399-11-15
222,وآوا,سرمايه گذاري آوا نوين,1658,6466126,48523071990,7766,7900,7500,-266,-3.43,7504,-262,-3.37,7378,8000,1399-11-15
223,قرن,پديده شيمي قرن,1650,1696069,105636538150,64110,64110,60990,-3120,-4.87,62280,-1830,-2.85,60950,65100,1399-11-15
224,فلامي,لاميران‌,1649,1858104,89436207260,49470,51000,47000,-2470,-4.99,48130,-1340,-2.71,47000,51000,1399-11-15
225,سفانو,سيمان فارس نو,1641,2236498,89075257700,39030,40000,39350,320,0.82,39830,800,2.05,38010,40690,1399-11-15
226,غپآذر,شير پگاه آذربايجان شرقي,1641,1550946,98436271307,64028,65800,61201,-2827,-4.42,63469,-559,-0.87,60827,66900,1399-11-15
227,افق,فروشگاههاي زنجيره اي افق كوروش,1640,1206489,97425592120,81170,80200,81000,-170,-0.21,80750,-420,-0.52,79000,83040,1399-11-15
228,كگل,معدني و صنعتي گل گهر,1632,9796895,166431580730,17610,17400,16740,-870,-4.94,16990,-620,-3.52,16730,18000,1399-11-15
229,فسازان,غلتك سازان سپاهان,1605,3178930,112622073290,35580,34040,34910,-670,-1.88,35430,-150,-0.42,34040,37300,1399-11-15
230,خكاوه,سايپا ديزل,1564,24802552,109736319649,4579,4450,4351,-228,-4.98,4424,-155,-3.39,4351,4700,1399-11-15
231,كسعدي,كاشي‌ سعدي‌,1523,6100068,119409822600,20380,20480,19370,-1010,-4.96,19580,-800,-3.93,19370,20480,1399-11-15
232,رتكو,كنترل‌خوردگي‌تكين‌كو,1515,8477502,187129035290,21130,21430,22180,1050,4.97,22070,940,4.45,21400,22180,1399-11-15
233,شلرد,كود شيميايي اوره لردگان,1513,13800033,100141249780,7426,7420,7204,-222,-2.99,7257,-169,-2.28,7204,7570,1399-11-15
234,ساربيل,سيمان آرتا اردبيل,1506,1913816,87382210830,47160,47600,44810,-2350,-4.98,45660,-1500,-3.18,44810,47900,1399-11-15
235,خكرمان,گروه اقتصادي كرمان خودرو,1472,19727859,88530433192,4665,4590,4432,-233,-4.99,4488,-177,-3.79,4432,4800,1399-11-15
236,ورنا,سرمايه‌گذاري‌ رنا(هلدينگ‌,1471,17458146,97474990600,5750,5790,5470,-280,-4.87,5580,-170,-2.96,5470,5970,1399-11-15
237,شيران,س. صنايع‌شيميايي‌ايران,1470,5480627,155540978870,29540,28070,28070,-1470,-4.98,28380,-1160,-3.93,28070,30000,1399-11-15
238,وگردش,بانك گردشگري,1464,14751565,289254894545,20173,20001,19568,-605,-3.0,19608,-565,-2.8,19568,20173,1399-11-15
239,دلقما,دارويي‌ لقمان‌,1461,2208073,50228683280,22890,24000,22100,-790,-3.45,22750,-140,-0.61,21800,24000,1399-11-15
240,بورس,بورس اوراق بهادار تهران,1455,2382911,98549561260,42340,41320,40230,-2110,-4.98,41360,-980,-2.31,40230,44010,1399-11-15
241,سهرمز,سيمان‌هرمزگان‌,1432,4209094,117177567640,26720,28020,27310,590,2.21,27840,1120,4.19,26690,28050,1399-11-15
242,شفارس,صنايع‌ شيميايي‌ فارس‌,1427,3225952,149697085960,48300,48300,46680,-1620,-3.35,46400,-1900,-3.93,45890,49500,1399-11-15
243,وليز,ليزينگ‌ايران‌,1419,18521899,130903250690,7390,7330,7030,-360,-4.87,7070,-320,-4.33,7030,7330,1399-11-15
244,سشمال,سيمان‌ شمال‌,1416,8181560,80762910160,9620,9450,10100,480,4.99,9870,250,2.6,9200,10100,1399-11-15
245,ساوه,سيمان ساوه,1413,858274,43657755981,53235,51000,50574,-2661,-5.0,51089,-2146,-4.03,50574,52990,1399-11-15
246,رتاپ,تجارت الكترونيك  پارسيان,1402,13303617,83360549170,6520,6650,6200,-320,-4.91,6270,-250,-3.83,6200,6650,1399-11-15
247,تپمپي,پمپ‌ سازي‌ ايران‌,1392,3194856,64359087880,20910,21220,19870,-1040,-4.97,20140,-770,-3.68,19870,21420,1399-11-15
248,ارزش,صندوق س ارزش آفرين بيدار-سهام,1391,7621482,73466082860,9740,9980,9510,-230,-2.36,9640,-100,-1.03,9340,10150,1399-11-15
249,وبيمه,سرمايه‌ گذاري‌ صنعت‌ بيمه‌,1387,17068426,46639276760,2800,2810,2660,-140,-5.0,2730,-70,-2.5,2660,2890,1399-11-15
250,سصوفي,سيمان‌ صوفيان‌,1376,5804366,84956819790,15050,15390,14490,-560,-3.72,14640,-410,-2.72,14300,15390,1399-11-15
251,واحيا,م .صنايع و معادن احياء سپاهان,1374,2176212,316362671943,152979,145331,145331,-7648,-5.0,145373,-7606,-4.97,145331,148000,1399-11-15
252,چكاوهح,ح . صنايع‌كاغذسازي‌كاوه‌,1367,9810115,111500059180,11250,11340,11000,-250,-2.22,11370,120,1.07,10400,12200,1399-11-15
253,غصينو,صنعتي مينو,1357,1787228,137253855839,79017,75900,75067,-3950,-5.0,76797,-2220,-2.81,75067,81860,1399-11-15
254,وكادو,تكادو,1356,6998565,170116559446,25515,24240,24240,-1275,-5.0,24307,-1208,-4.73,24240,24805,1399-11-15
255,كمنگنز,معادن‌منگنزايران‌,1345,860537,78283514500,94680,93300,90500,-4180,-4.41,90970,-3710,-3.92,89950,96990,1399-11-15
256,وملل,اعتباري ملل,1344,12099934,179282529420,14845,14700,15000,155,1.04,14817,-28,-0.19,14355,15000,1399-11-15
257,فرآور,فرآوري‌موادمعدني‌ايران‌,1339,4489216,140174231720,32770,31170,31140,-1630,-4.97,31220,-1550,-4.73,31140,32550,1399-11-15
258,ثشرق,سرمايه گذاري مسكن شمال شرق,1334,16370421,88267225850,5620,5740,5340,-280,-4.98,5390,-230,-4.09,5340,5760,1399-11-15
259,تبرك,گروه كارخانجات صنعتي تبرك,1332,3954526,60988858169,16065,16600,15262,-803,-5.0,15423,-642,-4.0,15262,16600,1399-11-15
260,سصفها,سيمان‌اصفهان‌,1323,330055,130017005720,395150,400100,397500,2350,0.59,393930,-1220,-0.31,385000,400100,1399-11-15
261,ومهان,گروه توسعه مالي مهر آيندگان,1314,5301366,65626492009,12764,12939,12350,-414,-3.24,12379,-385,-3.02,12126,12939,1399-11-15
262,وبانك,سرمايه گذاري گروه توسعه ملي,1302,12881749,103501090540,8410,8070,8000,-410,-4.88,8030,-380,-4.52,7990,8510,1399-11-15
263,شپديس,پتروشيمي پرديس,1278,2858346,260110642600,94950,93700,90210,-4740,-4.99,91000,-3950,-4.16,90210,96000,1399-11-15
264,وپست,پست بانك ايران,1274,9734409,169667501800,18200,17790,17290,-910,-5.0,17430,-770,-4.23,17290,18460,1399-11-15
265,ولبهمن,شركت بهمن ليزينگ,1270,9578549,73564840327,7606,7630,7599,-7,-0.09,7680,74,0.97,7300,7986,1399-11-15
266,بشهاب,لامپ‌  پارس‌ شهاب‌,1264,1211583,151779557560,121610,127690,127690,6080,5.0,125270,3660,3.01,116380,127690,1399-11-15
267,فوكا,فولاد كاويان,1262,15117482,193073450590,12400,12772,12772,372,3.0,12772,372,3.0,12511,12772,1399-11-15
268,شفن,پتروشيمي فناوران,1260,381838,108356351860,294930,287320,280220,-14710,-4.99,283780,-11150,-3.78,280190,295000,1399-11-15
269,ارفع,شركت آهن و فولاد ارفع,1257,7946558,88157164462,11605,11500,11040,-565,-4.87,11094,-511,-4.4,11025,11850,1399-11-15
270,پدرخش,درخشان‌ تهران‌,1256,1170868,159003874400,129340,135800,135800,6460,4.99,135800,6460,4.99,135800,135800,1399-11-15
271,دتوليد,داروسازي توليد دارو,1256,2650567,74139651305,28845,29200,27403,-1442,-5.0,27971,-874,-3.03,27403,29700,1399-11-15
272,شبريز,پالايش نفت تبريز,1252,5500792,143031707870,27060,26390,25710,-1350,-4.99,26000,-1060,-3.92,25710,27360,1399-11-15
273,تاپكيش,تجارت الكترونيك پارسيان كيش,1251,3302107,76601042746,24265,23400,23052,-1213,-5.0,23198,-1067,-4.4,23052,24022,1399-11-15
274,كهمدا,شيشه‌ همدان‌,1247,4984908,50142208980,10050,10250,9890,-160,-1.59,10060,10,0.1,9710,10450,1399-11-15
275,سمتاز,سيمان ممتازان كرمان,1235,5036102,97638878570,19009,18600,19579,570,3.0,19388,379,1.99,18439,19579,1399-11-15
276,خمحور,توليدمحورخودرو,1224,1490984,82489660930,55790,56000,56960,1170,2.1,55330,-460,-0.82,53010,57890,1399-11-15
277,فلوله,لوله‌وماشين‌سازي‌ايران‌,1217,5525889,111400148860,20890,21660,19850,-1040,-4.98,20160,-730,-3.49,19850,21780,1399-11-15
278,ومعلم,بيمه معلم,1210,11539436,54023704567,4845,4670,4603,-242,-4.99,4682,-163,-3.36,4603,5029,1399-11-15
279,ونفت,سرمايه‌گذاري‌ صنعت‌ نفت‌,1204,5506020,89051920130,16610,16220,15990,-620,-3.73,16170,-440,-2.65,15780,17210,1399-11-15
280,خشرق,الكتريك‌ خودرو شرق‌,1200,5975015,99334773410,17310,17100,16650,-660,-3.81,16630,-680,-3.93,16450,17600,1399-11-15
281,وايران,ليزينگ ايرانيان,1198,5574870,68935213740,12910,12540,12270,-640,-4.96,12370,-540,-4.18,12270,12980,1399-11-15
282,تپولا,مهندسي مرآت پولاد,1195,1957822,74840870186,39545,37570,38200,-1345,-3.4,38227,-1318,-3.33,37568,39600,1399-11-15
283,پلاسك,پلاسكوكار,1195,8837071,75084352220,8770,8900,8340,-430,-4.9,8500,-270,-3.08,8340,9050,1399-11-15
284,وساخت,سرمايه‌ گذاري‌ ساختمان‌ايران‌,1193,2483154,118598690240,49980,49000,47490,-2490,-4.98,47760,-2220,-4.44,47490,50500,1399-11-15
285,آپ,آسان پرداخت پرشين,1181,4046776,67611331110,17350,17060,16490,-860,-4.96,16710,-640,-3.69,16490,17760,1399-11-15
286,فباهنر,مس‌ شهيدباهنر,1176,1627665,83237173800,51950,50000,50010,-1940,-3.73,51140,-810,-1.56,50000,53700,1399-11-15
287,وشهر,بانك شهر,1175,17965786,107978395932,6142,6200,5897,-245,-3.99,6010,-132,-2.15,5897,6250,1399-11-15
288,وثخوز,سرمايه گذاري و توسعه خوزستان,1174,1303057,94830218365,76159,75100,72352,-3807,-5.0,72775,-3384,-4.44,72352,76600,1399-11-15
289,وسكاب,س.ص.بازنشستگي كاركنان بانكها,1170,12430884,78325828030,6530,6630,6210,-320,-4.9,6300,-230,-3.52,6210,6650,1399-11-15
290,زگلدشت,كشت و دام گلدشت نمونه اصفهان,1167,1677937,90535182588,56342,57000,53525,-2817,-5.0,53956,-2386,-4.23,53525,57000,1399-11-15
291,وثنو,سرمايه گذاري ساختماني نوين,1163,4461792,76502040074,17789,18000,16900,-889,-5.0,17146,-643,-3.61,16900,18200,1399-11-15
292,پارسان,گسترش نفت و گاز پارسيان,1142,11553420,204074017610,18320,18680,17420,-900,-4.91,17660,-660,-3.6,17410,18870,1399-11-15
293,پخش,پخش البرز,1140,2636182,88100204265,33555,34500,33870,315,0.94,33420,-135,-0.4,32000,34970,1399-11-15
294,غپاك,لبنيات‌ پاك‌,1135,5537413,84648035530,15130,15580,14990,-140,-0.93,15290,160,1.06,14800,15600,1399-11-15
295,رانفور,خدمات‌انفورماتيك‌,1124,2298184,60166416700,27370,26250,26040,-1330,-4.86,26560,-810,-2.96,26010,27990,1399-11-15
296,شسپا,نفت سپاهان,1124,5514811,127218302950,24030,23500,22830,-1200,-4.99,23070,-960,-4.0,22830,24890,1399-11-15
297,غويتا,ويتانا,1099,2544034,51312143676,20779,20090,19741,-1038,-5.0,20170,-609,-2.93,19741,21300,1399-11-15
298,وسين,بيمه سينا,1097,4408185,79978833934,17879,18770,17891,12,0.07,18143,264,1.48,17880,18770,1399-11-15
299,واعتبار,سرمايه گذاري اعتبار ايران,1093,6983789,60466264710,8520,8720,8700,180,2.11,8660,140,1.64,8400,8870,1399-11-15
300,قمرو,قند مرودشت‌,1091,1732654,51232475990,28310,29720,29720,1410,4.98,29470,1160,4.1,28500,29720,1399-11-15
301,دزهراويح,ح . ‌داروسازي‌زهراوي‌,1090,7928149,49827968170,6940,6640,6250,-690,-9.94,6280,-660,-9.51,6250,6650,1399-11-15
302,بهپاك,صنعتي بهپاك,1084,2427264,105395431727,44838,46000,44210,-628,-1.4,43421,-1417,-3.16,42597,46490,1399-11-15
303,رنيك,جنرال مكانيك,1059,2700052,57173800871,22161,21800,21053,-1108,-5.0,21175,-986,-4.45,21053,22369,1399-11-15
304,ثپرديس,سرمايه گذاري مسكن پرديس,1058,6855188,78757128164,11959,11420,11362,-597,-4.99,11489,-470,-3.93,11362,12170,1399-11-15
305,قنيشا,قند  نيشابور,1057,1161916,74330563180,66070,66000,62770,-3300,-4.99,63970,-2100,-3.18,62770,67190,1399-11-15
306,كيان,صندوق س. با درآمد ثابت كيان,1056,16733618,452450471066,27018,27040,27050,32,0.12,27038,20,0.07,27035,27050,1399-11-15
307,سرچشمه,سرمايه گذاري مس سرچشمه,1056,8376522,55636683848,6701,6940,6709,8,0.12,6642,-59,-0.88,6450,6940,1399-11-15
308,تكمبا,كمباين‌ سازي‌ ايران‌,1054,7600703,70120529480,9620,9780,9140,-480,-4.99,9230,-390,-4.05,9140,9780,1399-11-15
309,ثاصفا,شركت‌ ساختمان‌ اصفهان‌,1033,3373542,89063215316,27628,26247,26247,-1381,-5.0,26401,-1227,-4.44,26247,26930,1399-11-15
310,فجر,فولاد اميركبيركاشان,1010,1173561,76203476720,65440,66980,63600,-1840,-2.81,64930,-510,-0.78,63030,67970,1399-11-15
311,خچرخش,چرخشگر,1009,3988337,69672596570,18090,18080,17190,-900,-4.98,17470,-620,-3.43,17190,18800,1399-11-15
312,مفاخر,توسعه فناوري اطلاعات خوارزمي,1005,1329085,69114739862,52923,55569,50277,-2646,-5.0,52002,-921,-1.74,50277,55569,1399-11-15
313,وبوعلي,سرمايه‌گذاري‌بوعلي‌,1003,9447763,53590638220,5870,5590,5580,-290,-4.94,5670,-200,-3.41,5580,5990,1399-11-15
314,تنوين,تامين سرمايه نوين,985,9824951,60082313780,5970,6170,6080,110,1.84,6120,150,2.51,6000,6250,1399-11-15
315,كشرق,صنعتي و معدني شمال شرق شاهرود,985,497471,47867759548,94677,98990,97000,2323,2.45,96158,1481,1.56,93000,98990,1399-11-15
316,ريشمك,توليد و صادرات ريشمك,978,1888883,109275366413,60740,58270,57703,-3037,-5.0,57852,-2888,-4.75,57703,60750,1399-11-15
317,وسپه,سرمايه‌گذاري‌ سپه‌,977,6273322,42986319310,7120,6900,6800,-320,-4.49,6880,-240,-3.37,6790,7170,1399-11-15
318,بالاس,مهندسي ساختمان تاسيسات راه آهن,974,1481120,84676067343,59799,60000,56810,-2989,-5.0,57170,-2629,-4.4,56810,60000,1399-11-15
319,همراه,شركت ارتباطات سيار ايران,973,2564170,66540732720,27190,26200,25840,-1350,-4.97,26330,-860,-3.16,25840,26990,1399-11-15
320,كتوكاح,ح.توليدي وخدمات صنايع نسوزتوكا,972,2848112,68410597574,23096,22600,24250,1154,5.0,24020,924,4.0,22600,24250,1399-11-15
321,شدوص,دوده‌ صنعتي‌ پارس‌,971,3492860,103803689200,31050,31060,29500,-1550,-4.99,29720,-1330,-4.28,29500,31060,1399-11-15
322,دفارا,داروسازي‌ فارابي‌,970,1673589,99536432170,61000,59700,57950,-3050,-5.0,59470,-1530,-2.51,57950,61750,1399-11-15
323,شكبير,پتروشيمي اميركبير,970,2308916,213530263269,91132,93790,90940,-192,-0.21,92481,1349,1.48,89000,93865,1399-11-15
324,خرينگ,رينگ‌سازي‌مشهد,967,1293460,66913704010,54090,51500,51390,-2700,-4.99,51730,-2360,-4.36,51390,53690,1399-11-15
325,بميلا,توسعه بازرگاني آهن وفولادميلاد,965,3568804,81410452386,23795,22800,22606,-1189,-5.0,22812,-983,-4.13,22606,23998,1399-11-15
326,وخاور,بانك خاورميانه,962,10451144,104779569540,10300,10010,9900,-400,-3.88,10030,-270,-2.62,9790,10430,1399-11-15
327,غشوكو,شوكو پارس,955,1276868,56692566833,43587,42280,44894,1307,3.0,44400,813,1.87,42280,44894,1399-11-15
328,كاردان,صندوق س تجارت شاخصي كاردان,954,560257,85445881450,154380,154520,151000,-3380,-2.19,152510,-1870,-1.21,147100,161300,1399-11-15
329,ثنوسا,نوسازي‌وساختمان‌تهران‌,953,7992193,105750266250,13790,13900,13110,-680,-4.93,13230,-560,-4.06,13110,13900,1399-11-15
330,وآذر,سرمايه‌گذاري‌توسعه‌آذربايجان‌,949,1215603,114632501250,98180,94000,93280,-4900,-4.99,94300,-3880,-3.95,93280,98000,1399-11-15
331,هرمز,فولاد هرمزگان جنوب,948,5639932,67891209126,12564,12700,11960,-604,-4.81,12239,-325,-2.59,11936,12850,1399-11-15
332,تسه9910,امتياز تسهيلات مسكن دي99,943,15406,8909320612,550764,578302,578302,27538,5.0,578302,27538,5.0,578302,578302,1399-11-15
333,سكرما,سيمان‌ كرمان‌,943,4674220,78407887200,16180,16740,16980,800,4.94,16770,590,3.65,15690,16980,1399-11-15
334,خاهن,آهنگري‌ تراكتورسازي‌ ايران‌,942,2980549,113322941370,38080,38890,38010,-70,-0.18,38020,-60,-0.16,38000,38890,1399-11-15
335,كطبس,ذغال‌سنگ‌ نگين‌ ط‌بس‌,940,1431862,112017654880,80780,82400,76750,-4030,-4.99,78230,-2550,-3.16,76750,82400,1399-11-15
336,كي بي سي,شركت كي بي سي,937,1959066,58115302446,30730,30270,29194,-1536,-5.0,29665,-1065,-3.47,29194,31400,1399-11-15
337,غشان,شيرپاستوريزه‌پگاه‌خراسان‌,935,9358480,53237541450,5900,5660,5610,-290,-4.92,5690,-210,-3.56,5610,5960,1399-11-15
338,شغدير,پتروشيمي غدير,930,1263608,70637564958,56770,54500,54950,-1820,-3.21,55901,-869,-1.53,53932,59600,1399-11-15
339,پرديس,سرمايه گذاري پرديس,921,7597830,49154591730,6360,6500,6400,40,0.63,6460,100,1.57,6310,6670,1399-11-15
340,شپترو,پتروشيمي آبادان,908,19361076,91989235568,4614,4752,4752,138,2.99,4751,137,2.97,4621,4752,1399-11-15
341,وپترو,سرمايه‌گذاري صنايع پتروشيمي‌,902,3942249,57850961060,14690,14570,14130,-560,-3.81,14670,-20,-0.14,14130,15070,1399-11-15
342,غويتاح,ح . ويتانا,901,4555754,64191605125,14693,14990,13959,-734,-5.0,14090,-603,-4.1,13959,14990,1399-11-15
343,ثمسكن,سرمايه‌گذاري‌ مسكن‌,898,11582487,56257420460,5070,5070,4820,-250,-4.93,4860,-210,-4.14,4820,5140,1399-11-15
344,وتوكا,سرمايه‌گذاري‌توكافولاد(هلدينگ,896,7461888,73502334270,10280,10070,9770,-510,-4.96,9850,-430,-4.18,9770,10470,1399-11-15
345,وبهمن,سرمايه‌گذاري‌بهمن‌,894,5538689,92760819450,17570,16750,16720,-850,-4.84,16750,-820,-4.67,16700,17550,1399-11-15
346,خوساز,محورسازان‌ايران‌خودرو,892,5617392,46876559210,8590,8280,8170,-420,-4.89,8370,-220,-2.56,8170,8780,1399-11-15
347,حسينا,توسعه خدمات دريايي وبندري سينا,888,894059,65163675775,72869,71600,70901,-1968,-2.7,72885,16,0.02,70500,75880,1399-11-15
348,اميد,تامين سرمايه اميد,886,6450457,51713722350,8080,8370,7880,-200,-2.48,8020,-60,-0.74,7830,8370,1399-11-15
349,شاراك,پتروشيمي شازند,881,4719411,105853479650,23470,23900,22360,-1110,-4.73,22430,-1040,-4.43,22300,23900,1399-11-15
350,ولغدر,ليزينگ‌خودروغدير,876,2520070,58316743780,24180,23500,22980,-1200,-4.96,23140,-1040,-4.3,22980,24000,1399-11-15
351,كپرور,فرآوري زغال سنگ پروده طبس,871,1992769,80801463742,42353,43500,40600,-1753,-4.14,40547,-1806,-4.26,40236,43970,1399-11-15
352,ولشرق,ليزينگ ايران و شرق,869,7549151,57905687310,7913,7630,7518,-395,-4.99,7670,-243,-3.07,7518,8121,1399-11-15
353,دسانكو,داروسازي سبحان انكولوژي,866,3288770,52637020032,16411,16859,15591,-820,-5.0,16005,-406,-2.47,15591,17000,1399-11-15
354,وسينا,بانك سينا,860,10084290,35560559360,3630,3470,3450,-180,-4.96,3560,-70,-1.93,3450,3680,1399-11-15
355,وبشهر,توسعه‌ صنايع‌ بهشهر(هلدينگ,848,4396608,51447467300,12130,12400,11600,-530,-4.37,11700,-430,-3.54,11530,12470,1399-11-15
356,دتوزيع,توزيع دارو پخش,846,917759,47208605201,48990,51439,51439,2449,5.0,51339,2349,4.79,51439,51439,1399-11-15
357,توريل,توکاريل,822,3461691,85001927963,25520,25274,24244,-1276,-5.0,24555,-965,-3.78,24244,25647,1399-11-15
358,غشصفا,شيرپاستوريزه‌پگاه‌اصفهان‌,821,3650242,102997350430,29110,29660,27660,-1450,-4.98,28220,-890,-3.06,27660,29940,1399-11-15
359,فسپا,گروه‌صنعتي‌سپاهان‌,819,1713683,67354697770,40090,41700,38710,-1380,-3.44,39300,-790,-1.97,38250,41940,1399-11-15
360,سبجنو,سيمان‌ بجنورد,818,2178446,109146699860,47750,50130,50130,2380,4.98,50100,2350,4.92,48630,50130,1399-11-15
361,شرانل,نفت ايرانول,817,1543762,57638574706,38454,38980,36769,-1685,-4.38,37336,-1118,-2.91,36542,39890,1399-11-15
362,فسرب,ملي‌ سرب‌وروي‌ ايران‌,810,480839,39101980460,84660,83930,80430,-4230,-5.0,81800,-2860,-3.38,80430,86600,1399-11-15
363,پارس,پتروشيمي پارس,803,1607188,199048457380,129680,131390,123200,-6480,-5.0,123850,-5830,-4.5,123200,131390,1399-11-15
364,چافست,افست‌,802,2069167,33984451070,17150,16500,16300,-850,-4.96,16640,-510,-2.97,16300,17110,1399-11-15
365,دكوثر,داروسازي‌ كوثر,799,3068218,60303821870,20500,20980,19480,-1020,-4.98,19650,-850,-4.15,19480,20980,1399-11-15
366,شبهرن,نفت‌ بهران‌,794,1222386,71070355310,59530,60880,57950,-1580,-2.65,58140,-1390,-2.33,57150,60880,1399-11-15
367,وصندوق,سرمايه‌گذاري‌صندوق‌بازنشستگي‌,794,2492331,32649663020,13580,13230,13000,-580,-4.27,13450,-130,-0.96,12930,13690,1399-11-15
368,چكاوه,صنايع‌كاغذسازي‌كاوه‌,793,11482809,165763259690,13780,14460,14460,680,4.93,14440,660,4.79,13110,14460,1399-11-15
369,دسبحان,سبحان دارو,793,3049040,64565293040,21340,21450,21340,0,0.0,21180,-160,-0.75,20280,22400,1399-11-15
370,پاسا,ايران‌ياساتايرورابر,792,2743030,64919682750,24550,24490,23330,-1220,-4.97,23670,-880,-3.58,23330,25380,1399-11-15
371,ما,بيمه  ما,789,4663109,40912453820,8830,8990,8700,-130,-1.47,8790,-40,-0.45,8450,9010,1399-11-15
372,رمپنا,گروه مپنا (سهامي عام),783,8029664,132358527100,17270,16500,16410,-860,-4.98,16480,-790,-4.57,16410,17450,1399-11-15
373,وپاسار,بانك  پاسارگاد,771,5299541,59613288370,11750,11500,11170,-580,-4.94,11480,-270,-2.3,11170,11750,1399-11-15
374,پارتا,مجتمع‌صنعتي‌آرتاويل‌تاير,770,2204258,139610312008,64682,63000,62742,-1940,-3.0,63337,-1345,-2.08,62742,66000,1399-11-15
375,كوير,توليدي فولاد سپيد فراب كوير,765,2926010,75959219600,24730,25960,25960,1230,4.97,25570,840,3.4,25960,25960,1399-11-15
376,ميدكو,هلدينگ صنايع  معدني خاورميانه,760,1583637,47486657070,31486,30011,29912,-1574,-5.0,30860,-626,-1.99,29912,31000,1399-11-15
377,خلنت,لنت‌ ترمزايران‌,760,569605,58930573810,108130,108050,102730,-5400,-4.99,103460,-4670,-4.32,102730,108050,1399-11-15
378,وتوسم,سرمايه‌گذاري‌توسعه‌ملي‌,754,4247375,48672401370,11630,11630,11380,-250,-2.15,11460,-170,-1.46,11200,12050,1399-11-15
379,تيپيكو,سرمايه گذاري دارويي تامين,752,1316419,59325445170,46990,46700,45000,-1990,-4.23,45530,-1460,-3.11,44650,47470,1399-11-15
380,بموتو,موتوژن‌,742,1224548,67668137360,57930,58800,55040,-2890,-4.99,55260,-2670,-4.61,55040,58800,1399-11-15
381,دروز,داروسازي‌ روزدارو,738,2451997,61967219720,24390,24100,25600,1210,4.96,25270,880,3.61,24100,25600,1399-11-15
382,بسويچ,پارس‌سويچ‌,730,1114916,55881167370,52430,50300,49810,-2620,-5.0,50120,-2310,-4.41,49810,53700,1399-11-15
383,پارند,صندوق س. پارند پايدار سپهر,726,26247883,298756909636,11371,11397,11384,13,0.11,11382,11,0.1,11380,11397,1399-11-15
384,فپنتا,سپنتا,724,98331,41481245290,421760,402020,415000,-6760,-1.6,421830,70,0.02,402020,439000,1399-11-15
385,واميد,گروه مديريت سرمايه گذاري اميد,720,2015298,76912585080,39180,38160,37230,-1950,-4.98,38500,-680,-1.74,37230,39400,1399-11-15
386,شكلر,نيروكلر,716,3328490,175072843770,55290,52530,52530,-2760,-4.99,52600,-2690,-4.87,52530,53500,1399-11-15
387,وتوشه,سرمايه‌ گذاري‌ پارس‌ توشه‌,712,1958568,43580092730,22120,22200,21670,-450,-2.03,22230,110,0.5,21530,23200,1399-11-15
388,زملارد,كشاورزي و دامپروري ملارد شير,701,1777883,65913234342,39025,37074,37074,-1951,-5.0,37074,-1951,-5.0,37074,37074,1399-11-15
389,امين يكم2,صندوق درآمد ثابت امين يكم فردا,700,70000000,70000000,10169,1,1,-10168,-99.99,1,-10168,-99.99,1,1,1399-11-15
390,اتكام,شركت بيمه اتكايي امين,699,3790338,19506267399,5123,5320,5174,51,1.0,5133,10,0.2,5000,5350,1399-11-15
391,وگستر,گسترش سرمايه گذاري ايرانيان,695,1603885,31462404128,20365,20190,19347,-1018,-5.0,19854,-511,-2.51,19347,20940,1399-11-15
392,وسنا,سرمايه گذاري نيروگاهي ايران,695,5902572,109327091724,17656,18538,18538,882,5.0,18522,866,4.9,17981,18538,1399-11-15
393,ضسپا1102,اختيارخ خساپا-2000-1399/11/26,691,28913,5587562000,226,279,160,-66,-29.2,193,-33,-14.6,148,299,1399-11-15
394,شخارك,پتروشيمي‌ خارك‌,689,444044,18439925050,43060,42190,41340,-1720,-3.99,42770,-290,-0.67,40910,43100,1399-11-15
395,شساخت,مهندسي و ساختمان صنايع نفت,678,2472123,105345045283,42945,44230,41657,-1288,-3.0,42613,-332,-0.77,41657,44233,1399-11-15
396,ولملت,واسپاري ملت,678,3963775,37812206410,9980,9540,9490,-490,-4.91,9610,-370,-3.71,9490,9970,1399-11-15
397,شگل,گلتاش‌,675,2050011,51719200320,26410,26020,25090,-1320,-5.0,25230,-1180,-4.47,25090,26700,1399-11-15
398,وسكرد,شركت س استان كردستان,674,33482497,24460203780,760,730,730,-30,-3.95,740,-20,-2.63,730,740,1399-11-15
399,خفنر,فنرسازي‌خاور,673,2743792,63629966520,24040,23590,22840,-1200,-4.99,23190,-850,-3.54,22840,24030,1399-11-15
400,خمهر,مهركام‌پارس‌,660,12883134,33569089430,2700,2640,2570,-130,-4.81,2630,-70,-2.59,2570,2780,1399-11-15
401,اوان,مبين وان كيش,659,1184138,59803922239,49988,50000,50000,12,0.02,50504,516,1.03,49000,51460,1399-11-15
402,تايرا,تراكتورسازي‌ايران‌,657,904611,26110492630,28520,29600,28650,130,0.46,28690,170,0.6,28400,29600,1399-11-15
403,ثنور,سرمايه گذاري كوه نور,649,8536476,110897359716,12613,12991,12991,378,3.0,12991,378,3.0,12991,12991,1399-11-15
404,سخزر,سيمان‌ خزر,646,1555863,46770182970,31240,29800,29680,-1560,-4.99,30110,-1130,-3.62,29680,31600,1399-11-15
405,ولصنم,ليزينگ‌صنعت‌ومعدن‌,642,4476636,50240934390,11680,11270,11100,-580,-4.97,11220,-460,-3.94,11100,11910,1399-11-15
406,شپاكسا,پاكسان‌,642,2205637,65741758310,31170,31000,29620,-1550,-4.97,29810,-1360,-4.36,29620,31470,1399-11-15
407,شكف,كف,638,511207,42050028565,83576,81905,81912,-1664,-1.99,82256,-1320,-1.58,81905,84880,1399-11-15
408,سقاين,سيمان‌ قائن‌,637,1101909,88288701870,83300,79140,79140,-4160,-4.99,80120,-3180,-3.82,79140,84600,1399-11-15
409,ورازي,بيمه رازي,636,4330802,34814622267,8272,8510,7950,-322,-3.89,8039,-233,-2.82,7877,8510,1399-11-15
410,لبوتان,گروه‌صنعتي‌بوتان‌,630,520818,33734442070,67850,67160,64470,-3380,-4.98,65680,-2170,-3.2,64460,67200,1399-11-15
411,هجرت,پخش هجرت,628,838625,22684360813,28155,28900,26748,-1407,-5.0,27657,-498,-1.77,26748,28900,1399-11-15
412,گوهران,سرمايه گذاري توسعه گوهران اميد,623,3525762,27931870389,7850,7990,7999,149,1.9,7890,40,0.51,7750,8049,1399-11-15
413,ياقوت,صندوق س ياقوت آگاه-ثابت,621,18923749,224014833531,11817,11839,11838,21,0.18,11838,21,0.18,11820,11839,1399-11-15
414,بمپنا,توليد برق عسلويه  مپنا,618,520805,39186508966,77484,78250,73610,-3874,-5.0,75681,-1803,-2.33,73610,79999,1399-11-15
415,فايرا,آلومينيوم‌ايران‌,615,1708041,40833838680,24270,24010,23390,-880,-3.63,23980,-290,-1.19,23310,25200,1399-11-15
416,فن آوا,گروه فن آوا,614,5790166,104640195385,17705,18230,18236,531,3.0,18072,367,2.07,17210,18236,1399-11-15
417,كمينا,شيشه سازي مينا,614,1304576,36910958732,29394,28200,27925,-1469,-5.0,28293,-1101,-3.75,27925,29880,1399-11-15
418,غبشهر,صنعتي‌ بهشهر,614,2180330,45652958930,20790,21230,20900,110,0.53,20920,130,0.63,20500,21620,1399-11-15
419,دزهراوي,داروسازي‌زهراوي‌,611,3322665,26963314490,8520,8260,8100,-420,-4.93,8290,-230,-2.7,8100,8400,1399-11-15
420,لوتوس,تامين سرمايه لوتوس پارسيان,606,2189959,22411901230,10590,10590,10100,-490,-4.63,10430,-160,-1.51,10070,10900,1399-11-15
421,وسگيلا,شركت س استان گيلان,605,19331686,15249883430,810,850,770,-40,-4.94,800,-10,-1.23,770,850,1399-11-15
422,كساوه,صنايع‌ كاشي‌ و سراميك‌ سينا,597,651864,46952041840,75280,71520,71520,-3760,-4.99,72030,-3250,-4.32,71520,75270,1399-11-15
423,كرازي,كارخانجات‌توليدي‌شيشه‌رازي‌,596,2722682,72205526640,25260,26520,26520,1260,4.99,26520,1260,4.99,26520,26520,1399-11-15
424,دامين,داروسازي‌ امين‌,595,1766610,26485521120,15630,15510,14850,-780,-4.99,15280,-350,-2.24,14850,15510,1399-11-15
425,ضخود2005,اختيارخ خودرو-2000-1400/02/08,594,25696,16520841000,706,858,608,-98,-13.88,643,-63,-8.92,590,885,1399-11-15
426,غشهد,شهد ايران ‌,594,4311646,27769181980,6700,6700,6380,-320,-4.78,6550,-150,-2.24,6370,6790,1399-11-15
427,غمينو,شركت صنايع غذايي مينو شرق,593,3374429,43901804471,13613,13600,12933,-680,-5.0,13010,-603,-4.43,12933,14293,1399-11-15
428,سغرب,سيمان‌غرب‌,588,906099,22594099420,25330,26000,25190,-140,-0.55,25150,-180,-0.71,24170,26000,1399-11-15
429,دالبر,البرزدارو,586,1618650,34223651280,21250,22200,21260,10,0.05,21180,-70,-0.33,20190,22210,1399-11-15
430,قهكمت,قندهكمتان‌,586,718447,33096870000,44770,46000,46000,1230,2.75,45590,820,1.83,44810,47000,1399-11-15
431,شپارس,بين‌ المللي‌ محصولات‌  پارس‌,583,2702785,45521992410,17600,17900,17000,-600,-3.41,16840,-760,-4.32,16720,17900,1399-11-15
432,قنقش,قند نقش جهان,577,829918,62111183315,74601,73110,76093,1492,2.0,74840,239,0.32,73109,76093,1399-11-15
433,فيروزه,صندوق شاخص30 شركت فيروزه- سهام,576,325653,45549851380,141940,145000,138500,-3440,-2.42,139870,-2070,-1.46,138000,145400,1399-11-15
434,بخاور,بيمه زندگي خاورميانه,574,4899612,33804593532,7135,7370,6978,-157,-2.2,6973,-162,-2.27,6779,7370,1399-11-15
435,دسبحا,گروه دارويي سبحان,560,2082950,39880749340,19490,19990,18590,-900,-4.62,19250,-240,-1.23,18520,19990,1399-11-15
436,حاريا,كشتيراني آريا,556,2266248,70493723930,32707,31072,31072,-1635,-5.0,31106,-1601,-4.89,31072,31770,1399-11-15
437,كگهر,سنگ آهن گهرزمين,553,1083411,50575321845,47102,47200,45700,-1402,-2.98,46929,-173,-0.37,44747,48000,1399-11-15
438,سامان,بانك سامان,552,9890048,99000848385,10313,10004,10004,-309,-3.0,10010,-303,-2.94,10004,10303,1399-11-15
439,غدشت,دشت‌ مرغاب‌,549,201796,57185183500,271500,263170,285070,13570,5.0,283380,11880,4.38,263170,285070,1399-11-15
440,كنور,توسعه معدني و صنعتي صبانور,549,749655,32491618170,44530,44500,43390,-1140,-2.56,43770,-760,-1.71,42310,44920,1399-11-15
441,سيدكو,سرمايه گذاري توسعه صنايع سيمان,544,3882978,22909751860,5980,6130,5770,-210,-3.51,5940,-40,-0.67,5720,6150,1399-11-15
442,تسه9908,امتياز تسهيلات مسكن آبان99,543,12551,7423304073,563348,591515,591515,28167,5.0,591451,28103,4.99,580009,591515,1399-11-15
443,شوينده,مديريت صنعت شوينده ت.ص.بهشهر,542,1121915,37256625740,34130,33400,32900,-1230,-3.6,33420,-710,-2.08,32650,34800,1399-11-15
444,فولاژ,فولاد آلياژي ايران,540,2665739,39967449920,15700,15220,14920,-780,-4.97,15230,-470,-2.99,14920,15700,1399-11-15
445,سكرد,سيمان كردستان,536,4285869,44658754980,9930,10420,10420,490,4.93,10290,360,3.63,10420,10420,1399-11-15
446,دلر,داروسازي‌ اكسير,535,562375,20327012110,35450,37200,35620,170,0.48,35740,290,0.82,33700,37200,1399-11-15
447,شفا,سرمايه گذاري شفادارو,532,578894,26148770640,43860,46050,44530,670,1.53,44520,660,1.5,41690,46050,1399-11-15
448,فخاس,فولاد خراسان,528,1133471,28973317070,26140,25880,26100,-40,-0.15,25970,-170,-0.65,25000,26400,1399-11-15
449,حپترو,حمل و نقل پتروشيمي( سهامي عام,526,1039021,45863027320,42050,44140,44150,2100,4.99,43610,1560,3.71,43000,44150,1399-11-15
450,خديزل,بهمن  ديزل,524,2284313,101894834403,46673,47900,44340,-2333,-5.0,44606,-2067,-4.43,44340,47989,1399-11-15
451,سجام,مجتمع سيمان غرب آسيا,520,2699942,15481846510,5949,5652,5652,-297,-4.99,5789,-160,-2.69,5652,5999,1399-11-15
452,وآرين,شركت توسعه اقتصادي آرين,518,4066866,18502964737,4667,4660,4527,-140,-3.0,4552,-115,-2.46,4527,4790,1399-11-15
453,ولتجار,واسپاري تجارت وسرمايه ايرانيان,511,3378994,28401107793,8565,8800,8309,-256,-2.99,8405,-160,-1.87,8309,8820,1399-11-15
454,آساميد,صندوق س.مشترك آسمان اميد -د,507,22848250,262773815775,11495,11501,11504,9,0.08,11501,6,0.05,11500,11505,1399-11-15
455,خكار,ايركا پارت صنعت,507,1729009,32948473570,19800,19990,18810,-990,-5.0,19220,-580,-2.93,18810,19990,1399-11-15
456,وتوس,توسعه‌شهري‌توس‌گستر,506,2115672,40595317190,20140,19140,19140,-1000,-4.97,19380,-760,-3.77,19140,19890,1399-11-15
457,وكار,بانك‌ كارآفرين‌,506,7002839,17763969020,2610,2560,2530,-80,-3.07,2580,-30,-1.15,2500,2660,1399-11-15
458,اعتلا,شركت سرمايه گذاري اعتلاء البرز,503,3691267,27788717013,7876,7876,7483,-393,-4.99,7662,-214,-2.72,7483,7876,1399-11-15
459,وپخش,داروپخش‌ (هلدينگ‌,503,180250,22511123050,123630,129810,123620,-10,-0.01,124140,510,0.41,118010,129810,1399-11-15
460,جم پيلن,پلي پروپيلن جم - جم پيلن,502,522087,35517000000,70540,71450,67900,-2640,-3.74,68900,-1640,-2.32,67020,71450,1399-11-15
461,آريان,سرمايه گذاري پارس آريان,501,9401293,119234302202,13062,13040,12671,-391,-2.99,12683,-379,-2.9,12671,13040,1399-11-15
462,تماوند,تامين سرمايه دماوند,499,1412021,25732181265,18500,18900,18000,-500,-2.7,18224,-276,-1.49,17649,18900,1399-11-15
463,سايرا,ايرانيت‌,499,815119,38711361512,46295,48146,48146,1851,4.0,47492,1197,2.59,45600,48146,1399-11-15
464,دارو,كارخانجات‌داروپخش‌,498,1061026,36557190040,35850,35500,34060,-1790,-4.99,34780,-1070,-2.98,34060,36000,1399-11-15
465,ثجوان,تامين مسكن جوانان,497,7509401,99431218782,12856,13241,13241,385,2.99,13241,385,2.99,13200,13241,1399-11-15
466,فبيرا,بسته‌ بندي‌ ايران‌,494,6431551,20233464025,3300,3135,3135,-165,-5.0,3146,-154,-4.67,3135,3284,1399-11-15
467,داوه,داروسازي آوه سينا,492,2143121,41347856040,20256,19400,19244,-1012,-5.0,19333,-923,-4.56,19244,19990,1399-11-15
468,شنفت,نفت‌ پارس‌,492,1133090,59522721170,53790,52650,52340,-1450,-2.7,52530,-1260,-2.34,52000,54700,1399-11-15
469,غگلستا,شير پاستوريزه پگاه گلستان,491,2645276,88640553484,31914,33509,33509,1595,5.0,33509,1595,5.0,33509,33509,1399-11-15
470,وتعاون,بيمه  تعاون,488,2954818,19975860925,6952,6944,6744,-208,-2.99,6760,-192,-2.76,6744,6944,1399-11-15
471,ضخود2007,اختيارخ خودرو-3000-1400/02/08,485,20644,5034305000,281,290,230,-51,-18.15,244,-37,-13.17,222,300,1399-11-15
472,واتي,سرمايه‌ گذاري‌ آتيه‌ دماوند,480,2665085,29684741980,11530,11540,10960,-570,-4.94,11310,-220,-1.91,10960,11820,1399-11-15
473,خپويش,سازه‌ پويش‌,475,672583,33514099640,47500,49870,49870,2370,4.99,48980,1480,3.12,47940,49870,1399-11-15
474,بساما,بيمه سامان,473,1236810,26446343874,22231,21120,21120,-1111,-5.0,21759,-472,-2.12,21120,22780,1399-11-15
475,قاسم,قاسم ايران,471,6168677,79360029605,12253,12865,12865,612,4.99,12865,612,4.99,12865,12865,1399-11-15
476,قزوين,كارخانجات‌ قند قزوين‌,470,776948,28395803380,36490,37500,36080,-410,-1.12,36520,30,0.08,35900,37900,1399-11-15
477,كدما,معدني‌ دماوند,466,226613,56247612730,261270,248210,248210,-13060,-5.0,248210,-13060,-5.0,248210,248210,1399-11-15
478,ساروم,سيمان‌اروميه‌,458,961680,33081792000,32770,34400,34400,1630,4.97,33650,880,2.69,34400,34400,1399-11-15
479,سپ,پرداخت الكترونيك سامان كيش,452,1333336,21248696480,15850,16390,15550,-300,-1.89,15890,40,0.25,15280,16530,1399-11-15
480,دلرح,ح . داروسازي‌ اكسير,449,575273,16682052290,29620,30500,28990,-630,-2.13,29000,-620,-2.09,28020,30930,1399-11-15
481,پكرمان,گروه‌ صنعتي‌ بارز,444,1983414,52183774240,27180,28100,25930,-1250,-4.6,26310,-870,-3.2,25840,28100,1399-11-15
482,غشاذر,پگاه‌آذربايجان‌غربي‌,443,1787064,37962666500,22270,21820,21160,-1110,-4.98,21360,-910,-4.09,21160,22300,1399-11-15
483,كتوكا,توليدي و خدمات صنايع نسوز توكا,435,805082,28652868380,33896,35590,35590,1694,5.0,34689,793,2.34,35590,35590,1399-11-15
484,شپاس,نفت پاسارگاد,430,1070920,23590346992,22679,21690,22480,-199,-0.88,22357,-322,-1.42,21684,23290,1399-11-15
485,اطلس,صندوق س.توسعه اندوخته آينده-س,430,65567,12944038373,199457,200000,194240,-5217,-2.62,197417,-2040,-1.02,194001,202000,1399-11-15
486,پارسيان,بيمه پارسيان,421,2161153,22822594060,11040,10540,10490,-550,-4.98,10800,-240,-2.17,10490,11200,1399-11-15
487,وملت,سرمايه گذاري ملت,421,5848564,25375476844,4254,4339,4339,85,2.0,4339,85,2.0,4260,4339,1399-11-15
488,قشهد,شهد,421,501309,16803029920,33490,34500,33270,-220,-0.66,33500,10,0.03,33270,34500,1399-11-15
489,مرقام,ايران‌ارقام‌,417,2183773,40231472650,19230,18770,18270,-960,-4.99,18590,-640,-3.33,18270,19500,1399-11-15
490,سهگمت,سيمان‌هگمتان‌,416,1056529,24422194540,24030,23390,23310,-720,-3.0,23570,-460,-1.91,22830,24290,1399-11-15
491,سخوز,سيمان خوزستان,413,873382,20420870130,23970,24030,23110,-860,-3.59,23730,-240,-1.0,22920,24450,1399-11-15
492,وهنر,گروه توسعه هنر ايران,411,3506493,30492463128,8443,8696,8696,253,3.0,8696,253,3.0,8696,8696,1399-11-15
493,كاريس,صندوق س.سپهر كاريزما-س,409,2521249,26925269892,10772,10700,10489,-283,-2.63,10679,-93,-0.86,10448,11090,1399-11-15
494,كرماشا,صنايع پتروشيمي كرمانشاه,398,491221,17596840510,36380,36380,35300,-1080,-2.97,36190,-190,-0.52,35000,37360,1399-11-15
495,كمرجان,بازرگاني و توليدي مرجان كار,397,400977,54826387164,130221,136732,136732,6511,5.0,136165,5944,4.56,136732,136732,1399-11-15
496,تسه9909,امتياز تسهيلات مسكن آذر99,391,6603,3830050341,552426,580047,580047,27621,5.0,580047,27621,5.0,580047,580047,1399-11-15
497,طلا,صندوق س.پشتوانه طلاي لوتوس,386,304792,23326504081,77816,76200,76980,-836,-1.07,76533,-1283,-1.65,75025,77200,1399-11-15
498,شاوان,پالايش نفت لاوان,382,524828,42487305674,82182,78900,79070,-3112,-3.79,81045,-1137,-1.38,78550,83900,1399-11-15
499,ولانا,شركت ليزينگ آريا دانا,378,906029,30698074578,32896,33882,33882,986,3.0,33882,986,3.0,33882,33882,1399-11-15
500,آساس,صندوق س.آسمان آرماني سهام-س,377,188966,30502813636,162816,164998,159120,-3696,-2.27,161420,-1396,-0.86,159002,168890,1399-11-15
501,مبين,مبين انرژي خليج فارس,374,1961406,26358695130,13810,13880,13300,-510,-3.69,13720,-90,-0.65,13190,13880,1399-11-15
502,دتماد,توليدمواداوليه‌داروپخش‌,372,411120,20132337010,51040,51970,48520,-2520,-4.94,50170,-870,-1.7,48510,51970,1399-11-15
503,دكيمي,كيميدارو,371,1054216,27181767830,27070,26000,25720,-1350,-4.99,26390,-680,-2.51,25720,27040,1399-11-15
504,شجم,صنايع پتروشيمي تخت جمشيد,370,2393476,27239590047,11552,11400,11206,-346,-3.0,11394,-158,-1.37,11206,11898,1399-11-15
505,ثتوسا,س.توسعه و عمران استان اردبيل,369,816403,36391980128,43278,44576,44576,1298,3.0,44576,1298,3.0,44576,44576,1399-11-15
506,سرود,سيمان‌شاهرود,369,1729791,32137914010,19490,19000,18520,-970,-4.98,18900,-590,-3.03,18520,19160,1399-11-15
507,وسرمد,بيمه  سرمد,368,2671418,17170273610,6542,6660,6346,-196,-3.0,6435,-107,-1.64,6346,6660,1399-11-15
508,شلعاب,لعابيران‌,359,1197055,19583819800,15590,16360,16360,770,4.94,15850,260,1.67,16360,16360,1399-11-15
509,ضپاس2001,اختيارخ وپارس-2500-1400/02/29,357,17607,10640118000,680,700,615,-65,-9.56,604,-76,-11.18,597,769,1399-11-15
510,غدام,خوراك‌  دام‌ پارس‌,355,301742,123850003900,390910,410450,410450,19540,5.0,410450,19540,5.0,410450,410450,1399-11-15
511,دپارس,پارس‌ دارو,354,295340,25111355070,89310,85100,84850,-4460,-4.99,87140,-2170,-2.43,84850,88200,1399-11-15
512,زفكا,كشت و دامداري فكا,347,1920479,23254878176,12732,12096,12096,-636,-5.0,12429,-303,-2.38,12096,12400,1399-11-15
513,نيرو,نيرو سرمايه,339,562006,34946874587,62853,63800,61211,-1642,-2.61,62182,-671,-1.07,61000,63800,1399-11-15
514,ضسپا1103,اختيارخ خساپا-2500-1399/11/26,339,17890,429861000,44,65,16,-28,-63.64,24,-20,-45.45,11,65,1399-11-15
515,دسينا,داروسازي‌ سينا,338,949073,25654914460,27660,27290,26720,-940,-3.4,27330,-330,-1.19,26500,27700,1399-11-15
516,سپاس,صندوق س. پاداش سهامداري توسعه1,333,14013973,142432182919,10159,10171,10163,4,0.04,10164,5,0.05,10160,10171,1399-11-15
517,شيراز,پتروشيمي‌شيراز,329,1144178,62057054550,56150,56700,53350,-2800,-4.99,54950,-1200,-2.14,53350,56700,1399-11-15
518,حخزر,كشتيراني درياي خزر,325,740096,16880418555,23905,23250,23240,-665,-2.78,23506,-399,-1.67,22710,23900,1399-11-15
519,شبصير,توليدات پتروشيمي قائد بصير,317,162843,15025878461,94689,91585,92999,-1690,-1.78,93916,-773,-0.82,90000,96900,1399-11-15
520,غپونه,نوش پونه مشهد,316,916549,17758059088,19968,19369,19369,-599,-3.0,19391,-577,-2.89,19369,19760,1399-11-15
521,آكورد,صندوق س. آرمان آتي كوثر-د,307,4529801,138499700327,30560,30574,30580,20,0.07,30575,15,0.05,30573,30580,1399-11-15
522,دابور,داروسازي‌ ابوريحان‌,305,249064,9221838580,38470,36810,37550,-920,-2.39,38210,-260,-0.68,36550,38970,1399-11-15
523,فيروزا,صندوق بادرآمد ثابت فيروزه آسيا,300,5193066,115724397914,22244,22329,22280,36,0.16,22284,40,0.18,22244,22375,1399-11-15
524,درازك,دارويي‌ رازك‌,295,971220,35469525940,38230,36540,36970,-1260,-3.3,36980,-1250,-3.27,36320,38310,1399-11-15
525,كساپا,سايپاشيشه‌,291,482112,19129336010,41440,39560,39370,-2070,-5.0,40740,-700,-1.69,39370,40980,1399-11-15
526,ساينا,صنايع بهداشتي ساينا,290,68059,11266567719,168505,161620,164979,-3526,-2.09,167804,-701,-0.42,161620,170000,1399-11-15
527,زر,صندوق س.پشتوانه سكه طلاي زر,288,393228,18187954996,46841,46100,46500,-341,-0.73,46253,-588,-1.26,45100,46800,1399-11-15
528,شراز,پالايش نفت شيراز,287,83282,8039089342,98388,100380,97000,-1388,-1.41,98079,-309,-0.31,93500,100380,1399-11-15
529,دجابر,داروسازي‌ جابرابن‌حيان‌,284,365277,7676718760,21440,22060,20790,-650,-3.03,21380,-60,-0.28,20480,22060,1399-11-15
530,سدشت,صنايع سيمان دشتستان,284,324776,14942943760,43820,46010,46010,2190,5.0,44430,610,1.39,46010,46010,1399-11-15
531,ضخود2006,اختيارخ خودرو-2500-1400/02/08,278,10105,4276141000,467,500,400,-67,-14.35,423,-44,-9.42,395,501,1399-11-15
532,شصفها,پتروشيمي‌ اصفهان‌,271,319852,39005382316,123311,120845,120860,-2451,-1.99,121948,-1363,-1.11,120845,125274,1399-11-15
533,زفكاح,ح . كشت و دامداري فكا,268,1876492,14858577038,8298,7888,7884,-414,-4.99,7918,-380,-4.58,7884,8200,1399-11-15
534,فلات,گروه صنايع معادن فلات ايرانيان,266,1015725,14100538639,14232,14480,13806,-426,-2.99,13968,-264,-1.85,13806,14500,1399-11-15
535,كاذر,فرآورده‌هاي‌نسوزآذر,266,458719,16853336060,38670,36740,36740,-1930,-4.99,37980,-690,-1.78,36740,36740,1399-11-15
536,فنورد,نوردوقطعات‌ فولادي‌,259,125847,29779175610,225370,236630,236630,11260,5.0,231860,6490,2.88,236630,236630,1399-11-15
537,هجرتح,ح . پخش هجرت,242,247165,5361404463,22593,21561,21464,-1129,-5.0,21692,-901,-3.99,21464,22500,1399-11-15
538,عيار,صندوق س. پشتوانه طلاي مفيد,235,287143,7722036373,27213,26900,26994,-219,-0.8,26893,-320,-1.18,26600,27000,1399-11-15
539,حبندر,دريايي و کشتيراني خط دريابندر,233,523760,16730275280,32927,31940,31940,-987,-3.0,32027,-900,-2.73,31940,32500,1399-11-15
540,مارون,پتروشيمي مارون,229,174390,26225416279,152235,145130,149517,-2718,-1.79,151739,-496,-0.33,145130,153600,1399-11-15
541,تسه9712,امتياز تسهيلات مسكن اسفند97,222,3397,1973740159,555140,555000,582897,27757,5.0,581024,25884,4.66,532000,582897,1399-11-15
542,وتوصا,گروه س توسعه صنعتي ايران,222,1522432,20278794240,14020,13320,13320,-700,-4.99,13680,-340,-2.43,13320,13320,1399-11-15
543,كخاك,صنايع‌خاك‌چيني‌ايران‌,220,239310,10627284120,45940,45240,44050,-1890,-4.11,45590,-350,-0.76,44000,47160,1399-11-15
544,داروح,ح . كارخانجات‌داروپخش,219,420206,12223101420,30840,28300,28400,-2440,-7.91,29090,-1750,-5.67,28010,31310,1399-11-15
545,نتوس,پشم‌ بافي‌ توس,216,976764,22194031608,22061,22722,22722,661,3.0,22711,650,2.95,22722,22722,1399-11-15
546,گشان,توسعه بين المللي پديده شانديز,210,137941,6053402844,44779,43884,43884,-895,-2.0,44571,-208,-0.46,43884,43884,1399-11-15
547,داسوه,داروسازي‌ اسوه‌,209,794521,35149609040,46560,44240,44240,-2320,-4.98,44990,-1570,-3.37,44240,44240,1399-11-15
548,تسه9907,امتياز تسهيلات مسكن مهر99,208,4360,2605582115,569395,597864,597864,28469,5.0,597611,28216,4.96,565001,597864,1399-11-15
549,خفولا,خدمات فني فولاد يزد,205,212454,16813609560,81587,79140,79140,-2447,-3.0,79454,-2133,-2.61,79140,79140,1399-11-15
550,وارس,سرمايه گذاري ارس صبا,204,786821,14339056452,18780,18217,18217,-563,-3.0,18353,-427,-2.27,18217,18780,1399-11-15
551,بپاس,بيمه پاسارگاد,203,100759,8966442651,93672,88989,88989,-4683,-5.0,93201,-471,-0.5,88989,88989,1399-11-15
552,آتيمس,صندوق س.آرمان آتيه درخشان مس-س,203,55527,9745899872,178775,178020,173300,-5475,-3.06,175516,-3259,-1.82,172500,182800,1399-11-15
553,وزمين,بانك ايران زمين,202,4245648,59442147935,14284,14410,13999,-285,-2.0,14001,-283,-1.98,13999,14410,1399-11-15
554,شستان,پتروشيمي گلستان,195,2989866,12787656882,4194,4277,4277,83,1.98,4277,83,1.98,4277,4277,1399-11-15
555,پرداخت,به پرداخت ملت,193,581013,22642076610,41020,38970,38970,-2050,-5.0,40060,-960,-2.34,38970,38970,1399-11-15
556,دمعيار,صندوق س. توازن معيار-د,192,14563807,146665525006,10070,10076,10070,0,0.0,10071,1,0.01,10070,10085,1399-11-15
557,شتوكا,توكا رنگ فولاد سپاهان,186,195971,10937533452,58749,55812,55812,-2937,-5.0,58013,-736,-1.25,55812,55812,1399-11-15
558,دفرا,فرآورده‌هاي‌ تزريقي‌ ايران‌,179,259682,6979356870,27700,27700,26960,-740,-2.67,27580,-120,-0.43,26420,27990,1399-11-15
559,ثقزوي,شركت عمران و سازندگي قزوين,179,473900,15259580000,33894,32200,32200,-1694,-5.0,32425,-1469,-4.33,32200,32200,1399-11-15
560,شكربن,كربن‌ ايران‌,177,493014,47689244220,92130,96730,96730,4600,4.99,96730,4600,4.99,96730,96730,1399-11-15
561,افق ملت,صندوق س در سهام افق ملت,171,54992,6669333820,122380,122390,120310,-2070,-1.69,121280,-1100,-0.9,120300,128400,1399-11-15
562,غمهرا,توليدي‌مهرام‌,171,394755,41650600050,100490,105510,105510,5020,5.0,104020,3530,3.51,105510,105510,1399-11-15
563,شتولي,تولي‌پرس‌,168,366799,13557257839,36237,36961,36961,724,2.0,36961,724,2.0,36961,36961,1399-11-15
564,فردا,صندوق س آواي فرداي زاگرس-ثابت,164,117685,1190961092,10000,10120,10133,133,1.33,10120,120,1.2,10118,10133,1399-11-15
565,تصميم,صندوق س با درآمد ثابت تصميم,162,1841014,28653984477,15546,15561,15551,5,0.03,15564,18,0.12,15551,15576,1399-11-15
566,سكه0012پ01,سكه تمام بهارتحويلي 1روزه رفاه,162,40600,43768401500,1095252,1078000,1083000,-12252,-1.12,1078039,-17213,-1.57,1073334,1089998,1399-11-15
567,سباقر,سيمان باقران,159,672058,11101726102,15733,16519,16519,786,5.0,16158,425,2.7,16519,16519,1399-11-15
568,حتوكا,حمل‌ونقل‌توكا,157,202580,6437992400,33450,31780,31780,-1670,-4.99,33210,-240,-0.72,31780,31780,1399-11-15
569,تسه9711,امتياز تسهيلات مسكن بهمن 97,156,2050,1118020033,522157,510015,548264,26107,5.0,545376,23219,4.45,510015,548264,1399-11-15
570,سپر,صندوق س سپر سرمايه بيدار- ثابت,153,1442205,16421576242,11372,11372,11390,18,0.16,11386,14,0.12,11372,11390,1399-11-15
571,فجام,جام‌دارو,152,1151548,12310048120,11250,10690,10690,-560,-4.98,11090,-160,-1.42,10690,10690,1399-11-15
572,پلاست,كارخانجات توليدي پلاستيران,145,229439,17401571516,73635,75844,75844,2209,3.0,75323,1688,2.29,75844,75844,1399-11-15
573,كپشير,پشم‌شيشه‌ايران‌,144,336755,11018623600,31170,32720,32720,1550,4.97,31460,290,0.93,32720,32720,1399-11-15
574,اتكاي,بيمه اتكايي ايرانيان,142,713602,10226017374,14995,14246,14246,-749,-4.99,14847,-148,-0.99,14246,14990,1399-11-15
575,تسه9801,امتياز تسهيلات مسكن فروردين98,141,1365,805386863,562010,590000,590110,28100,5.0,590027,28017,4.99,560120,590110,1399-11-15
576,گوهر,صندوق سكه طلاي كيان,140,634961,33963085641,54019,53600,54000,-19,-0.04,53488,-531,-0.98,52528,54019,1399-11-15
577,پسهند,صنايع‌ لاستيكي‌  سهند,137,1035745,41150148850,37840,39730,39730,1890,4.99,39210,1370,3.62,39730,39730,1399-11-15
578,ارمغان,ص سرمايه گذاري ارمغان ايرانيان,132,3996551,40692732192,10176,10171,10181,5,0.05,10182,6,0.06,10171,10198,1399-11-15
579,شفارا,پتروشيمي فارابي,130,1623283,7398923914,4426,4558,4558,132,2.98,4477,51,1.15,4558,4558,1399-11-15
580,دارا,صندوق س. دارا الگوريتم-د,126,1917396,19265010465,10052,10064,10040,-12,-0.12,10047,-5,-0.05,10030,10064,1399-11-15
581,زعف0008پ11,زعفران0008نگين سحرخيز(پ),125,324486,40613764109,125064,125001,125102,38,0.03,125163,99,0.08,125001,125699,1399-11-15
582,كاسپين,داروسازي كاسپين تامين,125,211358,5089048327,25333,24850,24067,-1266,-5.0,25193,-140,-0.55,24067,24850,1399-11-15
583,تسه9902,امتياز تسهيلات مسكن ارديبهشت99,124,1754,1030549255,560080,580222,588084,28004,5.0,587542,27462,4.9,580222,588084,1399-11-15
584,سكه9912پ04,سكه تمام بهارتحويل1روزه صادرات,122,69600,74866612000,1094226,1070000,1078500,-15726,-1.44,1075670,-18556,-1.7,1066003,1079500,1399-11-15
585,شاملا,معدني‌ املاح‌  ايران‌,120,89317,4637519980,54620,52930,51890,-2730,-5.0,54340,-280,-0.51,51890,52930,1399-11-15
586,سفار,سيمان‌فارس‌,119,235468,30756830160,137490,130620,130620,-6870,-5.0,133100,-4390,-3.19,130620,130620,1399-11-15
587,تسه9810,امتياز تسهيلات مسكن دي98,115,1794,1037990252,551231,578792,578792,27561,5.0,578590,27359,4.96,550900,578792,1399-11-15
588,لكما,كارخانجات‌مخابراتي‌ايران‌,114,823803,5914081737,7401,7179,7179,-222,-3.0,7328,-73,-0.99,7179,7179,1399-11-15
589,تسه9906,امتياز تسهيلات مسكن شهريور99,114,1022,598949220,558201,558000,586111,27910,5.0,586056,27855,4.99,558000,586111,1399-11-15
590,سفاسي,شركت فارسيت اهواز,110,233554,3336552444,15037,14286,14286,-751,-4.99,14901,-136,-0.9,14286,14286,1399-11-15
591,تسه9802,امتياز تسهيلات مسكن ارديبهشت98,107,1182,705196712,568723,575000,597159,28436,5.0,596613,27890,4.9,575000,597159,1399-11-15
592,زعف0008پ10,زعفران0008نگين طلاي سرخ(پ),105,180544,22717399580,125695,125700,125750,55,0.04,125827,132,0.11,125700,127154,1399-11-15
593,كهرام,توليدي گرانيت بهسرام,105,70864,6389310832,87537,90163,90163,2626,3.0,88328,791,0.9,90163,90163,1399-11-15
594,ثاژن,سخت آژند,104,1675928,16586659416,9703,9897,9897,194,2.0,9897,194,2.0,9897,9897,1399-11-15
595,تسه9904,امتياز تسهيلات مسكن تير99,102,1534,905788815,566411,571172,594731,28320,5.0,590475,24064,4.25,571172,594731,1399-11-15
596,گكيش,توريستي ورفاهي آبادگران كيش,99,260081,24485845907,91405,94147,94147,2742,3.0,94147,2742,3.0,94147,94147,1399-11-15
597,بفجر,فجر انرژي خليج فارس,97,1269856,30235271360,25060,23810,23810,-1250,-4.99,24450,-610,-2.43,23810,23810,1399-11-15
598,گدنا,تهيه توزيع غذاي دنا آفرين فدك,94,56515,1685277300,31389,29820,29820,-1569,-5.0,31329,-60,-0.19,29820,29820,1399-11-15
599,فنفت,صنايع تجهيزات نفت,91,685689,20441760468,28944,29812,29812,868,3.0,29697,753,2.6,29812,29812,1399-11-15
600,صايند,صندوق س. گنجينه آينده روشن-د,89,461950,4591639110,9946,9921,9946,0,0.0,9940,-6,-0.06,9921,9950,1399-11-15
601,وآفري,بيمه كارآفرين,87,1215580,26035292440,20795,21418,21418,623,3.0,21418,623,3.0,21418,21418,1399-11-15
602,تسه9803,امتياز تسهيلات مسكن خرداد98,86,494,291894268,565250,575000,593512,28262,5.0,590879,25629,4.53,575000,593512,1399-11-15
603,كفرا,فراورده‌ هاي‌ نسوزايران‌,84,77050,3505428640,47880,45510,45490,-2390,-4.99,47690,-190,-0.4,45490,45530,1399-11-15
604,تسه9903,امتياز تسهيلات مسكن خرداد99,81,607,356410680,559701,571111,587686,27985,5.0,587167,27466,4.91,571111,587686,1399-11-15
605,افران,صندوق س افرا نماد پايدار-ثابت,80,2708566,34124544996,12589,12605,12598,9,0.07,12599,10,0.08,12590,12606,1399-11-15
606,تسه9905,امتياز تسهيلات مسكن مرداد99,80,552,319808928,551776,579364,579364,27588,5.0,579364,27588,5.0,579364,579364,1399-11-15
607,فنرژي,گسترش صنايع انرژي آذرآب,79,534427,10138080190,18241,18970,18970,729,4.0,18911,670,3.67,18970,18970,1399-11-15
608,اخزا903,اسنادخزانه-م3بودجه99-011110,79,163477,114460765735,695048,693016,697000,1952,0.28,700164,5116,0.74,693016,707999,1399-11-15
609,اخزا821,اسنادخزانه-م21بودجه98-020906,79,25527,15300889067,601634,601890,599800,-1834,-0.3,599400,-2234,-0.37,596008,601890,1399-11-15
610,خاتم,صندوق س خاتم ايساتيس پويا-ثابت,79,1919878,20138685762,10486,10488,10491,5,0.05,10490,4,0.04,10488,10515,1399-11-15
611,ثزاگرس,سرمايه گذاري توسعه عمران زاگرس,78,293079,17476300770,56791,59630,59630,2839,5.0,59008,2217,3.9,59630,59630,1399-11-15
612,اوصتا,صندوق انديشه ورزان صباتامين -د,78,1036508,18473862115,17823,17830,17830,7,0.04,17823,0,0.0,17818,17830,1399-11-15
613,حسير,ريل سير كوثر,75,786824,14061331704,18811,17871,17871,-940,-5.0,18553,-258,-1.37,17871,17871,1399-11-15
614,كسرام,پارس‌ سرام‌,71,359752,3683860480,10770,10240,10240,-530,-4.92,10730,-40,-0.37,10240,10240,1399-11-15
615,ضپاس2002,اختيارخ وپارس-3000-1400/02/29,69,2450,1140330000,497,535,421,-76,-15.29,465,-32,-6.44,420,540,1399-11-15
616,تسه9901,امتياز تسهيلات مسكن فروردين99,65,683,397773053,554659,582391,582391,27732,5.0,582391,27732,5.0,582391,582391,1399-11-15
617,زنجان,صنايع كشاورزي وكود زنجان,63,177780,1669709760,9886,9392,9392,-494,-5.0,9841,-45,-0.46,9392,9392,1399-11-15
618,سمايه,بانك سرمايه,58,230414,1607137650,7342,6975,6975,-367,-5.0,7311,-31,-0.42,6975,6975,1399-11-15
619,شرنگي,شيميايي رنگين,57,33889,5819012412,166707,171708,171708,5001,3.0,168048,1341,0.8,171708,171708,1399-11-15
620,نمرينو,ايران‌ مرينوس‌,57,122157,7000817670,54590,57310,57310,2720,4.98,54940,350,0.64,57310,57310,1399-11-15
621,اخزا902,اسنادخزانه-م2بودجه99-011019,57,143131,101285231481,702781,702700,705183,2402,0.34,707640,4859,0.69,702200,720000,1399-11-15
622,زعف0008پ05,زعفران0008نگين زرين(پ),56,59549,7379768467,124007,124500,123800,-207,-0.17,123928,-79,-0.06,123483,125488,1399-11-15
623,الماس,صندوق س.امين تدبيرگران فردا-س,55,14283,1584057690,111113,111000,109990,-1123,-1.01,110905,-208,-0.19,108000,113500,1399-11-15
624,فسديد,لوله‌وتجهيزات‌ سديد - ورشكسته,54,113646,13432843554,117029,118199,118199,1170,1.0,118199,1170,1.0,118199,118199,1399-11-15
625,تسه9812,امتياز تسهيلات مسكن اسفند98,53,552,320550699,556081,571000,583885,27804,5.0,580708,24627,4.43,570000,583885,1399-11-15
626,گپارس,امور رفاهي كارگزاران پارس,53,28551,5851042083,198965,204933,204933,5968,3.0,200573,1608,0.81,204933,204933,1399-11-15
627,وسمازن,س.سهام عدالت استان مازندران,51,1356317,1261374810,970,930,930,-40,-4.12,970,0,0.0,930,930,1399-11-15
628,اخزا815,اسنادخزانه-م15بودجه98-010406,50,15788,12317287353,780953,780001,781000,47,0.01,780168,-785,-0.1,779910,781800,1399-11-15
629,سخواف,سيمان مجد خواف,49,108064,2105951232,20090,19488,19488,-602,-3.0,20021,-69,-0.34,19488,19488,1399-11-15
630,ضشنا2001,اختيارخ شپنا-10000-1400/02/27,48,1061,2245045000,2452,2306,1901,-551,-22.47,2116,-336,-13.7,1900,3390,1399-11-15
631,اخزا906,اسنادخزانه-م6بودجه99-020321,48,119418,84401175510,709370,680000,674001,-35369,-4.99,706771,-2599,-0.37,674001,715000,1399-11-15
632,سكه0011پ02,سكه تمام بهارتحويلي 1روزه ملت,47,14000,15084968000,1092265,1070000,1075001,-17264,-1.58,1077498,-14767,-1.35,1070000,1079998,1399-11-15
633,زعف0008پ08,زعفران0008نگين روستا(پ),46,43249,5345873320,124227,123500,124098,-129,-0.1,123607,-620,-0.5,123000,124200,1399-11-15
634,سكارون,سيمان كارون,46,19344,3500567616,186560,180964,180964,-5596,-3.0,185422,-1138,-0.61,180964,180964,1399-11-15
635,تسه9811,امتياز تسهيلات مسكن بهمن98,46,327,187675764,546602,573932,573932,27330,5.0,573932,27330,5.0,573932,573932,1399-11-15
636,هبركت912,اختيارف ت بركت-22100-99/12/17,45,320000,37440000,1122,117,117,-1005,-89.57,117,-1005,-89.57,117,117,1399-11-15
637,اخزا818,اسنادخزانه-م18بودجه98-010614,44,120540,91341332842,757877,755113,763313,5436,0.72,757768,-109,-0.01,754113,763313,1399-11-15
638,ضسپا1101,اختيارخ خساپا-1800-1399/11/26,44,1612,593311000,391,498,331,-60,-15.35,368,-23,-5.88,331,498,1399-11-15
639,اخزا820,اسنادخزانه-م20بودجه98-020806,43,114942,69681721830,605255,606996,612995,7740,1.28,606234,979,0.16,603584,612995,1399-11-15
640,دقاضي,داروسازي شهيد قاضي,42,70283,3317478300,46871,45465,48270,1399,2.98,46928,57,0.12,45465,48270,1399-11-15
641,ضسپا1100,اختيارخ خساپا-1600-1399/11/26,40,1264,694101000,551,625,530,-21,-3.81,549,-2,-0.36,505,625,1399-11-15
642,ضغدر1119,اختيارخ وغدير-10000-1399/11/26,40,206,185371000,1353,1600,770,-583,-43.09,900,-453,-33.48,770,1600,1399-11-15
643,اخزا909,اسنادخزانه-م9بودجه99-020316,39,72966,47433679722,649878,650200,650300,422,0.06,650079,201,0.03,650000,651400,1399-11-15
644,اخزا905,اسنادخزانه-م5بودجه99-020218,39,65930,43425901740,657284,662450,657009,-275,-0.04,658667,1383,0.21,657009,662450,1399-11-15
645,سخند,صندوق س.سپهرخبرگان نفت-د,39,978690,9930231810,10107,10148,10128,21,0.21,10146,39,0.39,10127,10148,1399-11-15
646,زعف0008پ20,زعفران0008نگين وحدت جام(پ),39,36579,4500699329,124500,122760,123401,-1099,-0.88,123041,-1459,-1.17,122201,124000,1399-11-15
647,بنيرو,نيروترانس‌,38,90876,1528534320,17700,16820,16820,-880,-4.97,17670,-30,-0.17,16820,16820,1399-11-15
648,ضجار2002,اختيارخ وتجارت-2500-1400/02/22,38,951,529468000,631,552,565,-66,-10.46,557,-74,-11.73,512,700,1399-11-15
649,جهرم,پتروشيمي جهرم,37,347784,697306920,2067,2005,2005,-62,-3.0,2065,-2,-0.1,2005,2005,1399-11-15
650,اخزا817,اسنادخزانه-م17بودجه98-010512,37,81998,63112637569,767956,767020,769000,1044,0.14,769685,1729,0.23,767011,770000,1399-11-15
651,صنوين,صندوق سرمايه‌گذاري صنوين-مختلط,37,18747,1864905450,100130,99850,99000,-1130,-1.13,99480,-650,-0.65,99000,100000,1399-11-15
652,قلرست,قند لرستان‌,36,123400,3938928000,33590,31920,31920,-1670,-4.97,33450,-140,-0.42,31920,31920,1399-11-15
653,كيان2,صندوق س. با درآمد ثابت كيان,35,3500000,3500000,27018,1,1,-27017,-100.0,1,-27017,-100.0,1,1,1399-11-15
654,اخزا901,اسنادخزانه-م1بودجه99-010621,35,11529,8601799349,746298,745020,746140,-158,-0.02,746101,-197,-0.03,745020,749497,1399-11-15
655,بذر,صندوق س بذر اميد آفرين-سهام,32,11519,1113194330,98360,100350,95490,-2870,-2.92,96640,-1720,-1.75,94800,100350,1399-11-15
656,گنجين,صندوق س. گنجينه يكم آويد-د,32,175018,2126321685,12146,12148,12154,8,0.07,12149,3,0.02,12148,12155,1399-11-15
657,ثروتم,صندوق س. ثروت آفرين پارسيان-س,31,46170,3661661850,80257,80350,77640,-2617,-3.26,79308,-949,-1.18,77500,80390,1399-11-15
658,آسام,صندوق س.آرمان سپهر آشنا-م,31,19770,2026540020,101076,103000,103000,1924,1.9,102506,1430,1.41,100000,103999,1399-11-15
659,فسا,پتروشيمي فسا,31,506047,929608339,1893,1837,1837,-56,-2.96,1890,-3,-0.16,1837,1837,1399-11-15
660,كارين,صندوق س نگين سامان-ثابت,29,923112,9306943960,10076,10080,10090,14,0.14,10082,6,0.06,10080,10100,1399-11-15
661,ضسپا1104,اختيارخ خساپا-3000-1399/11/26,29,1924,2164000,2,2,2,0,0.0,1,-1,-50.0,1,2,1399-11-15
662,تسه9809,امتياز تسهيلات مسكن آذر98,29,180,103011660,545036,572287,572287,27251,5.0,572287,27251,5.0,572287,572287,1399-11-15
663,ثنظام,س. ساختماني نظام مهندسي ايران,28,80825,3839268325,48970,47501,47501,-1469,-3.0,48669,-301,-0.61,47501,47501,1399-11-15
664,تشتاد,صنايع توليدي اشتاد ايران‌,28,151365,2427289140,16531,16036,16036,-495,-2.99,16467,-64,-0.39,16036,16036,1399-11-15
665,تسه9806,امتياز تسهيلات مسكن شهريور98,28,270,153476100,541362,568430,568430,27068,5.0,568430,27068,5.0,568430,568430,1399-11-15
666,ضملت1125,اختيارخ وبملت-4000-1399/11/28,27,1139,157910000,173,150,100,-73,-42.2,139,-34,-19.65,100,150,1399-11-15
667,تسه9808,امتياز تسهيلات مسكن آبان98,25,126,71635410,541462,568535,568535,27073,5.0,568535,27073,5.0,568535,568535,1399-11-15
668,اخزا808,اسنادخزانه-م8بودجه98-000817,25,57500,50361433078,874369,870035,876000,1631,0.19,875851,1482,0.17,870035,876000,1399-11-15
669,اخزا814,اسنادخزانه-م14بودجه98-010318,24,74908,59165688691,787655,788400,788000,345,0.04,789845,2190,0.28,786500,790000,1399-11-15
670,تسه9807,امتياز تسهيلات مسكن مهر98,24,219,130869036,569240,570000,597702,28462,5.0,597575,28335,4.98,570000,597702,1399-11-15
671,ضشنا2000,اختيارخ شپنا-9000-1400/02/27,24,325,851495000,3300,3100,2460,-840,-25.45,2620,-680,-20.61,2460,3100,1399-11-15
672,ساروج,بين المللي ساروج بوشهر,23,255816,5588300520,22520,21845,21845,-675,-3.0,22311,-209,-0.93,21845,21845,1399-11-15
673,حرهشا,رهشاد سپاهان (سهامي عام,23,10629,683370297,65605,64293,64293,-1312,-2.0,65514,-91,-0.14,64293,64293,1399-11-15
674,ضخود2013,اختيارخ خودرو-7000-1400/02/08,23,781,11729000,15,16,15,0,0.0,15,0,0.0,11,23,1399-11-15
675,ضجار2003,اختيارخ وتجارت-3000-1400/02/22,23,644,267059000,515,510,473,-42,-8.16,415,-100,-19.42,303,510,1399-11-15
676,كقزوي,شيشه‌ قزوين‌,22,121749,1240987557,10508,10193,10193,-315,-3.0,10487,-21,-0.2,10193,10193,1399-11-15
677,اخزا908,اسنادخزانه-م8بودجه99-020606,22,10649,6645287657,622854,623201,626900,4046,0.65,624029,1175,0.19,623201,626900,1399-11-15
678,ضخود2009,اختيارخ خودرو-4000-1400/02/08,22,780,78548000,108,92,97,-11,-10.19,101,-7,-6.48,90,110,1399-11-15
679,ضفلا1155,اختيارخ فولاد-14000-1399/11/28,22,692,8176000,58,30,12,-46,-79.31,12,-46,-79.31,10,30,1399-11-15
680,اخزا809,اسنادخزانه-م9بودجه98-000923,21,11958,10291003110,861252,860012,860606,-646,-0.08,860596,-656,-0.08,860012,861500,1399-11-15
681,اخزا811,اسنادخزانه-م11بودجه98-001013,21,110140,93769327781,851617,852500,851500,-117,-0.01,851365,-252,-0.03,851128,854000,1399-11-15
682,هفارس912,اختيارف ت فارس-14576-99/12/13,21,375276,1953686856,4768,5206,5206,438,9.19,5206,438,9.19,5206,5206,1399-11-15
683,اخزا806,اسنادخزانه-م6بودجه98-000519,20,60523,55274481998,911396,912501,913999,2603,0.29,913281,1885,0.21,912500,914999,1399-11-15
684,تسه9805,امتياز تسهيلات مسكن مرداد98,20,84,50080265,568743,597180,597180,28437,5.0,596194,27451,4.83,580601,597180,1399-11-15
685,اراد50,مرابحه عام دولت5-ش.خ0302,20,500000,500000000000,1000001,1000000,1000000,-1,0.0,1000000,-1,0.0,1000000,1000000,1399-11-15
686,قپيرا,فرآورده‌هاي‌غدايي‌وقندپيرانشهر,19,8303,852219920,108040,102640,102640,-5400,-5.0,107940,-100,-0.09,102640,102640,1399-11-15
687,عيار2,صندوق س. پشتوانه طلاي مفيد,17,170000,170000,27213,1,1,-27212,-100.0,1,-27212,-100.0,1,1,1399-11-15
688,زعف0008پ19,زعفران0008نگين تروند قاينات(پ),17,10180,1263078100,123922,124000,124180,258,0.21,124074,152,0.12,124000,124180,1399-11-15
689,زعف0008پ16,زعفران0008نگين بيرجند(پ),17,7110,880884862,124094,123830,124150,56,0.05,123894,-200,-0.16,123550,124150,1399-11-15
690,سجامح,ح.مجتمع سيمان غرب آسيا,16,150151,525528500,400,3500,3500,3100,775.0,3500,3100,775.0,3500,3500,1399-11-15
691,تاپكيشح,ح.تجارت الكترونيك پارسيان كيش,16,191072,3806436736,20772,21610,19734,-1038,-5.0,19921,-851,-4.1,19734,21610,1399-11-15
692,سكه0112پ03,سكه تمام بهارتحويلي1روزه سامان,16,3600,3869509500,1091547,1070000,1079495,-12052,-1.1,1074864,-16683,-1.53,1070000,1079495,1399-11-15
693,داراب,پتروشيمي داراب,15,78399,189098388,2486,2412,2412,-74,-2.98,2485,-1,-0.04,2412,2412,1399-11-15
694,ضپاس2003,اختيارخ وپارس-3500-1400/02/29,15,568,122449000,300,256,199,-101,-33.67,216,-84,-28.0,183,256,1399-11-15
695,وسصفا,شركت س استان اصفهان,15,114186,116469720,1070,1020,1020,-50,-4.67,1070,0,0.0,1020,1020,1399-11-15
696,ضفلا1154,اختيارخ فولاد-12000-1399/11/28,14,489,54320000,219,200,100,-119,-54.34,111,-108,-49.32,100,200,1399-11-15
697,اخزا807,اسنادخزانه-م7بودجه98-000719,14,85688,75748937656,886766,884000,885604,-1162,-0.13,884009,-2757,-0.31,884000,886000,1399-11-15
698,زعف0008پ18,زعفران0008نگين بهرامن(پ),14,55933,6999922940,124949,125180,124000,-949,-0.76,125148,199,0.16,124000,125180,1399-11-15
699,تسه9804,امتياز تسهيلات مسكن تير98,14,50,28567100,544136,571342,571342,27206,5.0,571342,27206,5.0,571342,571342,1399-11-15
700,ضصاد3002,اختيارخ وبصادر-2500-1400/03/12,13,347,143668000,531,414,410,-121,-22.79,414,-117,-22.03,408,439,1399-11-15
701,ضملت1127,اختيارخ وبملت-5000-1399/11/28,13,517,574000,5,2,1,-4,-80.0,1,-4,-80.0,1,2,1399-11-15
702,ضجار2001,اختيارخ وتجارت-2000-1400/02/22,13,229,222990000,1254,1000,970,-284,-22.65,974,-280,-22.33,890,1000,1399-11-15
703,اخزا722,اسنادخزانه-م22بودجه97-000428,12,117759,108789621681,922000,924000,923900,1900,0.21,923833,1833,0.2,923011,924000,1399-11-15
704,اخزا813,اسنادخزانه-م13بودجه98-010219,12,7607,6076282402,799613,798501,799000,-613,-0.08,798775,-838,-0.1,798500,799613,1399-11-15
705,اخزا816,اسنادخزانه-م16بودجه98-010503,12,52813,40614001753,769268,769000,770000,732,0.1,769015,-253,-0.03,769000,770000,1399-11-15
706,اخزا721,اسنادخزانه-م21بودجه97-000728,11,77264,68164301871,885017,885000,885000,-17,0.0,882226,-2791,-0.32,878033,887000,1399-11-15
707,اخزا907,اسنادخزانه-م7بودجه99-020704,10,17875,11004511475,615950,617500,615500,-450,-0.07,615637,-313,-0.05,615000,617500,1399-11-15
708,ضسپا3003,اختيارخ خساپا-2000-1400/03/26,10,534,283038000,450,550,519,69,15.33,530,80,17.78,511,620,1399-11-15
709,ضخود2008,اختيارخ خودرو-3500-1400/02/08,10,319,49135000,165,180,155,-10,-6.06,154,-11,-6.67,140,180,1399-11-15
710,آكورد2,صندوق س. آرمان آتي كوثر-د,10,1000000,1000000,30560,1,1,-30559,-100.0,1,-30559,-100.0,1,1,1399-11-15
711,ضملي3001,اختيارخ فملي-9000-1400/03/02,10,103,258700000,2800,2550,2550,-250,-8.93,2512,-288,-10.29,2300,2800,1399-11-15
712,ضملت1126,اختيارخ وبملت-4500-1399/11/28,10,348,10425000,68,197,29,-39,-57.35,30,-38,-55.88,26,197,1399-11-15
713,گوهر2,صندوق سكه طلاي كيان,10,100000,100000,54019,1,1,-54018,-100.0,1,-54018,-100.0,1,1,1399-11-15
714,ضپار1115,اختيارخ خپارس-5000-1399/11/19,9,62,54412000,948,200,1399,451,47.57,878,-70,-7.38,101,1399,1399-11-15
715,اخزا720,اسنادخزانه-م20بودجه97-000324,9,79066,74140055081,938001,938500,937803,-198,-0.02,937698,-303,-0.03,937001,938500,1399-11-15
716,زير0003پ01,زيره سبز0003كيميابذر(پ),9,83,42594988,500549,519998,515000,14451,2.89,513193,12644,2.53,500001,524999,1399-11-15
717,نگين,ص.س. زمين و ساختمان نگين شهرري,9,3110,147840550,48170,47540,47530,-640,-1.33,47540,-630,-1.31,47530,47550,1399-11-15
718,اخزا718,اسنادخزانه-م18بودجه97-000525,9,69388,63259858935,911083,911100,912000,917,0.1,911683,600,0.07,907009,912000,1399-11-15
719,ضغدر1120,اختيارخ وغدير-12000-1399/11/26,8,135,40060000,444,300,280,-164,-36.94,297,-147,-33.11,280,300,1399-11-15
720,تملي701,تسهيلات مسكن ب. ملي-فروردين97,8,91,54302395,599702,629687,629687,29985,5.0,596730,-2972,-0.5,569717,629687,1399-11-15
721,ضشنا2003,اختيارخ شپنا-14000-1400/02/27,8,62,43148000,1022,860,501,-521,-50.98,696,-326,-31.9,501,860,1399-11-15
722,ضملت1123,اختيارخ وبملت-3000-1399/11/28,8,69,60085000,1100,1000,801,-299,-27.18,871,-229,-20.82,801,1000,1399-11-15
723,ضجار2000,اختيارخ وتجارت-1800-1400/02/22,8,323,379075000,1294,1375,1150,-144,-11.13,1174,-120,-9.27,812,1600,1399-11-15
724,اخزا812,اسنادخزانه-م12بودجه98-001111,8,17940,15082438408,838630,838853,840005,1375,0.16,840716,2086,0.25,838853,841000,1399-11-15
725,اخزا819,اسنادخزانه-م19بودجه98-020322,8,15259,11302530000,731601,720000,742575,10974,1.5,740712,9111,1.25,720000,742575,1399-11-15
726,كشم0001پ01,كشمش سبز0001خليل آباد(پ),8,227,172757063,738559,738559,760000,21441,2.9,761044,22485,3.04,738559,775486,1399-11-15
727,ضخود2010,اختيارخ خودرو-4500-1400/02/08,8,302,24663000,85,82,80,-5,-5.88,82,-3,-3.53,80,83,1399-11-15
728,ضجار2005,اختيارخ وتجارت-4000-1400/02/22,8,346,15612000,200,100,40,-160,-80.0,45,-155,-77.5,40,100,1399-11-15
729,زعف0008پ12,زعفران0008پوشالمعمول سحرخيز(پ),8,850,69529000,83433,82100,79000,-4433,-5.31,81799,-1634,-1.96,79000,82100,1399-11-15
730,وسيستا,شركت س استان سيستان وبلوچستان,8,72097,53351780,770,740,740,-30,-3.9,770,0,0.0,740,740,1399-11-15
731,ضفلا1153,اختيارخ فولاد-10000-1399/11/28,8,40,40204000,1429,1380,1000,-429,-30.02,1005,-424,-29.67,830,1380,1399-11-15
732,اخزا804,اسنادخزانه-م4بودجه98-000421,7,20415,18884641644,923344,925101,926010,2666,0.29,925038,1694,0.18,925000,926010,1399-11-15
733,دحاوي,الحاوي,7,28516,334863388,12361,11743,11743,-618,-5.0,12350,-11,-0.09,11743,11743,1399-11-15
734,كرونا2,تامين مالي جمعي صرفا اهداي سود,7,748,7480000,10000,10000,10000,0,0.0,10000,0,0.0,10000,10000,1399-11-15
735,ضفار3000,اختيارخ فارس-8000-1400/03/05,7,233,439700000,2291,2000,1800,-491,-21.43,1887,-404,-17.63,1800,2000,1399-11-15
736,ضچاد2003,اختيارخ كچاد-18000-1400/02/05,6,45,165260000,3900,2051,3850,-50,-1.28,3672,-228,-5.85,2051,4900,1399-11-15
737,ضملت3001,اختيارخ وبملت-3500-1400/03/19,6,237,187110000,1,860,740,739,73900.0,789,788,78800.0,701,860,1399-11-15
738,ضشنا2002,اختيارخ شپنا-12000-1400/02/27,6,300,330011000,1593,1111,1100,-493,-30.95,1100,-493,-30.95,1100,1111,1399-11-15
739,ضچاد2002,اختيارخ كچاد-16000-1400/02/05,6,152,684714000,6200,4503,4502,-1698,-27.39,4505,-1695,-27.34,4502,4511,1399-11-15
740,اخزا805,اسنادخزانه-م5بودجه98-000422,6,4264,3947254426,921110,926500,925024,3914,0.42,925716,4606,0.5,925024,926500,1399-11-15
741,هاباد912,اختيارف ت آبادا-30100-99/12/12,6,19033,262503136,12300,13792,13792,1492,12.13,13792,1492,12.13,13792,13792,1399-11-15
742,رطب0002پ01,رطب مضافتي0002افشارتعاون بم(پ),6,151,30314660,209115,210000,198660,-10455,-5.0,200759,-8356,-4.0,198660,210000,1399-11-15
743,ياقوت2,صندوق س ياقوت آگاه-ثابت,6,27319170,27319170,11817,1,1,-11816,-99.99,1,-11816,-99.99,1,1,1399-11-15
744,ضصاد3000,اختيارخ وبصادر-1800-1400/03/12,6,21,18477000,1000,900,900,-100,-10.0,880,-120,-12.0,777,900,1399-11-15
745,خعمرا,توسعه و عمران شهرستان نائين,6,9499,214154955,21889,22545,22545,656,3.0,21896,7,0.03,22545,22545,1399-11-15
746,زعف0008پ09,زعفران0008نگين نوين(پ),5,2700,334649500,123695,123811,124000,305,0.25,123944,249,0.2,123630,124000,1399-11-15
747,دارا2,صندوق س. دارا الگوريتم-د,5,500000,500000,10052,1,1,-10051,-99.99,1,-10051,-99.99,1,1,1399-11-15
748,ضفلا3003,اختيارخ فولاد-10000-1400/03/19,5,221,446000000,1,2000,2000,1999,199900.0,2018,2017,201700.0,2000,2200,1399-11-15
749,ضجار2004,اختيارخ وتجارت-3500-1400/02/22,5,103,22603000,300,201,220,-80,-26.67,219,-81,-27.0,201,220,1399-11-15
750,ضملي3002,اختيارخ فملي-10000-1400/03/02,5,49,103900000,2022,2200,2100,78,3.86,2120,98,4.85,2100,2200,1399-11-15
751,ضفلا1156,اختيارخ فولاد-16000-1399/11/28,4,305,305000,4,1,1,-3,-75.0,1,-3,-75.0,1,1,1399-11-15
752,ضچاد2004,اختيارخ كچاد-20000-1400/02/05,4,34,68705000,3880,2250,1950,-1930,-49.74,2021,-1859,-47.91,1950,2250,1399-11-15
753,سپر2,صندوق س سپر سرمايه بيدار- ثابت,4,4000000,4000000,11372,1,1,-11371,-99.99,1,-11371,-99.99,1,1,1399-11-15
754,ضخوز2013,اختيارخ فخوز-12000-1400/02/15,4,130,291000000,3300,2400,2200,-1100,-33.33,2238,-1062,-32.18,2200,2500,1399-11-15
755,ضملت1124,اختيارخ وبملت-3500-1399/11/28,4,63,16540000,600,270,255,-345,-57.5,263,-337,-56.17,255,270,1399-11-15
756,اراد314,مرابحه عام دولت3-ش.خ 0208,4,26000000,23279272000000,1000000,893785,896889,-103111,-10.31,895357,-104643,-10.46,893785,896889,1399-11-15
757,تملي705,تسهيلات مسكن ب. ملي-مرداد97,4,107,65022723,578752,607689,607689,28937,5.0,607689,28937,5.0,607689,607689,1399-11-15
758,شستا991,اجاره تامين اجتماعي-امين991226,4,97,96620000,999999,1000000,1000000,1,0.0,996082,-3917,-0.39,980000,1000000,1399-11-15
759,وسلرستا,شركت س استان لرستان,4,31524,27110640,900,860,860,-40,-4.44,900,0,0.0,860,860,1399-11-15
760,ضغدر1121,اختيارخ وغدير-14000-1399/11/26,4,105,9015000,89,78,89,0,0.0,86,-3,-3.37,78,89,1399-11-15
761,ضپاس2000,اختيارخ وپارس-2000-1400/02/29,4,19,18977000,1148,967,1120,-28,-2.44,999,-149,-12.98,960,1120,1399-11-15
762,ضملي3003,اختيارخ فملي-12000-1400/03/02,4,70,82100000,1285,1500,1100,-185,-14.4,1173,-112,-8.72,1100,1500,1399-11-15
763,ضپار1116,اختيارخ خپارس-6000-1399/11/19,3,101,26913000,144,1300,3,-141,-97.92,266,122,84.72,3,1300,1399-11-15
764,خبازرس,بازرسي مهندسي و صنعتي ايران,3,10700,269030100,24411,25143,25143,732,3.0,24420,9,0.04,25143,25143,1399-11-15
765,اراد554,مرابحه عام دولت5-ش.خ 0209,3,21569200,19397431984200,950000,904042,897730,-52270,-5.5,899312,-50688,-5.34,897730,904042,1399-11-15
766,پا ر 24,بار پايه روز 24,3,22000,8250000,350,375,375,25,7.14,375,25,7.14,375,375,1399-11-15
767,پا ر 23,بار پايه روز 23,3,22000,8250000,275,375,375,100,36.36,375,100,36.36,375,375,1399-11-15
768,شستا992,اجاره تامين اجتماعي-سپهر991226,3,125,124809915,999999,991000,999999,0,0.0,998479,-1520,-0.15,990002,999999,1399-11-15
769,زعف0008پ15,زعفران0008پوشالمعمول طلاسرخ(پ),3,259,20939900,82367,81100,79000,-3367,-4.09,80849,-1518,-1.84,79000,81300,1399-11-15
770,صايپا112,صكوك مرابحه سايپا112-3ماهه 16%,3,25000,24584275000,983371,983371,983371,0,0.0,983371,0,0.0,983371,983371,1399-11-15
771,ضپيك2010,اختيارخ تاپيكو-12000-00/02/19,3,28,54800000,2100,2100,1900,-200,-9.52,1957,-143,-6.81,1900,2100,1399-11-15
772,اخزا810,اسنادخزانه-م10بودجه98-001006,3,1112,947980000,852135,852500,852500,365,0.04,852500,365,0.04,852500,852500,1399-11-15
773,وساشرقي,شركت س استان آذربايجان شرقي,3,12500,11875000,990,950,950,-40,-4.04,990,0,0.0,950,950,1399-11-15
774,ضصاد3004,اختيارخ وبصادر-3500-1400/03/12,3,13,1611000,168,102,200,32,19.05,124,-44,-26.19,101,200,1399-11-15
775,پست0008پ09,پسته بادامي30-28مه ولات0008(پ),3,33,41310915,1289952,1225455,1290000,48,0.0,1251846,-38106,-2.95,1225455,1290000,1399-11-15
776,پا ر 22,بار پايه روز 22,3,42000,15750000,380,375,375,-5,-1.32,375,-5,-1.32,375,375,1399-11-15
777,ضمخا7071,اختيارخ اخابر-24000-1400/07/28,2,10,1577000,999,500,11,-988,-98.9,158,-841,-84.18,11,500,1399-11-15
778,تملي709,تسهيلات مسكن ب. ملي-آذر97,2,8,5546480,729799,693310,693310,-36489,-5.0,693310,-36489,-5.0,693310,693310,1399-11-15
779,صخود412,ص مرابحه خودرو412- 3ماهه 18%,2,100,99432000,985000,988800,998000,13000,1.32,994320,9320,0.95,988800,998000,1399-11-15
780,اخزا8144,اسنادخزانه-م14بودجه98-010318,2,710000,559082045000,787655,787224,787655,0,0.0,787439,-216,-0.03,787224,787655,1399-11-15
781,ضملت3000,اختيارخ وبملت-3000-1400/03/19,2,24,28800000,1,1200,1200,1199,119900.0,1200,1199,119900.0,1200,1200,1399-11-15
782,افاد14,منفعت دولت-با شرايط خاص140006,2,20000000,20317530000000,1000000,1021953,1009800,9800,0.98,1015876,15876,1.59,1009800,1021953,1399-11-15
783,افاد744,منفعت دولت7-ش.خاص ساير0204,2,4000000,3846714000000,1000000,961827,961530,-38470,-3.85,961678,-38322,-3.83,961530,961827,1399-11-15
784,اراد434,مرابحه عام دولت4-ش.خ 0205,2,3136000,2958927328000,980000,942044,945027,-34973,-3.57,943535,-36465,-3.72,942044,945027,1399-11-15
785,تملي801,تسهيلات مسكن ب. ملي-فروردين98,2,25,13464150,512920,538566,538566,25646,5.0,538566,25646,5.0,538566,538566,1399-11-15
786,شسم,توليد سموم‌ علف‌ كش,2,11,986546,87928,89686,89686,1758,2.0,87928,0,0.0,89686,89686,1399-11-15
787,اطلس2,صندوق س.توسعه اندوخته آينده-س,2,20000,20000,199457,1,1,-199456,-100.0,1,-199456,-100.0,1,1,1399-11-15
788,اراد384,مرابحه عام دولت3-ش.خ 0105,2,20000,19241500000,1013727,962920,961230,-52497,-5.18,962075,-51652,-5.1,961230,962920,1399-11-15
789,اخزا8154,اسنادخزانه-م15بودجه98-010406,2,1012000,788088928000,780953,776535,780953,0,0.0,778744,-2209,-0.28,776535,780953,1399-11-15
790,اراد404,مرابحه عام دولت4-ش.خ 0207,2,2094000,1892532072000,999000,902926,904650,-94350,-9.44,903788,-95212,-9.53,902926,904650,1399-11-15
791,اشاد104,مشاركت دولتي10-شرايط خاص001226,2,72600,69293614500,955687,953228,955687,0,0.0,954457,-1230,-0.13,953228,955687,1399-11-15
792,اعتماد2,صندوق س.اعتماد آفرين پارسيان-د,2,11500000,11500000,34655,1,1,-34654,-100.0,1,-34654,-100.0,1,1,1399-11-15
793,اخزا7234,اسنادخزانه-م23بودجه97-000824,2,416000,363065040000,874280,871225,874280,0,0.0,872752,-1528,-0.17,871225,874280,1399-11-15
794,اراد334,مرابحه عام دولت3-ش.خ 0303,2,3194000,2769701055000,910000,866174,868141,-41859,-4.6,867157,-42843,-4.71,866174,868141,1399-11-15
795,وسبوشهر,شركت س استان بوشهر,2,4234,5080800,1260,1200,1200,-60,-4.76,1260,0,0.0,1200,1200,1399-11-15
796,ضخود2011,اختيارخ خودرو-5000-1400/02/08,2,110,7660000,80,70,66,-14,-17.5,70,-10,-12.5,66,70,1399-11-15
797,اخزا8064,اسنادخزانه-م6بودجه98-000519,2,310000,282365360000,911396,910316,911396,0,0.0,910856,-540,-0.06,910316,911396,1399-11-15
798,اخزا723,اسنادخزانه-م23بودجه97-000824,2,39068,34067296000,874280,872000,872000,-2280,-0.26,872000,-2280,-0.26,872000,872000,1399-11-15
799,اخزا7134,اسنادخزانه-م13بودجه97-000518,2,3270000,2989085745000,915006,913181,915006,0,0.0,914093,-913,-0.1,913181,915006,1399-11-15
800,اشاد14,مشاركت دولتي1-شرايط خاص001026,2,1500200,1499221869600,1000000,998696,1000000,0,0.0,999348,-652,-0.07,998696,1000000,1399-11-15
801,افاد44,منفعت دولتي4-شرايط خاص14010729,2,6000000,5866878000000,1032000,978056,977570,-54430,-5.27,977813,-54187,-5.25,977570,978056,1399-11-15
802,رطب0002پ02,رطب مضافتي0002اتحاديه كرمان(پ),2,104,20660640,211085,198660,198660,-12425,-5.89,198660,-12425,-5.89,198660,198660,1399-11-15
803,تملي803,تسهيلات مسكن ب. ملي-خرداد98,2,9,5330898,623496,592322,592322,-31174,-5.0,592322,-31174,-5.0,592322,592322,1399-11-15
804,پست0008پ08,پسته فندقي32-30مه ولات0008(پ),2,9,12185000,1301231,1360000,1349000,47769,3.67,1353889,52658,4.05,1349000,1360000,1399-11-15
805,اخزا8124,اسنادخزانه-م12بودجه98-001111,2,1264000,1059633320000,838630,838005,838630,0,0.0,838317,-313,-0.04,838005,838630,1399-11-15
806,تملي706,تسهيلات مسكن ب. ملي-شهريور97,2,9,5341149,624695,593461,593461,-31234,-5.0,593461,-31234,-5.0,593461,593461,1399-11-15
807,اراد544,مرابحه عام دولت5-ش.خ 0109,2,14000000,13303906000000,964500,950606,949952,-14548,-1.51,950279,-14221,-1.47,949952,950606,1399-11-15
808,تصميم2,صندوق س با درآمد ثابت تصميم,2,2000000,2000000,15546,1,1,-15545,-99.99,1,-15545,-99.99,1,1,1399-11-15
809,كابگن,توليدي و صنعتي آبگينه‌,2,20983,108649974,5077,5178,5178,101,1.99,5079,2,0.04,5178,5178,1399-11-15
810,وسمركز,شركت س استان مركزي,2,13100,17423000,1400,1330,1330,-70,-5.0,1400,0,0.0,1330,1330,1399-11-15
811,زير0003پ04,زيره سبز0003شركت مينوبذر(پ),2,27,12960027,475000,480001,480001,5001,1.05,480001,5001,1.05,480001,480001,1399-11-15
812,اخزا8054,اسنادخزانه-م5بودجه98-000422,2,336000,309813672000,921110,923019,921110,0,0.0,922064,954,0.1,921110,923019,1399-11-15
813,اخزا716,اسنادخزانه-م16بودجه97-000407,1,40,37399600,939550,934990,934990,-4560,-0.49,934990,-4560,-0.49,934990,934990,1399-11-15
814,تملي711,تسهيلات مسكن ب. ملي-بهمن97,1,8,5751992,756841,718999,718999,-37842,-5.0,718999,-37842,-5.0,718999,718999,1399-11-15
815,اخزا904,اسنادخزانه-م4بودجه99-011215,1,436,297711700,685487,682825,682825,-2662,-0.39,682825,-2662,-0.39,682825,682825,1399-11-15
816,ضخوز2012,اختيارخ فخوز-10000-1400/02/15,1,10,30000000,3502,3000,3000,-502,-14.33,3000,-502,-14.33,3000,3000,1399-11-15
817,ضبدر1159,اختيارخ شبندر-16000-1399/11/19,1,4,16000000,5747,4000,4000,-1747,-30.4,4000,-1747,-30.4,4000,4000,1399-11-15
818,ثزاگرس2,سرمايه گذاري توسعه عمران زاگرس,1,650000,38759500000,56791,59630,59630,2839,5.0,59630,2839,5.0,59630,59630,1399-11-15
819,اراد494,مرابحه عام دولت4-ش.خ 0206,1,4600000,4320931800000,986000,939333,939333,-46667,-4.73,939333,-46667,-4.73,939333,939333,1399-11-15
820,ضچاد2000,اختيارخ كچاد-12000-1400/02/05,1,15,97500000,9000,6500,6500,-2500,-27.78,6500,-2500,-27.78,6500,6500,1399-11-15
821,دمعيار2,صندوق س. توازن معيار-د,1,8600000,8600000,10070,1,1,-10069,-99.99,1,-10069,-99.99,1,1,1399-11-15
822,زير0003پ02,زيره سبز0003 دانش(پ),1,10,5200000,480001,520000,520000,39999,8.33,520000,39999,8.33,520000,520000,1399-11-15
823,شرق1400,مشاركت ليزينگ ايران وشرق140010,1,9,8999100,999900,999900,999900,0,0.0,999900,0,0.0,999900,999900,1399-11-15
824,آينده4,بازرگاني آينده سازان بهشت پارس,1,1300000,33771400000,25143,25978,25978,835,3.32,25978,835,3.32,25978,25978,1399-11-15
825,اراد474,مرابحه عام دولت4-ش.خ 0008,1,4437000,4384581282000,980000,988186,988186,8186,0.84,988186,8186,0.84,988186,988186,1399-11-15
826,مصفها203,مشاركت ش اصفهان203-3ماهه18%,1,100,93700000,940000,937000,937000,-3000,-0.32,937000,-3000,-0.32,937000,937000,1399-11-15
827,ضترا3000,اختيارخ شتران-6000-1400/03/09,1,3,7671000,3636,2557,2557,-1079,-29.68,2557,-1079,-29.68,2557,2557,1399-11-15
828,ضپيك2008,اختيارخ تاپيكو-9000-00/02/19,1,2,6600000,3373,3300,3300,-73,-2.16,3300,-73,-2.16,3300,3300,1399-11-15
829,افاد73,منفعت دولت7-ش.خاص نوين0204,1,100,104000000,1020000,1040000,1040000,20000,1.96,1040000,20000,1.96,1040000,1040000,1399-11-15
830,ضفلا1151,اختيارخ فولاد-8000-1399/11/28,1,30,61800000,3003,2060,2060,-943,-31.4,2060,-943,-31.4,2060,2060,1399-11-15
831,تملي712,تسهيلات مسكن ب. ملي-اسفند97,1,8,7150984,940918,893873,893873,-47045,-5.0,893873,-47045,-5.0,893873,893873,1399-11-15
832,ضفلا3002,اختيارخ فولاد-9000-1400/03/19,1,30,84000000,1,2800,2800,2799,279900.0,2800,2799,279900.0,2800,2800,1399-11-15
833,تملي612,تسهيلات مسكن بانك ملي-اسفند96,1,7,5573246,838082,796178,796178,-41904,-5.0,796178,-41904,-5.0,796178,796178,1399-11-15
834,تملي710,تسهيلات مسكن ب. ملي-دي97,1,8,5168336,680044,646042,646042,-34002,-5.0,646042,-34002,-5.0,646042,646042,1399-11-15
835,ضفار3001,اختيارخ فارس-9000-1400/03/05,1,5,8000000,1900,1600,1600,-300,-15.79,1600,-300,-15.79,1600,1600,1399-11-15
836,ضصاد3001,اختيارخ وبصادر-2000-1400/03/12,1,50,41000000,885,820,820,-65,-7.34,820,-65,-7.34,820,820,1399-11-15
837,اشاد10,مشاركت دولتي10-شرايط خاص001226,1,400,382275200,955687,955688,955688,1,0.0,955688,1,0.0,955688,955688,1399-11-15
838,ضغدر3003,اختيارخ وغدير-9200-1400/03/26,1,100,211000000,2555,2110,2110,-445,-17.42,2110,-445,-17.42,2110,2110,1399-11-15
839,بساما2,بيمه سامان,1,1000000,21500000000,22231,21500,21500,-731,-3.29,21500,-731,-3.29,21500,21500,1399-11-15
840,سرو2,صندوق س سروسودمند مدبران-سهام,1,500000,500000,68120,1,1,-68119,-100.0,1,-68119,-100.0,1,1,1399-11-15
841,ضترا3002,اختيارخ شتران-8000-1400/03/09,1,2,3200000,2059,1600,1600,-459,-22.29,1600,-459,-22.29,1600,1600,1399-11-15
842,صخابر102,صكوك اجاره مخابرات-3 ماهه 16%,1,3000,2970000000,985000,990000,990000,5000,0.51,990000,5000,0.51,990000,990000,1399-11-15
843,تملي802,تسهيلات مسكن ب. ملي-ارديبهشت98,1,8,7447008,979869,930876,930876,-48993,-5.0,930876,-48993,-5.0,930876,930876,1399-11-15
844,پشاهن,توليدي پلاستيك‌ شاهين,1,1744,13245680,7374,7595,7595,221,3.0,7374,0,0.0,7595,7595,1399-11-15
845,صبا1401,اجاره مهندسي صبا نفت14010225,1,21,20376363,970303,970303,970303,0,0.0,970303,0,0.0,970303,970303,1399-11-15
846,تملي704,تسهيلات مسكن ب. ملي-تير97,1,8,9960936,1310649,1245117,1245117,-65532,-5.0,1245117,-65532,-5.0,1245117,1245117,1399-11-15
847,اخزا9072,اسنادخزانه-م7بودجه99-020704,1,158550,97666800000,615950,616000,616000,50,0.01,616000,50,0.01,616000,616000,1399-11-15
848,صخود0004,صكوك رهني خودرو0004- 3ماهه 16%,1,7,6790000,970000,970000,970000,0,0.0,970000,0,0.0,970000,970000,1399-11-15
849,ضسپا3001,اختيارخ خساپا-1600-1400/03/26,1,10,8500000,1,850,850,849,84900.0,850,849,84900.0,850,850,1399-11-15
850,تملي804,تسهيلات مسكن ب. ملي-تير98,1,9,5331996,623625,592444,592444,-31181,-5.0,592444,-31181,-5.0,592444,592444,1399-11-15
851,ضپار1117,اختيارخ خپارس-7000-1399/11/19,1,9,9000,4,1,1,-3,-75.0,1,-3,-75.0,1,1,1399-11-15
852,سپرمي,پرميت‌,1,1500,12862500,8491,8575,8575,84,0.99,8491,0,0.0,8575,8575,1399-11-15
853,صينا205,صكوك منفعت سينا دارو-3ماهه 19%,1,75,74250000,953010,990000,990000,36990,3.88,990000,36990,3.88,990000,990000,1399-11-15
854,عفولاد3,اوراق سلف موازي ورق گرم فولاد,1,10,8292800,827515,829280,829280,1765,0.21,829280,1765,0.21,829280,829280,1399-11-15
855,صايپا203,صكوك مرابحه سايپا203-3ماهه 16%,1,2,1904262,952131,952131,952131,0,0.0,952131,0,0.0,952131,952131,1399-11-15
856,داريك,صندوق س.اعتماد داريك-د,1,1091,11335490,10380,10390,10390,10,0.1,10390,10,0.1,10390,10390,1399-11-15
857,كمند2,صندوق س. با درآمد ثابت كمند,1,12000000,12000000,10159,1,1,-10158,-99.99,1,-10158,-99.99,1,1,1399-11-15
858,ضملت3002,اختيارخ وبملت-4000-1400/03/19,1,10,5000000,1,500,500,499,49900.0,500,499,49900.0,500,500,1399-11-15
859,وسكرشا,س.سهام عدالت استان كرمانشاه,1,10000,12000000,1260,1200,1200,-60,-4.76,1260,0,0.0,1200,1200,1399-11-15
860,تملي708,تسهيلات مسكن ب. ملي-آبان97,1,6,3314418,581476,552403,552403,-29073,-5.0,552403,-29073,-5.0,552403,552403,1399-11-15
861,هصيكو402,اختيارف ت تاصيكو13500-00/02/20,1,3000,5400000,3365,1800,1800,-1565,-46.51,1800,-1565,-46.51,1800,1800,1399-11-15
862,تملي707,تسهيلات مسكن ب. ملي-مهر97,1,6,5104998,895613,850833,850833,-44780,-5.0,850833,-44780,-5.0,850833,850833,1399-11-15
863,پارسا306,صكوك اجاره پارسيان-6ماهه16%,1,20,18600000,922290,930000,930000,7710,0.84,930000,7710,0.84,930000,930000,1399-11-15
864,پااسفند,بار پايه اسفند,1,50000,18500000,250000,370,370,-249630,-99.85,370,-249630,-99.85,370,370,1399-11-15
865,افاد614,منفعت دولت6-ش.خاص140109,1,5000000,4889100000000,979000,977820,977820,-1180,-0.12,977820,-1180,-0.12,977820,977820,1399-11-15
866,تملي807,تسهيلات مسكن ب. ملي-مهر98,1,3,2521602,884772,840534,840534,-44238,-5.0,840534,-44238,-5.0,840534,840534,1399-11-15
867,تملي702,تسهيلات مسكن ب. ملي-ارديبهشت97,1,8,5794440,762426,724305,724305,-38121,-5.0,724305,-38121,-5.0,724305,724305,1399-11-15
868,وسقم,شركت س استان قم,1,223,298820,1410,1340,1340,-70,-4.96,1410,0,0.0,1340,1340,1399-11-15
869,اخزا713,اسنادخزانه-م13بودجه97-000518,1,612,559980612,915006,915001,915001,-5,0.0,915001,-5,0.0,915001,915001,1399-11-15
870,تملي703,تسهيلات مسكن ب. ملي-خرداد97,1,10,5506510,579632,550651,550651,-28981,-5.0,550651,-28981,-5.0,550651,550651,1399-11-15
871,صايپا412,صكوك مرابحه سايپا412-3ماهه 16%,1,100,102000000,987525,1020000,1020000,32475,3.29,1020000,32475,3.29,1020000,1020000,1399-11-15
872,ضملي3004,اختيارخ فملي-14000-1400/03/02,1,20,10000000,517,500,500,-17,-3.29,500,-17,-3.29,500,500,1399-11-15
873,اراد504,مرابحه عام دولت5-ش.خ0302,1,300000,300000000000,1000001,1000000,1000000,-1,0.0,1000000,-1,0.0,1000000,1000000,1399-11-15
874,خاتم2,صندوق س خاتم ايساتيس پويا-ثابت,1,1000000,1000000,10486,1,1,-10485,-99.99,1,-10485,-99.99,1,1,1399-11-15
875,غشهداب2,كشت و صنعت شهداب ناب خراسان,1,5880000,21315000000,3648,3625,3625,-23,-0.63,3625,-23,-0.63,3625,3625,1399-11-15
876,اراد40,مرابحه عام دولت4-ش.خ 0207,1,800,799200000,999000,999000,999000,0,0.0,999000,0,0.0,999000,999000,1399-11-15
877,وسخراش,شركت س استان خراسان شمالي,1,5000,6550000,1370,1310,1310,-60,-4.38,1370,0,0.0,1310,1310,1399-11-15
